rank_number,actor,contributions,percent,cumulative_sum,cumulative_percent,all_contributions
1,cdk8s-automation,1683,0.49154,1683,0.49154,342394
2,mowies,848,0.24767,2531,0.73921,342394
3,gaius-qi,778,0.22722,3309,0.96643,342394
4,phlax,668,0.19510,3977,1.16153,342394
5,realshuting,652,0.19042,4629,1.35195,342394
6,odubajDT,480,0.14019,5109,1.49214,342394
7,haarchri,459,0.13406,5568,1.62620,342394
8,JorTurFer,426,0.12442,5994,1.75061,342394
9,raviknox,412,0.12033,6406,1.87094,342394
10,zhangjian10,386,0.11274,6792,1.98368,342394
11,copybaranaut,368,0.10748,7160,2.09116,342394
12,gandro,352,0.10281,7512,2.19396,342394
13,greenie-msft,349,0.10193,7861,2.29589,342394
14,ovaldi,343,0.10018,8204,2.39607,342394
15,patrick-stephens,337,0.09842,8541,2.49449,342394
16,tidal,336,0.09813,8877,2.59263,342394
17,akalenyu,335,0.09784,9212,2.69047,342394
18,mtlewis,329,0.09609,9541,2.78656,342394
19,mboukhalfa,325,0.09492,9866,2.88148,342394
20,wbpcode,321,0.09375,10187,2.97523,342394
21,Poorunga,318,0.09288,10505,3.06810,342394
22,Thor-wl,301,0.08791,10806,3.15601,342394
23,XiShanYongYe-Chang,295,0.08616,11101,3.24217,342394
24,jim3ma,289,0.08441,11390,3.32658,342394
25,Jarema,275,0.08032,11665,3.40689,342394
26,en-jin19,273,0.07973,11938,3.48663,342394
27,yuanganping,271,0.07915,12209,3.56578,342394
28,dereknola,259,0.07564,12468,3.64142,342394
29,mfelsche,250,0.07302,12718,3.71443,342394
30,Rozzii,244,0.07126,12962,3.78570,342394
31,244372610,241,0.07039,13203,3.85608,342394
32,khalid-jobs,240,0.07009,13443,3.92618,342394
33,Garrybest,239,0.06980,13682,3.99598,342394
34,brettmc,230,0.06717,13912,4.06316,342394
35,LeviHarrison,229,0.06688,14141,4.13004,342394
36,derekbit,228,0.06659,14369,4.19663,342394
37,perdasilva,225,0.06571,14594,4.26234,342394
38,legendecas,223,0.06513,14817,4.32747,342394
39,anubha-v-ardhan,222,0.06484,15039,4.39231,342394
40,shrids,222,0.06484,15261,4.45715,342394
41,ShuzZzle,222,0.06484,15483,4.52198,342394
42,kishorj,221,0.06455,15704,4.58653,342394
43,Lily2025,219,0.06396,15923,4.65049,342394
44,jibi,218,0.06367,16141,4.71416,342394
45,ahrtr,212,0.06192,16353,4.77608,342394
46,brybacki,210,0.06133,16563,4.83741,342394
47,mattcary,209,0.06104,16772,4.89845,342394
48,Somefive,208,0.06075,16980,4.95920,342394
49,mattlord,205,0.05987,17185,5.01907,342394
50,apepkuss,203,0.05929,17388,5.07836,342394
51,cynthia-sg,202,0.05900,17590,5.13736,342394
52,vihangm,202,0.05900,17792,5.19635,342394
53,ceclinux,201,0.05870,17993,5.25506,342394
54,XinShuYang,201,0.05870,18194,5.31376,342394
55,ormergi,193,0.05637,18387,5.37013,342394
56,whynowy,193,0.05637,18580,5.42650,342394
57,Chriscbr,192,0.05608,18772,5.48257,342394
58,Joonpark13,190,0.05549,18962,5.53806,342394
59,orelmisan,190,0.05549,19152,5.59356,342394
60,shuaijinchao,189,0.05520,19341,5.64876,342394
61,5kbpers,188,0.05491,19529,5.70366,342394
62,chivalryq,184,0.05374,19713,5.75740,342394
63,klaases,183,0.05345,19896,5.81085,342394
64,zhongzc,183,0.05345,20079,5.86430,342394
65,FedeDP,181,0.05286,20260,5.91716,342394
66,iamNoah1,177,0.05169,20437,5.96885,342394
67,andylokandy,175,0.05111,20612,6.01997,342394
68,rhdxmr,174,0.05082,20786,6.07078,342394
69,anishakj,169,0.04936,20955,6.12014,342394
70,aravindakidambi,167,0.04877,21122,6.16892,342394
71,awanlin,167,0.04877,21289,6.21769,342394
72,yuqi1129,166,0.04848,21455,6.26617,342394
73,xpivarc,164,0.04790,21619,6.31407,342394
74,kl52752,163,0.04761,21782,6.36168,342394
75,caspervonb,161,0.04702,21943,6.40870,342394
76,iguoyr,158,0.04615,22101,6.45484,342394
77,esigo,157,0.04585,22258,6.50070,342394
78,im-konge,155,0.04527,22413,6.54597,342394
79,swopebe,155,0.04527,22568,6.59124,342394
80,leonardo-albertovich,151,0.04410,22719,6.63534,342394
81,salman-accuknox,151,0.04410,22870,6.67944,342394
82,llhuii,148,0.04323,23018,6.72266,342394
83,YangJiao0817,147,0.04293,23165,6.76560,342394
84,kaxing,144,0.04206,23309,6.80765,342394
85,cmpadden,140,0.04089,23449,6.84854,342394
86,lonewolf3739,138,0.04030,23587,6.88885,342394
87,haosanzi,136,0.03972,23723,6.92857,342394
88,ydrozhdzhal,136,0.03972,23859,6.96829,342394
89,Barakmor1,134,0.03914,23993,7.00742,342394
90,shivanshu1333,133,0.03884,24126,7.04627,342394
91,AdamKorcz,132,0.03855,24258,7.08482,342394
92,fossedihelm,125,0.03651,24383,7.12133,342394
93,mornyx,122,0.03563,24505,7.15696,342394
94,tomaszwylezek,122,0.03563,24627,7.19259,342394
95,notfelineit,121,0.03534,24748,7.22793,342394
96,Taction,121,0.03534,24869,7.26327,342394
97,kuritka,119,0.03476,24988,7.29803,342394
98,aidanhahn,118,0.03446,25106,7.33249,342394
99,camilaibs,118,0.03446,25224,7.36695,342394
100,sayantani11,118,0.03446,25342,7.40141,342394
101,mrlihanbo,115,0.03359,25457,7.43500,342394
102,shshashwat,113,0.03300,25570,7.46800,342394
103,mehabhalodiya,111,0.03242,25681,7.50042,342394
104,riita10069,109,0.03183,25790,7.53226,342394
105,Sol-0,109,0.03183,25899,7.56409,342394
106,YuJuncen,109,0.03183,26008,7.59593,342394
107,marleypowell,108,0.03154,26116,7.62747,342394
108,ethan-lowman-dd,107,0.03125,26223,7.65872,342394
109,HashNuke,107,0.03125,26330,7.68997,342394
110,THS-on,107,0.03125,26437,7.72122,342394
111,aimichelle,106,0.03096,26543,7.75218,342394
112,lhy1024,106,0.03096,26649,7.78314,342394
113,M00nF1sh,105,0.03067,26754,7.81381,342394
114,pasha-codefresh,104,0.03037,26858,7.84418,342394
115,Serializator,104,0.03037,26962,7.87455,342394
116,leiyiz,103,0.03008,27065,7.90464,342394
117,agrawroh,102,0.02979,27167,7.93443,342394
118,abvaidya,101,0.02950,27268,7.96392,342394
119,wangyikewxgm,101,0.02950,27369,7.99342,342394
120,Weil0ng,100,0.02921,27469,8.02263,342394
121,dennycd,99,0.02891,27568,8.05154,342394
122,howieyuen,99,0.02891,27667,8.08046,342394
123,htroisi,97,0.02833,27764,8.10879,342394
124,kairoaraujo,97,0.02833,27861,8.13712,342394
125,kuangp,97,0.02833,27958,8.16545,342394
126,zasweq,97,0.02833,28055,8.19378,342394
127,halspang,96,0.02804,28151,8.22181,342394
128,lecaros,96,0.02804,28247,8.24985,342394
129,sifmelcara,96,0.02804,28343,8.27789,342394
130,parkanzky,95,0.02775,28438,8.30564,342394
131,robertlaurin,95,0.02775,28533,8.33338,342394
132,sjs994,94,0.02745,28627,8.36084,342394
133,mufaddal7,93,0.02716,28720,8.38800,342394
134,harikrongali,91,0.02658,28811,8.41458,342394
135,Mrod1598,91,0.02658,28902,8.44115,342394
136,chanow816,90,0.02629,28992,8.46744,342394
137,elgnay,89,0.02599,29081,8.49343,342394
138,mic-max,88,0.02570,29169,8.51913,342394
139,chenchunxiu,87,0.02541,29256,8.54454,342394
140,CrazyHZM,86,0.02512,29342,8.56966,342394
141,Little-Wallace,86,0.02512,29428,8.59478,342394
142,sashrith,86,0.02512,29514,8.61989,342394
143,zhengtianbao,86,0.02512,29600,8.64501,342394
144,annakhm,85,0.02483,29685,8.66984,342394
145,nserrino,84,0.02453,29769,8.69437,342394
146,Sunnatillo,84,0.02453,29853,8.71890,342394
147,victory460,84,0.02453,29937,8.74344,342394
148,chlins,83,0.02424,30020,8.76768,342394
149,nissayeva,83,0.02424,30103,8.79192,342394
150,oazizi000,83,0.02424,30186,8.81616,342394
151,matthewfala,82,0.02395,30268,8.84011,342394
152,jpsim,81,0.02366,30349,8.86377,342394
153,dddddai,79,0.02307,30428,8.88684,342394
154,CabinfeverB,78,0.02278,30506,8.90962,342394
155,tomjzzhang,78,0.02278,30584,8.93240,342394
156,krishgobinath,77,0.02249,30661,8.95489,342394
157,lloydchang,77,0.02249,30738,8.97738,342394
158,ccremer,76,0.02220,30814,8.99957,342394
159,charlesxsh,76,0.02220,30890,9.02177,342394
160,jgwest,76,0.02220,30966,9.04397,342394
161,anushkamittal20,75,0.02190,31041,9.06587,342394
162,leejanee,75,0.02190,31116,9.08778,342394
163,rpanduranga,75,0.02190,31191,9.10968,342394
164,sandipanpanda,75,0.02190,31266,9.13159,342394
165,jmguzik,74,0.02161,31340,9.15320,342394
166,sampajano,74,0.02161,31414,9.17481,342394
167,SAtacker,74,0.02161,31488,9.19642,342394
168,FancyFane,73,0.02132,31561,9.21774,342394
169,niladrih,72,0.02103,31633,9.23877,342394
170,cndoit18,71,0.02074,31704,9.25951,342394
171,mjb3279,71,0.02074,31775,9.28024,342394
172,fvaleri,70,0.02044,31845,9.30069,342394
173,theletterf,70,0.02044,31915,9.32113,342394
174,davidohana,69,0.02015,31984,9.34129,342394
175,imeoer,69,0.02015,32053,9.36144,342394
176,mohafarooq,69,0.02015,32122,9.38159,342394
177,Babapool,68,0.01986,32190,9.40145,342394
178,bertysentry,68,0.01986,32258,9.42131,342394
179,mayocream,68,0.01986,32326,9.44117,342394
180,mingqishao,68,0.01986,32394,9.46103,342394
181,vinzscam,68,0.01986,32462,9.48089,342394
182,tonyxuqqi,67,0.01957,32529,9.50046,342394
183,ashish-jaiswar,66,0.01928,32595,9.51973,342394
184,divolgin,66,0.01928,32661,9.53901,342394
185,goenning,66,0.01928,32727,9.55829,342394
186,sathieu,66,0.01928,32793,9.57756,342394
187,vkkoskie,66,0.01928,32859,9.59684,342394
188,dhoard,65,0.01898,32924,9.61582,342394
189,metonymic-smokey,65,0.01898,32989,9.63481,342394
190,yanjunz97,65,0.01898,33054,9.65379,342394
191,boostchicken,64,0.01869,33118,9.67248,342394
192,ktmitton,64,0.01869,33182,9.69117,342394
193,mayjiang0203,64,0.01869,33246,9.70987,342394
194,BinaryFissionGames,63,0.01840,33309,9.72827,342394
195,wenchajun,63,0.01840,33372,9.74667,342394
196,amacaskill,62,0.01811,33434,9.76477,342394
197,Jexf,62,0.01811,33496,9.78288,342394
198,3pointer,61,0.01782,33557,9.80070,342394
199,antmendoza,61,0.01782,33618,9.81851,342394
200,liuximu,61,0.01782,33679,9.83633,342394
201,neelanjan00,61,0.01782,33740,9.85414,342394
202,owent,61,0.01782,33801,9.87196,342394
203,daimg,60,0.01752,33861,9.88948,342394
204,JaneLiuL,60,0.01752,33921,9.90701,342394
205,Jeremy-boo,60,0.01752,33981,9.92453,342394
206,machadovilaca,60,0.01752,34041,9.94206,342394
207,NikitaSkrynnik,60,0.01752,34101,9.95958,342394
208,wiktor-k,60,0.01752,34161,9.97710,342394
209,CLAassistant,59,0.01723,34220,9.99433,342394
210,JatinSanghvi,59,0.01723,34279,10.01157,342394
211,PatrickNicholas,59,0.01723,34338,10.02880,342394
212,PaurushGarg,59,0.01723,34397,10.04603,342394
213,pradeepcrao,58,0.01694,34455,10.06297,342394
214,ls-2018,57,0.01665,34512,10.07962,342394
215,philkuz,57,0.01665,34569,10.09626,342394
216,anbaig,56,0.01636,34625,10.11262,342394
217,brandonpaiz,56,0.01636,34681,10.12897,342394
218,Grunet,56,0.01636,34737,10.14533,342394
219,mdrahman-suse,56,0.01636,34793,10.16169,342394
220,omniproc,56,0.01636,34849,10.17804,342394
221,pichlermarc,55,0.01606,34904,10.19410,342394
222,tanvigour,55,0.01606,34959,10.21017,342394
223,bartavelle,54,0.01577,35013,10.22594,342394
224,clarinette9,54,0.01577,35067,10.24171,342394
225,dehamzah,54,0.01577,35121,10.25748,342394
226,mainred,54,0.01577,35175,10.27325,342394
227,dteplits,53,0.01548,35228,10.28873,342394
228,jnmoyne,53,0.01548,35281,10.30421,342394
229,tamilmaran-7,53,0.01548,35334,10.31969,342394
230,Vignesh2208,53,0.01548,35387,10.33517,342394
231,wenqiq,53,0.01548,35440,10.35065,342394
232,lfbear,52,0.01519,35492,10.36584,342394
233,panslava,52,0.01519,35544,10.38102,342394
234,tier-cap,52,0.01519,35596,10.39621,342394
235,ciiay,51,0.01490,35647,10.41111,342394
236,kennytrytek,51,0.01490,35698,10.42600,342394
237,MrCroxx,51,0.01490,35749,10.44090,342394
238,ProticM,51,0.01490,35800,10.45579,342394
239,AvineshTripathi,50,0.01460,35850,10.47039,342394
240,nirarg,50,0.01460,35900,10.48500,342394
241,ran-huang,50,0.01460,35950,10.49960,342394
242,vupv,50,0.01460,36000,10.51420,342394
243,DhananjayPurohit,49,0.01431,36049,10.52851,342394
244,joeporpeglia,49,0.01431,36098,10.54282,342394
245,justadogistaken,49,0.01431,36147,10.55714,342394
246,kkkkun,49,0.01431,36196,10.57145,342394
247,ShubhamPalriwala,49,0.01431,36245,10.58576,342394
248,amulyavarote,48,0.01402,36293,10.59978,342394
249,AshokAccuknox,48,0.01402,36341,10.61380,342394
250,BigVan,48,0.01402,36389,10.62781,342394
251,BinacsLee,48,0.01402,36437,10.64183,342394
252,zasgar,48,0.01402,36485,10.65585,342394
253,zhangbo1882,48,0.01402,36533,10.66987,342394
254,Ahmed-Aghadi,47,0.01373,36580,10.68360,342394
255,dvirguttman,47,0.01373,36627,10.69733,342394
256,jidalong,47,0.01373,36674,10.71105,342394
257,sergenyalcin,47,0.01373,36721,10.72478,342394
258,bmsiegel,46,0.01343,36767,10.73821,342394
259,dubious90,46,0.01343,36813,10.75165,342394
260,fyang86,46,0.01343,36859,10.76508,342394
261,gamba47,46,0.01343,36905,10.77852,342394
262,zr-msft,46,0.01343,36951,10.79195,342394
263,chrismetz09,45,0.01314,36996,10.80510,342394
264,Fox32,45,0.01314,37041,10.81824,342394
265,joaopgrassi,45,0.01314,37086,10.83138,342394
266,namdeirf,45,0.01314,37131,10.84452,342394
267,ningmingxiao,45,0.01314,37176,10.85767,342394
268,Prajyot-Parab,45,0.01314,37221,10.87081,342394
269,smcavallo,45,0.01314,37266,10.88395,342394
270,TangliziGit,45,0.01314,37311,10.89710,342394
271,Anita-ihuman,44,0.01285,37355,10.90995,342394
272,CIPHERTron,44,0.01285,37399,10.92280,342394
273,danibachar,44,0.01285,37443,10.93565,342394
274,hiba-aldalaty,44,0.01285,37487,10.94850,342394
275,keep94,44,0.01285,37531,10.96135,342394
276,LemonHX,44,0.01285,37575,10.97420,342394
277,NickLanam,44,0.01285,37619,10.98705,342394
278,O3Ol,44,0.01285,37663,10.99990,342394
279,radcortez,44,0.01285,37707,11.01275,342394
280,rittneje,44,0.01285,37751,11.02560,342394
281,xens,44,0.01285,37795,11.03845,342394
282,2hangchen,43,0.01256,37838,11.05101,342394
283,gtxu,43,0.01256,37881,11.06357,342394
284,jameszhangyukun,43,0.01256,37924,11.07613,342394
285,NigelWu95,43,0.01256,37967,11.08869,342394
286,olljanat,43,0.01256,38010,11.10125,342394
287,prodanlabs,43,0.01256,38053,11.11380,342394
288,qiankunli,43,0.01256,38096,11.12636,342394
289,brsolomon-deloitte,42,0.01227,38138,11.13863,342394
290,liangzhou121,42,0.01227,38180,11.15090,342394
291,liulanzheng,42,0.01227,38222,11.16316,342394
292,nodify-at,42,0.01227,38264,11.17543,342394
293,peng1999,42,0.01227,38306,11.18770,342394
294,pirgeo,42,0.01227,38348,11.19996,342394
295,calvin0327,41,0.01197,38389,11.21194,342394
296,cfzjywxk,41,0.01197,38430,11.22391,342394
297,cwalterhk,41,0.01197,38471,11.23589,342394
298,jlsong01,41,0.01197,38512,11.24786,342394
299,kavyashree-r,41,0.01197,38553,11.25984,342394
300,rltoSD,41,0.01197,38594,11.27181,342394
301,suuus,41,0.01197,38635,11.28378,342394
302,swghosh,41,0.01197,38676,11.29576,342394
303,tkovacs-2,41,0.01197,38717,11.30773,342394
304,y1r,41,0.01197,38758,11.31971,342394
305,yangtaoran,41,0.01197,38799,11.33168,342394
306,astraw99,40,0.01168,38839,11.34336,342394
307,bkono,40,0.01168,38879,11.35505,342394
308,captainsafia,40,0.01168,38919,11.36673,342394
309,CatherineF-dev,40,0.01168,38959,11.37841,342394
310,johanfylling,40,0.01168,38999,11.39009,342394
311,TannerGabriel,40,0.01168,39039,11.40178,342394
312,yuriolisa,40,0.01168,39079,11.41346,342394
313,jiangliu,39,0.01139,39118,11.42485,342394
314,khalilswdp,39,0.01139,39157,11.43624,342394
315,lintongj,39,0.01139,39196,11.44763,342394
316,mustafain117,39,0.01139,39235,11.45902,342394
317,njayp,39,0.01139,39274,11.47041,342394
318,zhiminghufighting,39,0.01139,39313,11.48180,342394
319,assafad,38,0.01110,39351,11.49290,342394
320,colega,38,0.01110,39389,11.50400,342394
321,deexitp-splunk,38,0.01110,39427,11.51510,342394
322,HHogg,38,0.01110,39465,11.52619,342394
323,krzysztofdrys,38,0.01110,39503,11.53729,342394
324,nishant-yt,38,0.01110,39541,11.54839,342394
325,PhilipMay,38,0.01110,39579,11.55949,342394
326,stephen-fox,38,0.01110,39617,11.57059,342394
327,wanlin31,38,0.01110,39655,11.58169,342394
328,ChanKunggc,37,0.01081,39692,11.59249,342394
329,hellocloudnative,37,0.01081,39729,11.60330,342394
330,LucaGuerra,37,0.01081,39766,11.61411,342394
331,manikanth04,37,0.01081,39803,11.62491,342394
332,mardim91,37,0.01081,39840,11.63572,342394
333,mattwilkinsonn,37,0.01081,39877,11.64652,342394
334,pawbana,37,0.01081,39914,11.65733,342394
335,qmloong,37,0.01081,39951,11.66814,342394
336,sivchari,37,0.01081,39988,11.67894,342394
337,Thiyagu55,37,0.01081,40025,11.68975,342394
338,zhxie,37,0.01081,40062,11.70056,342394
339,kkaarreell,36,0.01051,40098,11.71107,342394
340,mac-chaffee,36,0.01051,40134,11.72158,342394
341,sbs2001,36,0.01051,40170,11.73210,342394
342,TomHellier,36,0.01051,40206,11.74261,342394
343,196Ikuchil,35,0.01022,40241,11.75283,342394
344,asubedy,35,0.01022,40276,11.76306,342394
345,chetak123,35,0.01022,40311,11.77328,342394
346,divyansh-gupta,35,0.01022,40346,11.78350,342394
347,FriedrichWilken,35,0.01022,40381,11.79372,342394
348,Icedroid,35,0.01022,40416,11.80395,342394
349,jayesh-srivastava,35,0.01022,40451,11.81417,342394
350,JayiceZ,35,0.01022,40486,11.82439,342394
351,JimmyYang20,35,0.01022,40521,11.83461,342394
352,llu94,35,0.01022,40556,11.84483,342394
353,nearora-msft,35,0.01022,40591,11.85506,342394
354,tobiasstadler,35,0.01022,40626,11.86528,342394
355,xujingjing-cmss,35,0.01022,40661,11.87550,342394
356,ycyaoxdu,35,0.01022,40696,11.88572,342394
357,dbsid,34,0.00993,40730,11.89565,342394
358,erikjoh,34,0.00993,40764,11.90558,342394
359,fanriming,34,0.00993,40798,11.91551,342394
360,LittleFox94,34,0.00993,40832,11.92544,342394
361,luncj,34,0.00993,40866,11.93537,342394
362,newhuangchuan,34,0.00993,40900,11.94530,342394
363,pingyu,34,0.00993,40934,11.95523,342394
364,saumeya,34,0.00993,40968,11.96516,342394
365,temawi,34,0.00993,41002,11.97509,342394
366,acumino,33,0.00964,41035,11.98473,342394
367,mmiranda96,33,0.00964,41068,11.99437,342394
368,mtfoley,33,0.00964,41101,12.00401,342394
369,oliviassss,33,0.00964,41134,12.01365,342394
370,osherv,33,0.00964,41167,12.02328,342394
371,rafikiassumani-msft,33,0.00964,41200,12.03292,342394
372,slacksach,33,0.00964,41233,12.04256,342394
373,v01dstar,33,0.00964,41266,12.05220,342394
374,wangchenglong01,33,0.00964,41299,12.06184,342394
375,xiongjiwei,33,0.00964,41332,12.07147,342394
376,yasin-cs-ko-ak,33,0.00964,41365,12.08111,342394
377,alex-berger,32,0.00935,41397,12.09046,342394
378,becky-hd,32,0.00935,41429,12.09980,342394
379,efunk,32,0.00935,41461,12.10915,342394
380,HuangYijuan,32,0.00935,41493,12.11850,342394
381,jn9e9,32,0.00935,41525,12.12784,342394
382,krispraws,32,0.00935,41557,12.13719,342394
383,learner0810,32,0.00935,41589,12.14653,342394
384,lgy1027,32,0.00935,41621,12.15588,342394
385,manang-splunk,32,0.00935,41653,12.16522,342394
386,Mr-DG-Wick,32,0.00935,41685,12.17457,342394
387,shree007,32,0.00935,41717,12.18392,342394
388,slawekgh,32,0.00935,41749,12.19326,342394
389,sudoHackIn,32,0.00935,41781,12.20261,342394
390,treydock,32,0.00935,41813,12.21195,342394
391,bwerthmann,31,0.00905,41844,12.22101,342394
392,donnadionne,31,0.00905,41875,12.23006,342394
393,jlpadilla,31,0.00905,41906,12.23912,342394
394,manugupt1,31,0.00905,41937,12.24817,342394
395,marcelobartsch,31,0.00905,41968,12.25722,342394
396,ofirshmuel,31,0.00905,41999,12.26628,342394
397,rohitrishim,31,0.00905,42030,12.27533,342394
398,shuaich,31,0.00905,42061,12.28439,342394
399,tachyus-ryan,31,0.00905,42092,12.29344,342394
400,zhyChesterCheung,31,0.00905,42123,12.30249,342394
401,zmberg,31,0.00905,42154,12.31155,342394
402,zyyw,31,0.00905,42185,12.32060,342394
403,AbhinavCSY,30,0.00876,42215,12.32936,342394
404,adriananeci,30,0.00876,42245,12.33813,342394
405,allenlsy,30,0.00876,42275,12.34689,342394
406,hanamantagoudvk,30,0.00876,42305,12.35565,342394
407,hanjin-qiu,30,0.00876,42335,12.36441,342394
408,ljkiraly,30,0.00876,42365,12.37317,342394
409,Nevay,30,0.00876,42395,12.38193,342394
410,OferLevi85,30,0.00876,42425,12.39070,342394
411,oxeye-nikolay,30,0.00876,42455,12.39946,342394
412,pwhelan,30,0.00876,42485,12.40822,342394
413,zeborg,30,0.00876,42515,12.41698,342394
414,AaronME,29,0.00847,42544,12.42545,342394
415,adriankostrubiak-tomtom,29,0.00847,42573,12.43392,342394
416,aymericDD,29,0.00847,42602,12.44239,342394
417,b0b0haha,29,0.00847,42631,12.45086,342394
418,ckandag,29,0.00847,42660,12.45933,342394
419,collimarco,29,0.00847,42689,12.46780,342394
420,Gbahdeyboh,29,0.00847,42718,12.47627,342394
421,hosseinsia,29,0.00847,42747,12.48474,342394
422,hprajapati-splunk,29,0.00847,42776,12.49321,342394
423,itspngu,29,0.00847,42805,12.50168,342394
424,kun-lu20,29,0.00847,42834,12.51015,342394
425,lukzerom,29,0.00847,42863,12.51862,342394
426,mpuckett159,29,0.00847,42892,12.52709,342394
427,regicsolutions,29,0.00847,42921,12.53556,342394
428,songlh,29,0.00847,42950,12.54403,342394
429,Tingtal,29,0.00847,42979,12.55250,342394
430,aidaizyy,28,0.00818,43007,12.56068,342394
431,bang9211,28,0.00818,43035,12.56885,342394
432,cwayne18,28,0.00818,43063,12.57703,342394
433,daomin885,28,0.00818,43091,12.58521,342394
434,deepakcys,28,0.00818,43119,12.59339,342394
435,dvic,28,0.00818,43147,12.60156,342394
436,floriangasc,28,0.00818,43175,12.60974,342394
437,Garima-Negi,28,0.00818,43203,12.61792,342394
438,jrkeen,28,0.00818,43231,12.62610,342394
439,kwanhur,28,0.00818,43259,12.63428,342394
440,MikeZappa87,28,0.00818,43287,12.64245,342394
441,orphaner,28,0.00818,43315,12.65063,342394
442,RomanKisilenko,28,0.00818,43343,12.65881,342394
443,thekingofcity,28,0.00818,43371,12.66699,342394
444,wangyd1988,28,0.00818,43399,12.67516,342394
445,xliuxu,28,0.00818,43427,12.68334,342394
446,yangjunmyfm192085,28,0.00818,43455,12.69152,342394
447,andrey-dubnik,27,0.00789,43482,12.69940,342394
448,dsavitskiy,27,0.00789,43509,12.70729,342394
449,heybronson,27,0.00789,43536,12.71518,342394
450,jayonlau,27,0.00789,43563,12.72306,342394
451,joccau,27,0.00789,43590,12.73095,342394
452,KernelErr,27,0.00789,43617,12.73883,342394
453,kittylyst,27,0.00789,43644,12.74672,342394
454,liornoy,27,0.00789,43671,12.75460,342394
455,livetocode,27,0.00789,43698,12.76249,342394
456,MandssS,27,0.00789,43725,12.77038,342394
457,MuZhou233,27,0.00789,43752,12.77826,342394
458,sebastianriese,27,0.00789,43779,12.78615,342394
459,tbeets,27,0.00789,43806,12.79403,342394
460,theunrealgeek,27,0.00789,43833,12.80192,342394
461,tombokombo,27,0.00789,43860,12.80980,342394
462,Amulyam24,26,0.00759,43886,12.81740,342394
463,cpheps,26,0.00759,43912,12.82499,342394
464,Darshnadas,26,0.00759,43938,12.83258,342394
465,drnushooz,26,0.00759,43964,12.84018,342394
466,FingerLeader,26,0.00759,43990,12.84777,342394
467,fivesheep,26,0.00759,44016,12.85537,342394
468,LQBing,26,0.00759,44042,12.86296,342394
469,lynxcat,26,0.00759,44068,12.87055,342394
470,ME-ON1,26,0.00759,44094,12.87815,342394
471,MisterMX,26,0.00759,44120,12.88574,342394
472,nikklassen,26,0.00759,44146,12.89333,342394
473,tooptoop4,26,0.00759,44172,12.90093,342394
474,uniqueni,26,0.00759,44198,12.90852,342394
475,VannTen,26,0.00759,44224,12.91611,342394
476,xavier-rbz,26,0.00759,44250,12.92371,342394
477,ZhangHanDong,26,0.00759,44276,12.93130,342394
478,2014BDuck,25,0.00730,44301,12.93860,342394
479,alittlehorse,25,0.00730,44326,12.94590,342394
480,ambiknai,25,0.00730,44351,12.95321,342394
481,deejross,25,0.00730,44376,12.96051,342394
482,jmalvarezf-lmes,25,0.00730,44401,12.96781,342394
483,JonathanWamsley,25,0.00730,44426,12.97511,342394
484,landreasyan,25,0.00730,44451,12.98241,342394
485,lucasjellema,25,0.00730,44476,12.98971,342394
486,Sam-Kramer,25,0.00730,44501,12.99702,342394
487,wasmcloud-automation,25,0.00730,44526,13.00432,342394
488,alexzielenski,24,0.00701,44550,13.01133,342394
489,arunvelayutham,24,0.00701,44574,13.01834,342394
490,ashish-varma,24,0.00701,44598,13.02535,342394
491,AuraSinis,24,0.00701,44622,13.03235,342394
492,bpinske,24,0.00701,44646,13.03936,342394
493,cbuschka,24,0.00701,44670,13.04637,342394
494,cebernardi,24,0.00701,44694,13.05338,342394
495,chenyukang,24,0.00701,44718,13.06039,342394
496,chuliang014,24,0.00701,44742,13.06740,342394
497,craig-seeman,24,0.00701,44766,13.07441,342394
498,enys,24,0.00701,44790,13.08142,342394
499,gbbr,24,0.00701,44814,13.08843,342394
500,hhstu,24,0.00701,44838,13.09544,342394
501,jon-stumpf,24,0.00701,44862,13.10245,342394
502,king-11,24,0.00701,44886,13.10946,342394
503,king-jingxiang,24,0.00701,44910,13.11647,342394
504,MSNev,24,0.00701,44934,13.12348,342394
505,ottosichert,24,0.00701,44958,13.13049,342394
506,Phil-sun,24,0.00701,44982,13.13750,342394
507,pragmaticivan,24,0.00701,45006,13.14451,342394
508,prkeshri,24,0.00701,45030,13.15152,342394
509,PurneswarPrasad,24,0.00701,45054,13.15852,342394
510,q2dg,24,0.00701,45078,13.16553,342394
511,RenjieTang,24,0.00701,45102,13.17254,342394
512,reugn,24,0.00701,45126,13.17955,342394
513,Scowluga,24,0.00701,45150,13.18656,342394
514,ueno,24,0.00701,45174,13.19357,342394
515,VelocityLight,24,0.00701,45198,13.20058,342394
516,YRXING,24,0.00701,45222,13.20759,342394
517,yuryu,24,0.00701,45246,13.21460,342394
518,yzhao1012,24,0.00701,45270,13.22161,342394
519,ainhoaL,23,0.00672,45293,13.22833,342394
520,anooptp,23,0.00672,45316,13.23505,342394
521,avinal,23,0.00672,45339,13.24176,342394
522,bpoland,23,0.00672,45362,13.24848,342394
523,budhirajamadhav,23,0.00672,45385,13.25520,342394
524,chenlujjj,23,0.00672,45408,13.26191,342394
525,cuichenli,23,0.00672,45431,13.26863,342394
526,futuretea,23,0.00672,45454,13.27535,342394
527,gabihodoroaga,23,0.00672,45477,13.28207,342394
528,HanFa,23,0.00672,45500,13.28878,342394
529,hcoona,23,0.00672,45523,13.29550,342394
530,isubasinghe,23,0.00672,45546,13.30222,342394
531,JimFran,23,0.00672,45569,13.30894,342394
532,khoang98,23,0.00672,45592,13.31565,342394
533,mmatache,23,0.00672,45615,13.32237,342394
534,moltenice,23,0.00672,45638,13.32909,342394
535,mtagstyle,23,0.00672,45661,13.33581,342394
536,peteroneilljr,23,0.00672,45684,13.34252,342394
537,pkesavap,23,0.00672,45707,13.34924,342394
538,richardchen331,23,0.00672,45730,13.35596,342394
539,saber-wang,23,0.00672,45753,13.36268,342394
540,sreekaransrinath,23,0.00672,45776,13.36939,342394
541,Utkarsh-0211,23,0.00672,45799,13.37611,342394
542,besha100,22,0.00643,45821,13.38254,342394
543,champly,22,0.00643,45843,13.38896,342394
544,chenlinx17,22,0.00643,45865,13.39539,342394
545,chenxuc,22,0.00643,45887,13.40181,342394
546,derjust,22,0.00643,45909,13.40824,342394
547,dgerding,22,0.00643,45931,13.41466,342394
548,didicodes,22,0.00643,45953,13.42109,342394
549,eightzero,22,0.00643,45975,13.42751,342394
550,ilan-pinto,22,0.00643,45997,13.43394,342394
551,kart,22,0.00643,46019,13.44036,342394
552,lukpep,22,0.00643,46041,13.44679,342394
553,marunachalam,22,0.00643,46063,13.45321,342394
554,mircyb,22,0.00643,46085,13.45964,342394
555,moluzhui,22,0.00643,46107,13.46607,342394
556,Nawaz027,22,0.00643,46129,13.47249,342394
557,Patrick0308,22,0.00643,46151,13.47892,342394
558,phillipuniverse,22,0.00643,46173,13.48534,342394
559,postescu,22,0.00643,46195,13.49177,342394
560,ruquanzhao,22,0.00643,46217,13.49819,342394
561,smg247,22,0.00643,46239,13.50462,342394
562,solonish,22,0.00643,46261,13.51104,342394
563,xigifty,22,0.00643,46283,13.51747,342394
564,x-shadow-man,22,0.00643,46305,13.52389,342394
565,yaocw2020,22,0.00643,46327,13.53032,342394
566,yuvalman,22,0.00643,46349,13.53674,342394
567,Alvaro-Campesino,21,0.00613,46370,13.54288,342394
568,baurine,21,0.00613,46391,13.54901,342394
569,chreniuc,21,0.00613,46412,13.55514,342394
570,dehaansa,21,0.00613,46433,13.56128,342394
571,disq,21,0.00613,46454,13.56741,342394
572,ethernoy,21,0.00613,46475,13.57354,342394
573,EvgenyAGRO,21,0.00613,46496,13.57968,342394
574,Freakachoo,21,0.00613,46517,13.58581,342394
575,GitHubxsy,21,0.00613,46538,13.59194,342394
576,hzyfox,21,0.00613,46559,13.59808,342394
577,irizzant,21,0.00613,46580,13.60421,342394
578,jessicalins,21,0.00613,46601,13.61034,342394
579,johnxiaohe,21,0.00613,46622,13.61648,342394
580,leonharetd,21,0.00613,46643,13.62261,342394
581,LuyaoZhong,21,0.00613,46664,13.62874,342394
582,ndrwrbgs,21,0.00613,46685,13.63488,342394
583,nuka137,21,0.00613,46706,13.64101,342394
584,nvadluri,21,0.00613,46727,13.64714,342394
585,prnam,21,0.00613,46748,13.65328,342394
586,qlijin,21,0.00613,46769,13.65941,342394
587,rhtyd,21,0.00613,46790,13.66554,342394
588,rlankfo,21,0.00613,46811,13.67168,342394
589,rlex,21,0.00613,46832,13.67781,342394
590,windtalker,21,0.00613,46853,13.68394,342394
591,zivAnyvision,21,0.00613,46874,13.69008,342394
592,1998729,20,0.00584,46894,13.69592,342394
593,achetronic,20,0.00584,46914,13.70176,342394
594,acm-installer-team,20,0.00584,46934,13.70760,342394
595,artem-nefedov,20,0.00584,46954,13.71344,342394
596,Asphaltt,20,0.00584,46974,13.71928,342394
597,atran-brex,20,0.00584,46994,13.72512,342394
598,bobychaudhary,20,0.00584,47014,13.73096,342394
599,chenjazz,20,0.00584,47034,13.73681,342394
600,Danny-Wei,20,0.00584,47054,13.74265,342394
601,danports,20,0.00584,47074,13.74849,342394
602,delanym,20,0.00584,47094,13.75433,342394
603,gotson,20,0.00584,47114,13.76017,342394
604,ixodie,20,0.00584,47134,13.76601,342394
605,Jayice-zjw,20,0.00584,47154,13.77185,342394
606,jiangxiaobin96,20,0.00584,47174,13.77769,342394
607,jordy1024,20,0.00584,47194,13.78354,342394
608,kw7oe,20,0.00584,47214,13.78938,342394
609,merveyilmaz-netrd,20,0.00584,47234,13.79522,342394
610,michaellzc,20,0.00584,47254,13.80106,342394
611,momiji,20,0.00584,47274,13.80690,342394
612,offSwitch,20,0.00584,47294,13.81274,342394
613,patricknelson,20,0.00584,47314,13.81858,342394
614,qabpea,20,0.00584,47334,13.82442,342394
615,qiancai,20,0.00584,47354,13.83027,342394
616,qidi1,20,0.00584,47374,13.83611,342394
617,robotjellyzone,20,0.00584,47394,13.84195,342394
618,Ronyk1,20,0.00584,47414,13.84779,342394
619,sanchayanghosh,20,0.00584,47434,13.85363,342394
620,sazzle2611,20,0.00584,47454,13.85947,342394
621,sbarikdev,20,0.00584,47474,13.86531,342394
622,sethAmazon,20,0.00584,47494,13.87115,342394
623,ssz1997,20,0.00584,47514,13.87700,342394
624,tamboliasir1,20,0.00584,47534,13.88284,342394
625,Th0masL,20,0.00584,47554,13.88868,342394
626,uds5501,20,0.00584,47574,13.89452,342394
627,vangork,20,0.00584,47594,13.90036,342394
628,xzyangNB,20,0.00584,47614,13.90620,342394
629,yebyen,20,0.00584,47634,13.91204,342394
630,ztelur,20,0.00584,47654,13.91788,342394
631,zxbyoyoyo,20,0.00584,47674,13.92373,342394
632,100mik,19,0.00555,47693,13.92927,342394
633,bdun1013,19,0.00555,47712,13.93482,342394
634,Blackclaws,19,0.00555,47731,13.94037,342394
635,BobVanB,19,0.00555,47750,13.94592,342394
636,book987,19,0.00555,47769,13.95147,342394
637,bradfrosty,19,0.00555,47788,13.95702,342394
638,camba1,19,0.00555,47807,13.96257,342394
639,CO-lhagman,19,0.00555,47826,13.96812,342394
640,dellThejas,19,0.00555,47845,13.97367,342394
641,ecthelion77,19,0.00555,47864,13.97922,342394
642,eliaskoromilas,19,0.00555,47883,13.98477,342394
643,g-gaston,19,0.00555,47902,13.99032,342394
644,hainesc,19,0.00555,47921,13.99586,342394
645,hstefan,19,0.00555,47940,14.00141,342394
646,hustliyilin,19,0.00555,47959,14.00696,342394
647,jyller,19,0.00555,47978,14.01251,342394
648,krestofur,19,0.00555,47997,14.01806,342394
649,lc2705,19,0.00555,48016,14.02361,342394
650,lucy-cl,19,0.00555,48035,14.02916,342394
651,matchge-ca,19,0.00555,48054,14.03471,342394
652,melisatanrverdi,19,0.00555,48073,14.04026,342394
653,Michaelpalacce,19,0.00555,48092,14.04581,342394
654,ooraini,19,0.00555,48111,14.05136,342394
655,oppegard,19,0.00555,48130,14.05691,342394
656,PaulLiang1,19,0.00555,48149,14.06245,342394
657,prashbnair,19,0.00555,48168,14.06800,342394
658,rainfd,19,0.00555,48187,14.07355,342394
659,semharel,19,0.00555,48206,14.07910,342394
660,sergio-correia,19,0.00555,48225,14.08465,342394
661,Sherlock-Holo,19,0.00555,48244,14.09020,342394
662,shriyasankhyan,19,0.00555,48263,14.09575,342394
663,sophieyfang,19,0.00555,48282,14.10130,342394
664,swills,19,0.00555,48301,14.10685,342394
665,wangglbj,19,0.00555,48320,14.11240,342394
666,ak2766,18,0.00526,48338,14.11765,342394
667,alienninja,18,0.00526,48356,14.12291,342394
668,andrewhr,18,0.00526,48374,14.12817,342394
669,chenlei677,18,0.00526,48392,14.13343,342394
670,ChristianCiach,18,0.00526,48410,14.13868,342394
671,diceride,18,0.00526,48428,14.14394,342394
672,ezemegwara,18,0.00526,48446,14.14920,342394
673,Feggah,18,0.00526,48464,14.15445,342394
674,fxiang1,18,0.00526,48482,14.15971,342394
675,HannahShiSFB,18,0.00526,48500,14.16497,342394
676,harytary,18,0.00526,48518,14.17022,342394
677,hedinasr,18,0.00526,48536,14.17548,342394
678,jamesharr,18,0.00526,48554,14.18074,342394
679,jeremyguarini,18,0.00526,48572,14.18600,342394
680,jfl929930,18,0.00526,48590,14.19125,342394
681,Legion2,18,0.00526,48608,14.19651,342394
682,lic17,18,0.00526,48626,14.20177,342394
683,mallow111,18,0.00526,48644,14.20702,342394
684,mingleiw,18,0.00526,48662,14.21228,342394
685,necatican,18,0.00526,48680,14.21754,342394
686,nilayasiktoprak,18,0.00526,48698,14.22280,342394
687,nissy34,18,0.00526,48716,14.22805,342394
688,presztak,18,0.00526,48734,14.23331,342394
689,priyamshet,18,0.00526,48752,14.23857,342394
690,rahulbapumore,18,0.00526,48770,14.24382,342394
691,raje143r,18,0.00526,48788,14.24908,342394
692,ramrodo,18,0.00526,48806,14.25434,342394
693,RoelvandenBerg,18,0.00526,48824,14.25960,342394
694,rupipal,18,0.00526,48842,14.26485,342394
695,sipriyaa,18,0.00526,48860,14.27011,342394
696,sunzhaochang,18,0.00526,48878,14.27537,342394
697,timmy59100,18,0.00526,48896,14.28062,342394
698,timonwong,18,0.00526,48914,14.28588,342394
699,trierra,18,0.00526,48932,14.29114,342394
700,VerstraeteBert,18,0.00526,48950,14.29640,342394
701,wonleing,18,0.00526,48968,14.30165,342394
702,xyz-li,18,0.00526,48986,14.30691,342394
703,yyang48,18,0.00526,49004,14.31217,342394
704,zhuxiaolong-g,18,0.00526,49022,14.31742,342394
705,zonnie,18,0.00526,49040,14.32268,342394
706,akazimierskigl,17,0.00497,49057,14.32765,342394
707,ankita25,17,0.00497,49074,14.33261,342394
708,arunraman,17,0.00497,49091,14.33758,342394
709,assaf-admi,17,0.00497,49108,14.34254,342394
710,au2001,17,0.00497,49125,14.34751,342394
711,baoquach14,17,0.00497,49142,14.35247,342394
712,champtar,17,0.00497,49159,14.35744,342394
713,chenxiaofei-cxf,17,0.00497,49176,14.36240,342394
714,dialogbox,17,0.00497,49193,14.36737,342394
715,dnsaoki2,17,0.00497,49210,14.37233,342394
716,fgharo,17,0.00497,49227,14.37730,342394
717,Friedrich42,17,0.00497,49244,14.38226,342394
718,getporterbot,17,0.00497,49261,14.38723,342394
719,h0jeZvgoxFepBQ2C,17,0.00497,49278,14.39219,342394
720,h4ghhh,17,0.00497,49295,14.39716,342394
721,habmic,17,0.00497,49312,14.40212,342394
722,haslersn,17,0.00497,49329,14.40709,342394
723,Inode1,17,0.00497,49346,14.41205,342394
724,isugimpy,17,0.00497,49363,14.41702,342394
725,janpieper,17,0.00497,49380,14.42198,342394
726,jasoares,17,0.00497,49397,14.42695,342394
727,JPRbrs,17,0.00497,49414,14.43191,342394
728,khalludi,17,0.00497,49431,14.43688,342394
729,loresuso,17,0.00497,49448,14.44184,342394
730,lucming,17,0.00497,49465,14.44681,342394
731,manick02,17,0.00497,49482,14.45177,342394
732,mbimbij,17,0.00497,49499,14.45674,342394
733,mfbieber,17,0.00497,49516,14.46170,342394
734,mossroy,17,0.00497,49533,14.46667,342394
735,NI1993,17,0.00497,49550,14.47163,342394
736,ShivamTyagi12345,17,0.00497,49567,14.47660,342394
737,slayer321,17,0.00497,49584,14.48156,342394
738,stingshen,17,0.00497,49601,14.48653,342394
739,TannerGilbert,17,0.00497,49618,14.49149,342394
740,VillePihlava,17,0.00497,49635,14.49646,342394
741,vinhph0906,17,0.00497,49652,14.50142,342394
742,Vi-Nk,17,0.00497,49669,14.50639,342394
743,VirrageS,17,0.00497,49686,14.51135,342394
744,wangshishuo,17,0.00497,49703,14.51632,342394
745,wangyanghack,17,0.00497,49720,14.52128,342394
746,weilaaa,17,0.00497,49737,14.52625,342394
747,yanghesong,17,0.00497,49754,14.53121,342394
748,yz271544,17,0.00497,49771,14.53618,342394
749,zgriesinger,17,0.00497,49788,14.54114,342394
750,alanz2015,16,0.00467,49804,14.54582,342394
751,amfred,16,0.00467,49820,14.55049,342394
752,anthonyikeda,16,0.00467,49836,14.55516,342394
753,artificial-aidan,16,0.00467,49852,14.55983,342394
754,astencel-sumo,16,0.00467,49868,14.56451,342394
755,Atharva-Shinde,16,0.00467,49884,14.56918,342394
756,bangqipropel,16,0.00467,49900,14.57385,342394
757,carpe-github,16,0.00467,49916,14.57853,342394
758,chandrasekhar1996,16,0.00467,49932,14.58320,342394
759,commandgjj,16,0.00467,49948,14.58787,342394
760,cowboyd,16,0.00467,49964,14.59255,342394
761,cvvz,16,0.00467,49980,14.59722,342394
762,darren-wang,16,0.00467,49996,14.60189,342394
763,EdgeJ,16,0.00467,50012,14.60656,342394
764,eggiter,16,0.00467,50028,14.61124,342394
765,EHSchmitt4395,16,0.00467,50044,14.61591,342394
766,eulerf,16,0.00467,50060,14.62058,342394
767,FuyuanChu,16,0.00467,50076,14.62526,342394
768,Giridhar23689,16,0.00467,50092,14.62993,342394
769,globalflea,16,0.00467,50108,14.63460,342394
770,GregoireW,16,0.00467,50124,14.63928,342394
771,guyzyl,16,0.00467,50140,14.64395,342394
772,hansonchar,16,0.00467,50156,14.64862,342394
773,harshaccuknox,16,0.00467,50172,14.65329,342394
774,hfxsd,16,0.00467,50188,14.65797,342394
775,horizonzy,16,0.00467,50204,14.66264,342394
776,IceeMC,16,0.00467,50220,14.66731,342394
777,infra-monkey,16,0.00467,50236,14.67199,342394
778,jaypume,16,0.00467,50252,14.67666,342394
779,jerbob92,16,0.00467,50268,14.68133,342394
780,jyz0309,16,0.00467,50284,14.68601,342394
781,linux-gcc,16,0.00467,50300,14.69068,342394
782,liuminjian,16,0.00467,50316,14.69535,342394
783,marcosdiez,16,0.00467,50332,14.70002,342394
784,MattesWhite,16,0.00467,50348,14.70470,342394
785,Mini256,16,0.00467,50364,14.70937,342394
786,Pearl1594,16,0.00467,50380,14.71404,342394
787,PranshuSrivastava,16,0.00467,50396,14.71872,342394
788,pratikgote,16,0.00467,50412,14.72339,342394
789,pymongo,16,0.00467,50428,14.72806,342394
790,Rains6,16,0.00467,50444,14.73273,342394
791,rodrigobaron,16,0.00467,50460,14.73741,342394
792,RyanAoh,16,0.00467,50476,14.74208,342394
793,shioshiota,16,0.00467,50492,14.74675,342394
794,skoech,16,0.00467,50508,14.75143,342394
795,sturman,16,0.00467,50524,14.75610,342394
796,TimelifeCzy,16,0.00467,50540,14.76077,342394
797,tomhuang12,16,0.00467,50556,14.76545,342394
798,trasc,16,0.00467,50572,14.77012,342394
799,vamsiammineni,16,0.00467,50588,14.77479,342394
800,yongzhang,16,0.00467,50604,14.77946,342394
801,yq314,16,0.00467,50620,14.78414,342394
802,zach030,16,0.00467,50636,14.78881,342394
803,916264367,15,0.00438,50651,14.79319,342394
804,acm19,15,0.00438,50666,14.79757,342394
805,ahsan-n,15,0.00438,50681,14.80195,342394
806,aintbrokedontfix,15,0.00438,50696,14.80633,342394
807,aliusmiles,15,0.00438,50711,14.81072,342394
808,avaakash,15,0.00438,50726,14.81510,342394
809,avinashupadhya99,15,0.00438,50741,14.81948,342394
810,Balasundaram,15,0.00438,50756,14.82386,342394
811,caden2016,15,0.00438,50771,14.82824,342394
812,chenf1234,15,0.00438,50786,14.83262,342394
813,dkpeall,15,0.00438,50801,14.83700,342394
814,dn-scribe,15,0.00438,50816,14.84138,342394
815,El-Moatasem,15,0.00438,50831,14.84576,342394
816,froblesmartin,15,0.00438,50846,14.85014,342394
817,glen-uc,15,0.00438,50861,14.85452,342394
818,gmambro,15,0.00438,50876,14.85891,342394
819,grafvonb,15,0.00438,50891,14.86329,342394
820,guo-shaoge,15,0.00438,50906,14.86767,342394
821,hrishavjha,15,0.00438,50921,14.87205,342394
822,hueifeng,15,0.00438,50936,14.87643,342394
823,iantivey,15,0.00438,50951,14.88081,342394
824,iarunpaul,15,0.00438,50966,14.88519,342394
825,JCzz,15,0.00438,50981,14.88957,342394
826,jdnurme,15,0.00438,50996,14.89395,342394
827,jpedro1992,15,0.00438,51011,14.89833,342394
828,kaiszybiak,15,0.00438,51026,14.90271,342394
829,khatrig,15,0.00438,51041,14.90710,342394
830,leonsp-ai,15,0.00438,51056,14.91148,342394
831,liqiangz,15,0.00438,51071,14.91586,342394
832,maugustosilva,15,0.00438,51086,14.92024,342394
833,mikebarkas,15,0.00438,51101,14.92462,342394
834,nishit93-hub,15,0.00438,51116,14.92900,342394
835,nitinatgh,15,0.00438,51131,14.93338,342394
836,olivierbouffet,15,0.00438,51146,14.93776,342394
837,penghuazhou,15,0.00438,51161,14.94214,342394
838,perezjasonr,15,0.00438,51176,14.94652,342394
839,pnbrown,15,0.00438,51191,14.95090,342394
840,Polokghosh53,15,0.00438,51206,14.95529,342394
841,pradipd,15,0.00438,51221,14.95967,342394
842,ProvenGuilty,15,0.00438,51236,14.96405,342394
843,pxp928,15,0.00438,51251,14.96843,342394
844,qinxx108,15,0.00438,51266,14.97281,342394
845,satrox28,15,0.00438,51281,14.97719,342394
846,shivamkm07,15,0.00438,51296,14.98157,342394
847,SihengCui,15,0.00438,51311,14.98595,342394
848,szubster,15,0.00438,51326,14.99033,342394
849,tanguofu,15,0.00438,51341,14.99471,342394
850,ThorManager,15,0.00438,51356,14.99909,342394
851,timmyyuan,15,0.00438,51371,15.00348,342394
852,tkoeppe,15,0.00438,51386,15.00786,342394
853,Vr00mm,15,0.00438,51401,15.01224,342394
854,wanghong230,15,0.00438,51416,15.01662,342394
855,warunicorn19,15,0.00438,51431,15.02100,342394
856,watermelon-brother,15,0.00438,51446,15.02538,342394
857,Wwwsylvia,15,0.00438,51461,15.02976,342394
858,xuegege5290,15,0.00438,51476,15.03414,342394
859,ysksuzuki,15,0.00438,51491,15.03852,342394
860,zyjhtangtang,15,0.00438,51506,15.04290,342394
861,00ssh,14,0.00409,51520,15.04699,342394
862,Aishwarya-Hebbar,14,0.00409,51534,15.05108,342394
863,alexey-medvedchikov,14,0.00409,51548,15.05517,342394
864,aron,14,0.00409,51562,15.05926,342394
865,arvind-murty,14,0.00409,51576,15.06335,342394
866,b0b3rt,14,0.00409,51590,15.06744,342394
867,bai3shuo4,14,0.00409,51604,15.07153,342394
868,beastob,14,0.00409,51618,15.07561,342394
869,bianchi2,14,0.00409,51632,15.07970,342394
870,chrism417,14,0.00409,51646,15.08379,342394
871,cwyl02,14,0.00409,51660,15.08788,342394
872,DanStough,14,0.00409,51674,15.09197,342394
873,djdongjin,14,0.00409,51688,15.09606,342394
874,ec4n6,14,0.00409,51702,15.10015,342394
875,endersonmenezes,14,0.00409,51716,15.10424,342394
876,eric846,14,0.00409,51730,15.10833,342394
877,ghevge,14,0.00409,51744,15.11241,342394
878,GoFightNguyen,14,0.00409,51758,15.11650,342394
879,gr8Adakron,14,0.00409,51772,15.12059,342394
880,guillaumBrisard,14,0.00409,51786,15.12468,342394
881,heshengyuan1311,14,0.00409,51800,15.12877,342394
882,icecoffee531,14,0.00409,51814,15.13286,342394
883,jala-dx,14,0.00409,51828,15.13695,342394
884,JamesMBartlett,14,0.00409,51842,15.14104,342394
885,JarrodJ83,14,0.00409,51856,15.14513,342394
886,jialez0,14,0.00409,51870,15.14921,342394
887,JoeyHwong-gk,14,0.00409,51884,15.15330,342394
888,jon-fearer,14,0.00409,51898,15.15739,342394
889,joshuabezaleel,14,0.00409,51912,15.16148,342394
890,jsalatiel,14,0.00409,51926,15.16557,342394
891,jsun-splunk,14,0.00409,51940,15.16966,342394
892,juliusl,14,0.00409,51954,15.17375,342394
893,kbreit,14,0.00409,51968,15.17784,342394
894,lamc,14,0.00409,51982,15.18192,342394
895,leland17,14,0.00409,51996,15.18601,342394
896,lesovsky,14,0.00409,52010,15.19010,342394
897,luigizhou,14,0.00409,52024,15.19419,342394
898,mattoberle,14,0.00409,52038,15.19828,342394
899,mingregister,14,0.00409,52052,15.20237,342394
900,mohanli-ml,14,0.00409,52066,15.20646,342394
901,pkwarren,14,0.00409,52080,15.21055,342394
902,radoslaw-wielonski-nc,14,0.00409,52094,15.21464,342394
903,ritwizsinha,14,0.00409,52108,15.21872,342394
904,rjhenry,14,0.00409,52122,15.22281,342394
905,robertjahn,14,0.00409,52136,15.22690,342394
906,RodionGork,14,0.00409,52150,15.23099,342394
907,ron1,14,0.00409,52164,15.23508,342394
908,ryanrupp,14,0.00409,52178,15.23917,342394
909,sanxun0325,14,0.00409,52192,15.24326,342394
910,sdowell,14,0.00409,52206,15.24735,342394
911,snuggie12,14,0.00409,52220,15.25144,342394
912,Somoshree,14,0.00409,52234,15.25552,342394
913,syhpoon,14,0.00409,52248,15.25961,342394
914,therynamo,14,0.00409,52262,15.26370,342394
915,tiezhuoyu,14,0.00409,52276,15.26779,342394
916,TomShawn,14,0.00409,52290,15.27188,342394
917,tonyttz,14,0.00409,52304,15.27597,342394
918,usrbinkat,14,0.00409,52318,15.28006,342394
919,vasireddy99,14,0.00409,52332,15.28415,342394
920,victor-sudakov,14,0.00409,52346,15.28824,342394
921,vidhem,14,0.00409,52360,15.29232,342394
922,VivekThrivikraman-est,14,0.00409,52374,15.29641,342394
923,wajika,14,0.00409,52388,15.30050,342394
924,wgitg,14,0.00409,52402,15.30459,342394
925,yzeng25,14,0.00409,52416,15.30868,342394
926,zhanghe9702,14,0.00409,52430,15.31277,342394
927,66li,13,0.00380,52443,15.31657,342394
928,aateeqi,13,0.00380,52456,15.32036,342394
929,ahmedalhulaibi,13,0.00380,52469,15.32416,342394
930,ajdergute,13,0.00380,52482,15.32796,342394
931,alanpoon,13,0.00380,52495,15.33175,342394
932,alex-vmw,13,0.00380,52508,15.33555,342394
933,allanian,13,0.00380,52521,15.33935,342394
934,allenporter,13,0.00380,52534,15.34314,342394
935,amibhi,13,0.00380,52547,15.34694,342394
936,ankitm123,13,0.00380,52560,15.35074,342394
937,anrossi,13,0.00380,52573,15.35453,342394
938,ashankar1,13,0.00380,52586,15.35833,342394
939,AurelienGasser,13,0.00380,52599,15.36213,342394
940,cevian,13,0.00380,52612,15.36592,342394
941,cyrilcros,13,0.00380,52625,15.36972,342394
942,danpodeanu,13,0.00380,52638,15.37352,342394
943,denisivan0v,13,0.00380,52651,15.37731,342394
944,dweber019,13,0.00380,52664,15.38111,342394
945,dylanlingelbach,13,0.00380,52677,15.38491,342394
946,Edimo24,13,0.00380,52690,15.38870,342394
947,ekalinin,13,0.00380,52703,15.39250,342394
948,elevenzhan,13,0.00380,52716,15.39630,342394
949,eloo,13,0.00380,52729,15.40009,342394
950,fatpat,13,0.00380,52742,15.40389,342394
951,gyz2009,13,0.00380,52755,15.40769,342394
952,Hoohaha,13,0.00380,52768,15.41149,342394
953,huangchong94,13,0.00380,52781,15.41528,342394
954,hxietkg,13,0.00380,52794,15.41908,342394
955,hyschumi,13,0.00380,52807,15.42288,342394
956,hzh0425,13,0.00380,52820,15.42667,342394
957,imneov,13,0.00380,52833,15.43047,342394
958,importhuman,13,0.00380,52846,15.43427,342394
959,jack-evans,13,0.00380,52859,15.43806,342394
960,jahrlin,13,0.00380,52872,15.44186,342394
961,janpieper-gcx,13,0.00380,52885,15.44566,342394
962,JarHMJ,13,0.00380,52898,15.44945,342394
963,jboesh,13,0.00380,52911,15.45325,342394
964,jebeaudet,13,0.00380,52924,15.45705,342394
965,jerry7z,13,0.00380,52937,15.46084,342394
966,JiaoDean,13,0.00380,52950,15.46464,342394
967,joaedwar,13,0.00380,52963,15.46844,342394
968,KMilhan,13,0.00380,52976,15.47223,342394
969,kpchen,13,0.00380,52989,15.47603,342394
970,kristiansvalland,13,0.00380,53002,15.47983,342394
971,leons727,13,0.00380,53015,15.48362,342394
972,lfpino,13,0.00380,53028,15.48742,342394
973,likunbyl,13,0.00380,53041,15.49122,342394
974,liu-song,13,0.00380,53054,15.49501,342394
975,liverbirdkte,13,0.00380,53067,15.49881,342394
976,mfuxi,13,0.00380,53080,15.50261,342394
977,michalmaka,13,0.00380,53093,15.50640,342394
978,miheer,13,0.00380,53106,15.51020,342394
979,ocraviotto,13,0.00380,53119,15.51400,342394
980,orweis,13,0.00380,53132,15.51780,342394
981,paullaffitte,13,0.00380,53145,15.52159,342394
982,phantasm66,13,0.00380,53158,15.52539,342394
983,pierreprinetti,13,0.00380,53171,15.52919,342394
984,qianjun1993,13,0.00380,53184,15.53298,342394
985,razo7,13,0.00380,53197,15.53678,342394
986,rck,13,0.00380,53210,15.54058,342394
987,R-omk,13,0.00380,53223,15.54437,342394
988,rtjfarrimond,13,0.00380,53236,15.54817,342394
989,RuliXu,13,0.00380,53249,15.55197,342394
990,rvalkenaers,13,0.00380,53262,15.55576,342394
991,RyanW8,13,0.00380,53275,15.55956,342394
992,sachithmuhandiram,13,0.00380,53288,15.56336,342394
993,SamLR,13,0.00380,53301,15.56715,342394
994,satyapriyamishra222,13,0.00380,53314,15.57095,342394
995,shhdgit,13,0.00380,53327,15.57475,342394
996,Shoothzj,13,0.00380,53340,15.57854,342394
997,simrangupta234,13,0.00380,53353,15.58234,342394
998,singeleaf,13,0.00380,53366,15.58614,342394
999,siredmar,13,0.00380,53379,15.58993,342394
1000,sivanzcw,13,0.00380,53392,15.59373,342394
1001,sjoerdsimons,13,0.00380,53405,15.59753,342394
1002,skycyan,13,0.00380,53418,15.60132,342394
1003,slow-zhang,13,0.00380,53431,15.60512,342394
1004,SomalianIvan,13,0.00380,53444,15.60892,342394
1005,spencerwilson,13,0.00380,53457,15.61272,342394
1006,spider0061,13,0.00380,53470,15.61651,342394
1007,su-gupta,13,0.00380,53483,15.62031,342394
1008,TheAbhishekS,13,0.00380,53496,15.62411,342394
1009,thedadams,13,0.00380,53509,15.62790,342394
1010,TonsnakeLin,13,0.00380,53522,15.63170,342394
1011,vibhorrawat,13,0.00380,53535,15.63550,342394
1012,vishjain,13,0.00380,53548,15.63929,342394
1013,wujunwei,13,0.00380,53561,15.64309,342394
1014,zdzichu,13,0.00380,53574,15.64689,342394
1015,zenhighzer,13,0.00380,53587,15.65068,342394
1016,zzehring,13,0.00380,53600,15.65448,342394
1017,4molybdenum2,12,0.00350,53612,15.65798,342394
1018,AlexandrClick,12,0.00350,53624,15.66149,342394
1019,algebra2k,12,0.00350,53636,15.66499,342394
1020,alibo,12,0.00350,53648,15.66850,342394
1021,anodelman,12,0.00350,53660,15.67200,342394
1022,artqzn,12,0.00350,53672,15.67551,342394
1023,AustinSiu,12,0.00350,53684,15.67901,342394
1024,badis,12,0.00350,53696,15.68252,342394
1025,beef9999,12,0.00350,53708,15.68602,342394
1026,birenroy,12,0.00350,53720,15.68953,342394
1027,BronzeDeer,12,0.00350,53732,15.69303,342394
1028,brunojcm,12,0.00350,53744,15.69654,342394
1029,cbsfly,12,0.00350,53756,15.70004,342394
1030,chrispatmore,12,0.00350,53768,15.70355,342394
1031,compactcfusr,12,0.00350,53780,15.70705,342394
1032,czomo,12,0.00350,53792,15.71056,342394
1033,d0u9,12,0.00350,53804,15.71406,342394
1034,dafu-wu,12,0.00350,53816,15.71757,342394
1035,daniellavoie,12,0.00350,53828,15.72107,342394
1036,DavidVentura,12,0.00350,53840,15.72457,342394
1037,dchancogne,12,0.00350,53852,15.72808,342394
1038,denis-codefresh,12,0.00350,53864,15.73158,342394
1039,diannahu,12,0.00350,53876,15.73509,342394
1040,dolevf,12,0.00350,53888,15.73859,342394
1041,Dragoncell,12,0.00350,53900,15.74210,342394
1042,dwerder,12,0.00350,53912,15.74560,342394
1043,edithturn,12,0.00350,53924,15.74911,342394
1044,elad-codefresh,12,0.00350,53936,15.75261,342394
1045,emilgelman,12,0.00350,53948,15.75612,342394
1046,Emin3mU,12,0.00350,53960,15.75962,342394
1047,fnxpt,12,0.00350,53972,15.76313,342394
1048,ghl116,12,0.00350,53984,15.76663,342394
1049,haiker2011,12,0.00350,53996,15.77014,342394
1050,hisa-tanaka,12,0.00350,54008,15.77364,342394
1051,hjiajing,12,0.00350,54020,15.77715,342394
1052,ianbillett,12,0.00350,54032,15.78065,342394
1053,IMPranshu,12,0.00350,54044,15.78416,342394
1054,jklaw90,12,0.00350,54056,15.78766,342394
1055,jleloup,12,0.00350,54068,15.79116,342394
1056,JoupainMD,12,0.00350,54080,15.79467,342394
1057,kevinschoonover,12,0.00350,54092,15.79817,342394
1058,Leavrth,12,0.00350,54104,15.80168,342394
1059,L-jasmine,12,0.00350,54116,15.80518,342394
1060,lukasmoellerch,12,0.00350,54128,15.80869,342394
1061,luodw,12,0.00350,54140,15.81219,342394
1062,majimenez-stratio,12,0.00350,54152,15.81570,342394
1063,mattheidelbaugh,12,0.00350,54164,15.81920,342394
1064,mlieberman85,12,0.00350,54176,15.82271,342394
1065,moyuduo,12,0.00350,54188,15.82621,342394
1066,MrMYHuang,12,0.00350,54200,15.82972,342394
1067,mullerch,12,0.00350,54212,15.83322,342394
1068,MurzNN,12,0.00350,54224,15.83673,342394
1069,nemoshlag,12,0.00350,54236,15.84023,342394
1070,NewmanJ1987,12,0.00350,54248,15.84374,342394
1071,nielstenboom,12,0.00350,54260,15.84724,342394
1072,nikParasyr,12,0.00350,54272,15.85075,342394
1073,OliverMKing,12,0.00350,54284,15.85425,342394
1074,pkit,12,0.00350,54296,15.85775,342394
1075,prnaraya,12,0.00350,54308,15.86126,342394
1076,racdev,12,0.00350,54320,15.86476,342394
1077,ReigenDing,12,0.00350,54332,15.86827,342394
1078,rino-pupkin,12,0.00350,54344,15.87177,342394
1079,robertgates55,12,0.00350,54356,15.87528,342394
1080,roeelandesman,12,0.00350,54368,15.87878,342394
1081,rotem-codefresh,12,0.00350,54380,15.88229,342394
1082,rpiceage,12,0.00350,54392,15.88579,342394
1083,sachinar,12,0.00350,54404,15.88930,342394
1084,samip5,12,0.00350,54416,15.89280,342394
1085,sebastiaoamaro,12,0.00350,54428,15.89631,342394
1086,sherifkayad,12,0.00350,54440,15.89981,342394
1087,Shubh28698,12,0.00350,54452,15.90332,342394
1088,skol101,12,0.00350,54464,15.90682,342394
1089,tarruda,12,0.00350,54476,15.91033,342394
1090,TheQueenIsDead,12,0.00350,54488,15.91383,342394
1091,tjhop,12,0.00350,54500,15.91734,342394
1092,tmsnan,12,0.00350,54512,15.92084,342394
1093,tokers,12,0.00350,54524,15.92434,342394
1094,Tomoku-dm,12,0.00350,54536,15.92785,342394
1095,tomsunyu,12,0.00350,54548,15.93135,342394
1096,tydhot,12,0.00350,54560,15.93486,342394
1097,unai-ttxu,12,0.00350,54572,15.93836,342394
1098,vakul-gupta-flp,12,0.00350,54584,15.94187,342394
1099,verma-kunal,12,0.00350,54596,15.94537,342394
1100,vlavorini,12,0.00350,54608,15.94888,342394
1101,wangl0320,12,0.00350,54620,15.95238,342394
1102,winkee01,12,0.00350,54632,15.95589,342394
1103,yossicohn,12,0.00350,54644,15.95939,342394
1104,zhangyangyu,12,0.00350,54656,15.96290,342394
1105,zhoupoko2000,12,0.00350,54668,15.96640,342394
1106,zonito,12,0.00350,54680,15.96991,342394
1107,2339478391,11,0.00321,54691,15.97312,342394
1108,760515805,11,0.00321,54702,15.97633,342394
1109,abnormall,11,0.00321,54713,15.97954,342394
1110,Agares,11,0.00321,54724,15.98276,342394
1111,aholic,11,0.00321,54735,15.98597,342394
1112,alice-suse,11,0.00321,54746,15.98918,342394
1113,amirschw,11,0.00321,54757,15.99239,342394
1114,arash-bizcover,11,0.00321,54768,15.99561,342394
1115,armsnyder,11,0.00321,54779,15.99882,342394
1116,arthurpitman,11,0.00321,54790,16.00203,342394
1117,asskss,11,0.00321,54801,16.00525,342394
1118,berlinsaint,11,0.00321,54812,16.00846,342394
1119,cdelzotti,11,0.00321,54823,16.01167,342394
1120,ChetHosey,11,0.00321,54834,16.01488,342394
1121,chris13524,11,0.00321,54845,16.01810,342394
1122,damdo,11,0.00321,54856,16.02131,342394
1123,davedavedavid,11,0.00321,54867,16.02452,342394
1124,davidy718,11,0.00321,54878,16.02773,342394
1125,dgovinndaraju12,11,0.00321,54889,16.03095,342394
1126,dmitriklein,11,0.00321,54900,16.03416,342394
1127,edarha,11,0.00321,54911,16.03737,342394
1128,edin44,11,0.00321,54922,16.04058,342394
1129,ekbduffy,11,0.00321,54933,16.04380,342394
1130,Ericra95,11,0.00321,54944,16.04701,342394
1131,etep,11,0.00321,54955,16.05022,342394
1132,fangchengjie,11,0.00321,54966,16.05344,342394
1133,findmyway,11,0.00321,54977,16.05665,342394
1134,flashgorman-chorus,11,0.00321,54988,16.05986,342394
1135,FlorentATo,11,0.00321,54999,16.06307,342394
1136,gl-up,11,0.00321,55010,16.06629,342394
1137,gomakesix,11,0.00321,55021,16.06950,342394
1138,goushicui,11,0.00321,55032,16.07271,342394
1139,huangxuelun,11,0.00321,55043,16.07592,342394
1140,iamnoah,11,0.00321,55054,16.07914,342394
1141,itsnagaraj,11,0.00321,55065,16.08235,342394
1142,jagjeetst,11,0.00321,55076,16.08556,342394
1143,jamiees2,11,0.00321,55087,16.08877,342394
1144,jaredliw,11,0.00321,55098,16.09199,342394
1145,jepio,11,0.00321,55109,16.09520,342394
1146,JiahaoWei-RH,11,0.00321,55120,16.09841,342394
1147,JieDing,11,0.00321,55131,16.10163,342394
1148,jmpolom,11,0.00321,55142,16.10484,342394
1149,jonathanrainer,11,0.00321,55153,16.10805,342394
1150,katran001,11,0.00321,55164,16.11126,342394
1151,klihub,11,0.00321,55175,16.11448,342394
1152,lalex,11,0.00321,55186,16.11769,342394
1153,laudibert,11,0.00321,55197,16.12090,342394
1154,leewoobin789,11,0.00321,55208,16.12411,342394
1155,luhaopei,11,0.00321,55219,16.12733,342394
1156,lujiajing1126,11,0.00321,55230,16.13054,342394
1157,manjo-git,11,0.00321,55241,16.13375,342394
1158,marcobjorge,11,0.00321,55252,16.13697,342394
1159,mathildeHermet,11,0.00321,55263,16.14018,342394
1160,mikabytes,11,0.00321,55274,16.14339,342394
1161,mkossoris,11,0.00321,55285,16.14660,342394
1162,mvniekerk,11,0.00321,55296,16.14982,342394
1163,nee1esh,11,0.00321,55307,16.15303,342394
1164,neelayu,11,0.00321,55318,16.15624,342394
1165,nerdalert,11,0.00321,55329,16.15945,342394
1166,nigelwright-roam,11,0.00321,55340,16.16267,342394
1167,nmtsousa,11,0.00321,55351,16.16588,342394
1168,oertl,11,0.00321,55362,16.16909,342394
1169,Payback159,11,0.00321,55373,16.17230,342394
1170,pedro-stanaka,11,0.00321,55384,16.17552,342394
1171,pianiststickman,11,0.00321,55395,16.17873,342394
1172,pixie-labs-buildbot,11,0.00321,55406,16.18194,342394
1173,ponienselvan,11,0.00321,55417,16.18516,342394
1174,rpalkin,11,0.00321,55428,16.18837,342394
1175,SchoolGuy,11,0.00321,55439,16.19158,342394
1176,Sh1ftry,11,0.00321,55450,16.19479,342394
1177,shadowshot-x,11,0.00321,55461,16.19801,342394
1178,silverlyra,11,0.00321,55472,16.20122,342394
1179,smile-luobin,11,0.00321,55483,16.20443,342394
1180,splmatto,11,0.00321,55494,16.20764,342394
1181,srijan55,11,0.00321,55505,16.21086,342394
1182,sureshkachwa,11,0.00321,55516,16.21407,342394
1183,suyashtava,11,0.00321,55527,16.21728,342394
1184,tkrishtop,11,0.00321,55538,16.22049,342394
1185,TKTKTKK,11,0.00321,55549,16.22371,342394
1186,tobbez,11,0.00321,55560,16.22692,342394
1187,tomwolfgang,11,0.00321,55571,16.23013,342394
1188,uril,11,0.00321,55582,16.23335,342394
1189,vmihailenco,11,0.00321,55593,16.23656,342394
1190,wanshicheng,11,0.00321,55604,16.23977,342394
1191,wdrdres3qew5ts21,11,0.00321,55615,16.24298,342394
1192,webliupeng,11,0.00321,55626,16.24620,342394
1193,wilsonmoss,11,0.00321,55637,16.24941,342394
1194,wind57,11,0.00321,55648,16.25262,342394
1195,wllenyj,11,0.00321,55659,16.25583,342394
1196,wolffberg,11,0.00321,55670,16.25905,342394
1197,wpedrak,11,0.00321,55681,16.26226,342394
1198,wxyh,11,0.00321,55692,16.26547,342394
1199,xavierivadulla,11,0.00321,55703,16.26868,342394
1200,xibz,11,0.00321,55714,16.27190,342394
1201,xkilian,11,0.00321,55725,16.27511,342394
1202,yun-ling,11,0.00321,55736,16.27832,342394
1203,Yun-Ting,11,0.00321,55747,16.28154,342394
1204,zacharyrgonzales,11,0.00321,55758,16.28475,342394
1205,zeeke,11,0.00321,55769,16.28796,342394
1206,zhifei92,11,0.00321,55780,16.29117,342394
1207,zhonghui12,11,0.00321,55791,16.29439,342394
1208,zishen,11,0.00321,55802,16.29760,342394
1209,5had3z,10,0.00292,55812,16.30052,342394
1210,admgolovin,10,0.00292,55822,16.30344,342394
1211,alexrybch,10,0.00292,55832,16.30636,342394
1212,allenjol,10,0.00292,55842,16.30928,342394
1213,Alt-Shivam,10,0.00292,55852,16.31220,342394
1214,AlyssaBetty,10,0.00292,55862,16.31512,342394
1215,amazingyyc,10,0.00292,55872,16.31804,342394
1216,andreamlin,10,0.00292,55882,16.32096,342394
1217,andrewnazarov,10,0.00292,55892,16.32388,342394
1218,anneelisabethlelievre,10,0.00292,55902,16.32680,342394
1219,armenr,10,0.00292,55912,16.32973,342394
1220,arrowfeng,10,0.00292,55922,16.33265,342394
1221,AugustasV,10,0.00292,55932,16.33557,342394
1222,AWinterman,10,0.00292,55942,16.33849,342394
1223,A-Zee029,10,0.00292,55952,16.34141,342394
1224,babygoat,10,0.00292,55962,16.34433,342394
1225,beatrausch,10,0.00292,55972,16.34725,342394
1226,Bhupender-Y,10,0.00292,55982,16.35017,342394
1227,Boojapho,10,0.00292,55992,16.35309,342394
1228,carolinestere,10,0.00292,56002,16.35601,342394
1229,ccbeloy,10,0.00292,56012,16.35893,342394
1230,chengruizhe,10,0.00292,56022,16.36185,342394
1231,chickeaterbanana,10,0.00292,56032,16.36477,342394
1232,clcc2019,10,0.00292,56042,16.36769,342394
1233,codefromthecrypt,10,0.00292,56052,16.37061,342394
1234,CodingCanuck,10,0.00292,56062,16.37353,342394
1235,Coolp,10,0.00292,56072,16.37646,342394
1236,danquack,10,0.00292,56082,16.37938,342394
1237,dblate,10,0.00292,56092,16.38230,342394
1238,deepskyblue86,10,0.00292,56102,16.38522,342394
1239,dfeldman,10,0.00292,56112,16.38814,342394
1240,diana-borbe-consensys,10,0.00292,56122,16.39106,342394
1241,dimitarvdimitrov,10,0.00292,56132,16.39398,342394
1242,dquagebeur,10,0.00292,56142,16.39690,342394
1243,duttaANI,10,0.00292,56152,16.39982,342394
1244,dwangxxx,10,0.00292,56162,16.40274,342394
1245,evansheng,10,0.00292,56172,16.40566,342394
1246,Evreke,10,0.00292,56182,16.40858,342394
1247,fanzhihai0215,10,0.00292,56192,16.41150,342394
1248,fatjyc,10,0.00292,56202,16.41442,342394
1249,fhke,10,0.00292,56212,16.41734,342394
1250,fisherdarling,10,0.00292,56222,16.42026,342394
1251,gagoar,10,0.00292,56232,16.42318,342394
1252,geekgao,10,0.00292,56242,16.42611,342394
1253,gfonseca-tc,10,0.00292,56252,16.42903,342394
1254,Goodwine,10,0.00292,56262,16.43195,342394
1255,gregoryfranklin,10,0.00292,56272,16.43487,342394
1256,halfC,10,0.00292,56282,16.43779,342394
1257,hamidaria70,10,0.00292,56292,16.44071,342394
1258,hochuenw-dd,10,0.00292,56302,16.44363,342394
1259,humengyu2012,10,0.00292,56312,16.44655,342394
1260,hwaastad,10,0.00292,56322,16.44947,342394
1261,IcePigZDB,10,0.00292,56332,16.45239,342394
1262,jasha64,10,0.00292,56342,16.45531,342394
1263,jasonmillerstackpath,10,0.00292,56352,16.45823,342394
1264,jazka,10,0.00292,56362,16.46115,342394
1265,jiezhang0917,10,0.00292,56372,16.46407,342394
1266,joeldeteves,10,0.00292,56382,16.46699,342394
1267,joeyberkovitz,10,0.00292,56392,16.46991,342394
1268,johanneslarsson,10,0.00292,56402,16.47284,342394
1269,jorgecasar,10,0.00292,56412,16.47576,342394
1270,jskazinski,10,0.00292,56422,16.47868,342394
1271,JWKartheiser,10,0.00292,56432,16.48160,342394
1272,kakkotetsu,10,0.00292,56442,16.48452,342394
1273,Karthik-K-N,10,0.00292,56452,16.48744,342394
1274,keithalucas,10,0.00292,56462,16.49036,342394
1275,keshavprasadms,10,0.00292,56472,16.49328,342394
1276,killerkc12,10,0.00292,56482,16.49620,342394
1277,kim5566,10,0.00292,56492,16.49912,342394
1278,kokizzu,10,0.00292,56502,16.50204,342394
1279,LINKIWI,10,0.00292,56512,16.50496,342394
1280,linuxxin,10,0.00292,56522,16.50788,342394
1281,linxiulei,10,0.00292,56532,16.51080,342394
1282,lipingxue,10,0.00292,56542,16.51372,342394
1283,liuzqt,10,0.00292,56552,16.51664,342394
1284,lpcy,10,0.00292,56562,16.51957,342394
1285,LuBingtan,10,0.00292,56572,16.52249,342394
1286,LukaszByczynski,10,0.00292,56582,16.52541,342394
1287,matthewrobertson,10,0.00292,56592,16.52833,342394
1288,maxiloEmmmm,10,0.00292,56602,16.53125,342394
1289,mihivagyok,10,0.00292,56612,16.53417,342394
1290,mknyszek,10,0.00292,56622,16.53709,342394
1291,mosuke5,10,0.00292,56632,16.54001,342394
1292,muhamadto,10,0.00292,56642,16.54293,342394
1293,n4j,10,0.00292,56652,16.54585,342394
1294,neillturner,10,0.00292,56662,16.54877,342394
1295,niloc132,10,0.00292,56672,16.55169,342394
1296,noamzafrir,10,0.00292,56682,16.55461,342394
1297,novegit,10,0.00292,56692,16.55753,342394
1298,omarabid,10,0.00292,56702,16.56045,342394
1299,onimor,10,0.00292,56712,16.56337,342394
1300,only-test-linux,10,0.00292,56722,16.56629,342394
1301,owenammann,10,0.00292,56732,16.56922,342394
1302,pchan,10,0.00292,56742,16.57214,342394
1303,pcolazurdo,10,0.00292,56752,16.57506,342394
1304,piotrnosek,10,0.00292,56762,16.57798,342394
1305,plakyda-codefresh,10,0.00292,56772,16.58090,342394
1306,Raj-Dharwadkar,10,0.00292,56782,16.58382,342394
1307,rdxmb,10,0.00292,56792,16.58674,342394
1308,rickardgranberg,10,0.00292,56802,16.58966,342394
1309,Rory-Z,10,0.00292,56812,16.59258,342394
1310,rumstead,10,0.00292,56822,16.59550,342394
1311,sai-arigeli,10,0.00292,56832,16.59842,342394
1312,samuelBB,10,0.00292,56842,16.60134,342394
1313,sanjeevshar,10,0.00292,56852,16.60426,342394
1314,scirner22,10,0.00292,56862,16.60718,342394
1315,scottnice,10,0.00292,56872,16.61010,342394
1316,sdarwin,10,0.00292,56882,16.61302,342394
1317,simonjbeaumont,10,0.00292,56892,16.61595,342394
1318,sjberman,10,0.00292,56902,16.61887,342394
1319,Sparkton,10,0.00292,56912,16.62179,342394
1320,Spikhalskiy,10,0.00292,56922,16.62471,342394
1321,StarryVae,10,0.00292,56932,16.62763,342394
1322,steve-gray,10,0.00292,56942,16.63055,342394
1323,thbishop-intuit,10,0.00292,56952,16.63347,342394
1324,timblaktu,10,0.00292,56962,16.63639,342394
1325,trentcain,10,0.00292,56972,16.63931,342394
1326,tutorguai,10,0.00292,56982,16.64223,342394
1327,valorl,10,0.00292,56992,16.64515,342394
1328,VariableExp0rt,10,0.00292,57002,16.64807,342394
1329,wangyysde,10,0.00292,57012,16.65099,342394
1330,wim-de-groot,10,0.00292,57022,16.65391,342394
1331,witekest,10,0.00292,57032,16.65683,342394
1332,wjtracey,10,0.00292,57042,16.65975,342394
1333,wufunc,10,0.00292,57052,16.66268,342394
1334,xing0821,10,0.00292,57062,16.66560,342394
1335,ystkfujii,10,0.00292,57072,16.66852,342394
1336,yudiezheng1127,10,0.00292,57082,16.67144,342394
1337,yuyadiel,10,0.00292,57092,16.67436,342394
1338,zbhuang2008,10,0.00292,57102,16.67728,342394
1339,zestysoft,10,0.00292,57112,16.68020,342394
1340,zheyu001,10,0.00292,57122,16.68312,342394
1341,zhhuabj,10,0.00292,57132,16.68604,342394
1342,zhongqishang,10,0.00292,57142,16.68896,342394
1343,zhongr3n,10,0.00292,57152,16.69188,342394
1344,ziansong,10,0.00292,57162,16.69480,342394
1345,zivfuture,10,0.00292,57172,16.69772,342394
1346,zqzten,10,0.00292,57182,16.70064,342394
1347,1978629634,9,0.00263,57191,16.70327,342394
1348,ajvn,9,0.00263,57200,16.70590,342394
1349,akshaydmore,9,0.00263,57209,16.70853,342394
1350,albertdb,9,0.00263,57218,16.71116,342394
1351,aldemira,9,0.00263,57227,16.71379,342394
1352,amoore877,9,0.00263,57236,16.71641,342394
1353,ancientstraits,9,0.00263,57245,16.71904,342394
1354,AndrewNiven1,9,0.00263,57254,16.72167,342394
1355,anicr7,9,0.00263,57263,16.72430,342394
1356,anubisg1,9,0.00263,57272,16.72693,342394
1357,aragos,9,0.00263,57281,16.72956,342394
1358,Argh4k,9,0.00263,57290,16.73219,342394
1359,ashishgoyal111,9,0.00263,57299,16.73481,342394
1360,ashokmariyala,9,0.00263,57308,16.73744,342394
1361,ayr-ton,9,0.00263,57317,16.74007,342394
1362,balalnx16,9,0.00263,57326,16.74270,342394
1363,benbek,9,0.00263,57335,16.74533,342394
1364,benjaminp,9,0.00263,57344,16.74796,342394
1365,Bez625,9,0.00263,57353,16.75059,342394
1366,bkircher,9,0.00263,57362,16.75321,342394
1367,BloodyIron,9,0.00263,57371,16.75584,342394
1368,c0rv4x,9,0.00263,57380,16.75847,342394
1369,chance19,9,0.00263,57389,16.76110,342394
1370,Chenhb123,9,0.00263,57398,16.76373,342394
1371,Cifer0325,9,0.00263,57407,16.76636,342394
1372,CollinShoop,9,0.00263,57416,16.76899,342394
1373,craigminihan,9,0.00263,57425,16.77161,342394
1374,criztovyl,9,0.00263,57434,16.77424,342394
1375,Cylix,9,0.00263,57443,16.77687,342394
1376,dak-x,9,0.00263,57452,16.77950,342394
1377,danielh-codefresh,9,0.00263,57461,16.78213,342394
1378,danielm-codefresh,9,0.00263,57470,16.78476,342394
1379,dbpolito,9,0.00263,57479,16.78739,342394
1380,denis-reblaze,9,0.00263,57488,16.79001,342394
1381,dereknex,9,0.00263,57497,16.79264,342394
1382,devillove084,9,0.00263,57506,16.79527,342394
1383,djloude,9,0.00263,57515,16.79790,342394
1384,djplt,9,0.00263,57524,16.80053,342394
1385,dubyte,9,0.00263,57533,16.80316,342394
1386,dumb0002,9,0.00263,57542,16.80579,342394
1387,elakito,9,0.00263,57551,16.80841,342394
1388,emanuelr93,9,0.00263,57560,16.81104,342394
1389,emiran-orange,9,0.00263,57569,16.81367,342394
1390,ernado,9,0.00263,57578,16.81630,342394
1391,Estherbdf,9,0.00263,57587,16.81893,342394
1392,feeltimeQ,9,0.00263,57596,16.82156,342394
1393,Ferdudas97,9,0.00263,57605,16.82419,342394
1394,FlightToFreedom,9,0.00263,57614,16.82681,342394
1395,francesco995,9,0.00263,57623,16.82944,342394
1396,franznemeth,9,0.00263,57632,16.83207,342394
1397,frebib,9,0.00263,57641,16.83470,342394
1398,fred214,9,0.00263,57650,16.83733,342394
1399,fungiboletus,9,0.00263,57659,16.83996,342394
1400,GabMgt,9,0.00263,57668,16.84258,342394
1401,gozeloglu,9,0.00263,57677,16.84521,342394
1402,GrahamCampbell,9,0.00263,57686,16.84784,342394
1403,guodongli-google,9,0.00263,57695,16.85047,342394
1404,GuyPaddock,9,0.00263,57704,16.85310,342394
1405,hmstepanek,9,0.00263,57713,16.85573,342394
1406,hodgesds,9,0.00263,57722,16.85836,342394
1407,idrissneumann,9,0.00263,57731,16.86098,342394
1408,itaru2622,9,0.00263,57740,16.86361,342394
1409,jabdoa2,9,0.00263,57749,16.86624,342394
1410,jacks-reid,9,0.00263,57758,16.86887,342394
1411,jamezrin,9,0.00263,57767,16.87150,342394
1412,JanScheurich,9,0.00263,57776,16.87413,342394
1413,jbhennin,9,0.00263,57785,16.87676,342394
1414,jgrund,9,0.00263,57794,16.87938,342394
1415,jixinchi,9,0.00263,57803,16.88201,342394
1416,jklippel,9,0.00263,57812,16.88464,342394
1417,jluk-box,9,0.00263,57821,16.88727,342394
1418,johanhammar,9,0.00263,57830,16.88990,342394
1419,johnkeates,9,0.00263,57839,16.89253,342394
1420,joshuasimon-taulia,9,0.00263,57848,16.89516,342394
1421,jowliwon,9,0.00263,57857,16.89778,342394
1422,jvrahav,9,0.00263,57866,16.90041,342394
1423,j-zimnowoda,9,0.00263,57875,16.90304,342394
1424,kellyma2,9,0.00263,57884,16.90567,342394
1425,kennethzfeng,9,0.00263,57893,16.90830,342394
1426,kevin-lindsay-1,9,0.00263,57902,16.91093,342394
1427,kiddingl,9,0.00263,57911,16.91356,342394
1428,kranurag7,9,0.00263,57920,16.91618,342394
1429,kujiraitakahiro,9,0.00263,57929,16.91881,342394
1430,LanDinh,9,0.00263,57938,16.92144,342394
1431,lchayoun,9,0.00263,57947,16.92407,342394
1432,loicmathieu,9,0.00263,57956,16.92670,342394
1433,louisnow,9,0.00263,57965,16.92933,342394
1434,lvfei103650,9,0.00263,57974,16.93196,342394
1435,lwmqwer,9,0.00263,57983,16.93458,342394
1436,MalulDekel,9,0.00263,57992,16.93721,342394
1437,maoueh,9,0.00263,58001,16.93984,342394
1438,martinkuba,9,0.00263,58010,16.94247,342394
1439,mbeards,9,0.00263,58019,16.94510,342394
1440,mcrio,9,0.00263,58028,16.94773,342394
1441,mdibaiee,9,0.00263,58037,16.95036,342394
1442,meastp,9,0.00263,58046,16.95298,342394
1443,microyahoo,9,0.00263,58055,16.95561,342394
1444,mjrist,9,0.00263,58064,16.95824,342394
1445,mkoertgen,9,0.00263,58073,16.96087,342394
1446,mrjoelkamp,9,0.00263,58082,16.96350,342394
1447,mvkrishna86,9,0.00263,58091,16.96613,342394
1448,nappa85,9,0.00263,58100,16.96876,342394
1449,NassimBtk,9,0.00263,58109,16.97138,342394
1450,NavinKu10,9,0.00263,58118,16.97401,342394
1451,Nizifan,9,0.00263,58127,16.97664,342394
1452,nshankar13,9,0.00263,58136,16.97927,342394
1453,oakad,9,0.00263,58145,16.98190,342394
1454,OpenGuidou,9,0.00263,58154,16.98453,342394
1455,oren-zohar,9,0.00263,58163,16.98716,342394
1456,osherdp,9,0.00263,58172,16.98978,342394
1457,petejespersqbe,9,0.00263,58181,16.99241,342394
1458,pgoyal01,9,0.00263,58190,16.99504,342394
1459,politician,9,0.00263,58199,16.99767,342394
1460,qfframb,9,0.00263,58208,17.00030,342394
1461,qfiard,9,0.00263,58217,17.00293,342394
1462,qixiaobo,9,0.00263,58226,17.00556,342394
1463,qkfrksvl,9,0.00263,58235,17.00818,342394
1464,ra-grover,9,0.00263,58244,17.01081,342394
1465,raphaelauv,9,0.00263,58253,17.01344,342394
1466,raulcabello,9,0.00263,58262,17.01607,342394
1467,rexnp,9,0.00263,58271,17.01870,342394
1468,rmalchow,9,0.00263,58280,17.02133,342394
1469,rmarting,9,0.00263,58289,17.02395,342394
1470,robtayl0r,9,0.00263,58298,17.02658,342394
1471,ryanlyy,9,0.00263,58307,17.02921,342394
1472,SABERYJS,9,0.00263,58316,17.03184,342394
1473,sachin-kumar-ik8,9,0.00263,58325,17.03447,342394
1474,saikrishna397,9,0.00263,58334,17.03710,342394
1475,scheler,9,0.00263,58343,17.03973,342394
1476,schmikei,9,0.00263,58352,17.04235,342394
1477,Schramp,9,0.00263,58361,17.04498,342394
1478,shelefg,9,0.00263,58370,17.04761,342394
1479,shyodx,9,0.00263,58379,17.05024,342394
1480,simonsuns,9,0.00263,58388,17.05287,342394
1481,singvey999,9,0.00263,58397,17.05550,342394
1482,sloorush,9,0.00263,58406,17.05813,342394
1483,SoaringAnecdotalBear,9,0.00263,58415,17.06075,342394
1484,spiros-p,9,0.00263,58424,17.06338,342394
1485,sschegolev,9,0.00263,58433,17.06601,342394
1486,ssmall,9,0.00263,58442,17.06864,342394
1487,sullis,9,0.00263,58451,17.07127,342394
1488,summerisc,9,0.00263,58460,17.07390,342394
1489,syntastical,9,0.00263,58469,17.07653,342394
1490,takeda,9,0.00263,58478,17.07915,342394
1491,tanujd11,9,0.00263,58487,17.08178,342394
1492,THEMOSTHIGH0618,9,0.00263,58496,17.08441,342394
1493,tholvoleak,9,0.00263,58505,17.08704,342394
1494,thomascoquet,9,0.00263,58514,17.08967,342394
1495,tierra,9,0.00263,58523,17.09230,342394
1496,tspearconquest,9,0.00263,58532,17.09493,342394
1497,TsubasaEX,9,0.00263,58541,17.09755,342394
1498,Udit107710,9,0.00263,58550,17.10018,342394
1499,uhari03,9,0.00263,58559,17.10281,342394
1500,venukarnati92,9,0.00263,58568,17.10544,342394
1501,vietanhduong,9,0.00263,58577,17.10807,342394
1502,vrince,9,0.00263,58586,17.11070,342394
1503,wawlian,9,0.00263,58595,17.11333,342394
1504,wilfriedroset,9,0.00263,58604,17.11595,342394
1505,wu0407,9,0.00263,58613,17.11858,342394
1506,xp-1000,9,0.00263,58622,17.12121,342394
1507,yangvipguang,9,0.00263,58631,17.12384,342394
1508,yanndegat,9,0.00263,58640,17.12647,342394
1509,YaronDror23,9,0.00263,58649,17.12910,342394
1510,yogisec,9,0.00263,58658,17.13173,342394
1511,ZBoIsHere,9,0.00263,58667,17.13435,342394
1512,zhftxdy,9,0.00263,58676,17.13698,342394
1513,zhoudayongdennis,9,0.00263,58685,17.13961,342394
1514,13567436138,8,0.00234,58693,17.14195,342394
1515,359859461,8,0.00234,58701,17.14428,342394
1516,3V3RYONE,8,0.00234,58709,17.14662,342394
1517,3Xpl0it3r,8,0.00234,58717,17.14896,342394
1518,844700118,8,0.00234,58725,17.15129,342394
1519,AAber,8,0.00234,58733,17.15363,342394
1520,abaus-vc,8,0.00234,58741,17.15597,342394
1521,abhisheksinghbaghel,8,0.00234,58749,17.15830,342394
1522,aemperador,8,0.00234,58757,17.16064,342394
1523,ajsaclayan,8,0.00234,58765,17.16298,342394
1524,AlexanderBabel,8,0.00234,58773,17.16531,342394
1525,alexbiehl,8,0.00234,58781,17.16765,342394
1526,alisabzevari,8,0.00234,58789,17.16999,342394
1527,alkmim,8,0.00234,58797,17.17232,342394
1528,almson,8,0.00234,58805,17.17466,342394
1529,andrewhu-hcl,8,0.00234,58813,17.17699,342394
1530,annettejanewilson,8,0.00234,58821,17.17933,342394
1531,anyulled,8,0.00234,58829,17.18167,342394
1532,argl,8,0.00234,58837,17.18400,342394
1533,astroparam,8,0.00234,58845,17.18634,342394
1534,asummers,8,0.00234,58853,17.18868,342394
1535,autumn0207,8,0.00234,58861,17.19101,342394
1536,aysabzevar,8,0.00234,58869,17.19335,342394
1537,ayushghosh,8,0.00234,58877,17.19569,342394
1538,balonik,8,0.00234,58885,17.19802,342394
1539,bartcode,8,0.00234,58893,17.20036,342394
1540,beyondyinjl2,8,0.00234,58901,17.20270,342394
1541,bigfleet,8,0.00234,58909,17.20503,342394
1542,biskit,8,0.00234,58917,17.20737,342394
1543,bobykus31,8,0.00234,58925,17.20971,342394
1544,brandonLyonCf,8,0.00234,58933,17.21204,342394
1545,brickpattern,8,0.00234,58941,17.21438,342394
1546,brovoca,8,0.00234,58949,17.21672,342394
1547,brumhard,8,0.00234,58957,17.21905,342394
1548,buggithubs,8,0.00234,58965,17.22139,342394
1549,caeugusmao,8,0.00234,58973,17.22372,342394
1550,Cellebyte,8,0.00234,58981,17.22606,342394
1551,cfredri4,8,0.00234,58989,17.22840,342394
1552,childe,8,0.00234,58997,17.23073,342394
1553,chris-aeviator,8,0.00234,59005,17.23307,342394
1554,chrisreddington,8,0.00234,59013,17.23541,342394
1555,clintonyeb,8,0.00234,59021,17.23774,342394
1556,cocampbe,8,0.00234,59029,17.24008,342394
1557,CodeGlitcher,8,0.00234,59037,17.24242,342394
1558,cospotato,8,0.00234,59045,17.24475,342394
1559,crazy-max,8,0.00234,59053,17.24709,342394
1560,Cryingmouse,8,0.00234,59061,17.24943,342394
1561,cutecutecat,8,0.00234,59069,17.25176,342394
1562,dan-m8t,8,0.00234,59077,17.25410,342394
1563,dargentieri,8,0.00234,59085,17.25644,342394
1564,ddobbinsweb,8,0.00234,59093,17.25877,342394
1565,DevOpserzhao,8,0.00234,59101,17.26111,342394
1566,dimbleby,8,0.00234,59109,17.26345,342394
1567,dintel,8,0.00234,59117,17.26578,342394
1568,disconnect3d,8,0.00234,59125,17.26812,342394
1569,dmanbu,8,0.00234,59133,17.27045,342394
1570,dperaza4dustbit,8,0.00234,59141,17.27279,342394
1571,Eikykun,8,0.00234,59149,17.27513,342394
1572,eLife-long,8,0.00234,59157,17.27746,342394
1573,Enkelian,8,0.00234,59165,17.27980,342394
1574,eoregua,8,0.00234,59173,17.28214,342394
1575,evolution232634,8,0.00234,59181,17.28447,342394
1576,feber,8,0.00234,59189,17.28681,342394
1577,FrankYang0529,8,0.00234,59197,17.28915,342394
1578,FruityWelsh,8,0.00234,59205,17.29148,342394
1579,Gehhilfe,8,0.00234,59213,17.29382,342394
1580,geotransformer,8,0.00234,59221,17.29616,342394
1581,giantcroc,8,0.00234,59229,17.29849,342394
1582,giskou,8,0.00234,59237,17.30083,342394
1583,guidoffm,8,0.00234,59245,17.30317,342394
1584,Gyorgy-Hrabovszki,8,0.00234,59253,17.30550,342394
1585,haoruan,8,0.00234,59261,17.30784,342394
1586,HeGaoYuan,8,0.00234,59269,17.31017,342394
1587,hhb584520,8,0.00234,59277,17.31251,342394
1588,hoyon,8,0.00234,59285,17.31485,342394
1589,ikatolkar,8,0.00234,59293,17.31718,342394
1590,jainbhavya65,8,0.00234,59301,17.31952,342394
1591,jambu,8,0.00234,59309,17.32186,342394
1592,jarias-lfx,8,0.00234,59317,17.32419,342394
1593,jav333,8,0.00234,59325,17.32653,342394
1594,jbpratt,8,0.00234,59333,17.32887,342394
1595,jerry-sc,8,0.00234,59341,17.33120,342394
1596,jfmyers9,8,0.00234,59349,17.33354,342394
1597,jfrabaute,8,0.00234,59357,17.33588,342394
1598,jhchabran,8,0.00234,59365,17.33821,342394
1599,jimeh,8,0.00234,59373,17.34055,342394
1600,johncming,8,0.00234,59381,17.34289,342394
1601,jorgearteiro,8,0.00234,59389,17.34522,342394
1602,juozasg,8,0.00234,59397,17.34756,342394
1603,jurgen-weber-deltatre,8,0.00234,59405,17.34990,342394
1604,Kailop12,8,0.00234,59413,17.35223,342394
1605,khalilnkhaliln,8,0.00234,59421,17.35457,342394
1606,khanhntd,8,0.00234,59429,17.35690,342394
1607,Kidswiss,8,0.00234,59437,17.35924,342394
1608,kkalin68,8,0.00234,59445,17.36158,342394
1609,KnBrBz,8,0.00234,59453,17.36391,342394
1610,kuldazbraslav,8,0.00234,59461,17.36625,342394
1611,KushalBeniwal,8,0.00234,59469,17.36859,342394
1612,ladd,8,0.00234,59477,17.37092,342394
1613,leoxhj,8,0.00234,59485,17.37326,342394
1614,lghxue,8,0.00234,59493,17.37560,342394
1615,lidavidm,8,0.00234,59501,17.37793,342394
1616,liljaylj,8,0.00234,59509,17.38027,342394
1617,lmercl,8,0.00234,59517,17.38261,342394
1618,lmuhlha,8,0.00234,59525,17.38494,342394
1619,ludurr,8,0.00234,59533,17.38728,342394
1620,luigi-bitonti,8,0.00234,59541,17.38962,342394
1621,mackjmr,8,0.00234,59549,17.39195,342394
1622,manifest,8,0.00234,59557,17.39429,342394
1623,mcosta74,8,0.00234,59565,17.39662,342394
1624,mdnfiras,8,0.00234,59573,17.39896,342394
1625,meixingdb,8,0.00234,59581,17.40130,342394
1626,melfeqy,8,0.00234,59589,17.40363,342394
1627,mendi160,8,0.00234,59597,17.40597,342394
1628,mingfang,8,0.00234,59605,17.40831,342394
1629,mixitgit,8,0.00234,59613,17.41064,342394
1630,mkowalski,8,0.00234,59621,17.41298,342394
1631,movd,8,0.00234,59629,17.41532,342394
1632,muqp,8,0.00234,59637,17.41765,342394
1633,nautiam,8,0.00234,59645,17.41999,342394
1634,negram,8,0.00234,59653,17.42233,342394
1635,nicjohnson145,8,0.00234,59661,17.42466,342394
1636,oneiro-naut,8,0.00234,59669,17.42700,342394
1637,orzen,8,0.00234,59677,17.42934,342394
1638,ozcb,8,0.00234,59685,17.43167,342394
1639,pablocavalieri,8,0.00234,59693,17.43401,342394
1640,PeterF778,8,0.00234,59701,17.43635,342394
1641,philipatl,8,0.00234,59709,17.43868,342394
1642,pi-bit,8,0.00234,59717,17.44102,342394
1643,polar3130,8,0.00234,59725,17.44335,342394
1644,prahaladdarkin,8,0.00234,59733,17.44569,342394
1645,praveen-SRE,8,0.00234,59741,17.44803,342394
1646,prein,8,0.00234,59749,17.45036,342394
1647,pymag09,8,0.00234,59757,17.45270,342394
1648,qqustc,8,0.00234,59765,17.45504,342394
1649,qwtsc,8,0.00234,59773,17.45737,342394
1650,RafalMaleska,8,0.00234,59781,17.45971,342394
1651,ralbon,8,0.00234,59789,17.46205,342394
1652,rdavyd,8,0.00234,59797,17.46438,342394
1653,regadas,8,0.00234,59805,17.46672,342394
1654,RicardoS840,8,0.00234,59813,17.46906,342394
1655,ritpanjw,8,0.00234,59821,17.47139,342394
1656,rkrzewski,8,0.00234,59829,17.47373,342394
1657,robbie-unlikelyai,8,0.00234,59837,17.47607,342394
1658,rocrisp,8,0.00234,59845,17.47840,342394
1659,ruidfigueiredo,8,0.00234,59853,17.48074,342394
1660,saurabhghumnar,8,0.00234,59861,17.48308,342394
1661,sebltm,8,0.00234,59869,17.48541,342394
1662,seralepo,8,0.00234,59877,17.48775,342394
1663,shanthisagar-dhanya-kumar-db,8,0.00234,59885,17.49008,342394
1664,sheepcat,8,0.00234,59893,17.49242,342394
1665,Shreya027,8,0.00234,59901,17.49476,342394
1666,Shuanglu,8,0.00234,59909,17.49709,342394
1667,sid-johnson,8,0.00234,59917,17.49943,342394
1668,simorgh1,8,0.00234,59925,17.50177,342394
1669,smaloo-salesforce,8,0.00234,59933,17.50410,342394
1670,smbambling,8,0.00234,59941,17.50644,342394
1671,snagiel,8,0.00234,59949,17.50878,342394
1672,starteleport,8,0.00234,59957,17.51111,342394
1673,stephaneetje,8,0.00234,59965,17.51345,342394
1674,stephane-mori,8,0.00234,59973,17.51579,342394
1675,strus38,8,0.00234,59981,17.51812,342394
1676,SunhaoKim,8,0.00234,59989,17.52046,342394
1677,sunshine69,8,0.00234,59997,17.52280,342394
1678,sysnasri,8,0.00234,60005,17.52513,342394
1679,Tails128,8,0.00234,60013,17.52747,342394
1680,Tantalor93,8,0.00234,60021,17.52980,342394
1681,TenSt,8,0.00234,60029,17.53214,342394
1682,thatGreekGuy96,8,0.00234,60037,17.53448,342394
1683,tiancaiamao,8,0.00234,60045,17.53681,342394
1684,toasthorse,8,0.00234,60053,17.53915,342394
1685,tomasspi,8,0.00234,60061,17.54149,342394
1686,tonyqus,8,0.00234,60069,17.54382,342394
1687,Tony-The-Developer,8,0.00234,60077,17.54616,342394
1688,tosone,8,0.00234,60085,17.54850,342394
1689,UOS-liang,8,0.00234,60093,17.55083,342394
1690,uptutu,8,0.00234,60101,17.55317,342394
1691,vadbluedata,8,0.00234,60109,17.55551,342394
1692,ventifus,8,0.00234,60117,17.55784,342394
1693,vjjmiras,8,0.00234,60125,17.56018,342394
1694,wangshli,8,0.00234,60133,17.56252,342394
1695,we4tech,8,0.00234,60141,17.56485,342394
1696,wenhuwang,8,0.00234,60149,17.56719,342394
1697,ws-prive,8,0.00234,60157,17.56953,342394
1698,yanllearnn,8,0.00234,60165,17.57186,342394
1699,yasintahaerol,8,0.00234,60173,17.57420,342394
1700,YitzyD,8,0.00234,60181,17.57653,342394
1701,yjjy0921,8,0.00234,60189,17.57887,342394
1702,yllek,8,0.00234,60197,17.58121,342394
1703,yongxiu,8,0.00234,60205,17.58354,342394
1704,yotamloe,8,0.00234,60213,17.58588,342394
1705,zhengyi,8,0.00234,60221,17.58822,342394
1706,zmapleshine,8,0.00234,60229,17.59055,342394
1707,ZMing316,8,0.00234,60237,17.59289,342394
1708,zzvara,8,0.00234,60245,17.59523,342394
1709,08mamba24,7,0.00204,60252,17.59727,342394
1710,0verflowme,7,0.00204,60259,17.59932,342394
1711,0xc0000007b,7,0.00204,60266,17.60136,342394
1712,2like,7,0.00204,60273,17.60340,342394
1713,aaronrenner,7,0.00204,60280,17.60545,342394
1714,aattuluri,7,0.00204,60287,17.60749,342394
1715,acezen,7,0.00204,60294,17.60954,342394
1716,AjohnsonLS,7,0.00204,60301,17.61158,342394
1717,akanshat,7,0.00204,60308,17.61363,342394
1718,akshar-rafay,7,0.00204,60315,17.61567,342394
1719,aktxyz,7,0.00204,60322,17.61772,342394
1720,Alceatraz,7,0.00204,60329,17.61976,342394
1721,alex-bezek,7,0.00204,60336,17.62180,342394
1722,alexisbel1,7,0.00204,60343,17.62385,342394
1723,AlexYinHan,7,0.00204,60350,17.62589,342394
1724,allupaku,7,0.00204,60357,17.62794,342394
1725,Alon-Katz,7,0.00204,60364,17.62998,342394
1726,alwaysastudent,7,0.00204,60371,17.63203,342394
1727,AndrewKindleysides,7,0.00204,60378,17.63407,342394
1728,andriktr,7,0.00204,60385,17.63612,342394
1729,angeloskaltsikis,7,0.00204,60392,17.63816,342394
1730,apodhrad,7,0.00204,60399,17.64020,342394
1731,apolegoshko,7,0.00204,60406,17.64225,342394
1732,applike-ss,7,0.00204,60413,17.64429,342394
1733,Arbiv,7,0.00204,60420,17.64634,342394
1734,ArtBlnd,7,0.00204,60427,17.64838,342394
1735,aslobodskoy-fiksu,7,0.00204,60434,17.65043,342394
1736,augi,7,0.00204,60441,17.65247,342394
1737,awoodsprim,7,0.00204,60448,17.65451,342394
1738,AyushCloud,7,0.00204,60455,17.65656,342394
1739,azylinski,7,0.00204,60462,17.65860,342394
1740,baiakbar,7,0.00204,60469,17.66065,342394
1741,baryluk,7,0.00204,60476,17.66269,342394
1742,Bataran,7,0.00204,60483,17.66474,342394
1743,bbassingthwaite,7,0.00204,60490,17.66678,342394
1744,bbeattie-phxlabs,7,0.00204,60497,17.66883,342394
1745,BerndFarkaDyna,7,0.00204,60504,17.67087,342394
1746,biello,7,0.00204,60511,17.67291,342394
1747,bigbanglwb,7,0.00204,60518,17.67496,342394
1748,bocharovf,7,0.00204,60525,17.67700,342394
1749,bo-er,7,0.00204,60532,17.67905,342394
1750,bondido,7,0.00204,60539,17.68109,342394
1751,brianthelion,7,0.00204,60546,17.68314,342394
1752,broken-ufa,7,0.00204,60553,17.68518,342394
1753,brunopenso,7,0.00204,60560,17.68723,342394
1754,btalbot,7,0.00204,60567,17.68927,342394
1755,caizixian,7,0.00204,60574,17.69131,342394
1756,Captain-P-Goldfish,7,0.00204,60581,17.69336,342394
1757,cglong,7,0.00204,60588,17.69540,342394
1758,chenFe-1,7,0.00204,60595,17.69745,342394
1759,chrisahl,7,0.00204,60602,17.69949,342394
1760,chukynax,7,0.00204,60609,17.70154,342394
1761,Church13,7,0.00204,60616,17.70358,342394
1762,cisco1115,7,0.00204,60623,17.70563,342394
1763,CitadelCore,7,0.00204,60630,17.70767,342394
1764,coawlion,7,0.00204,60637,17.70971,342394
1765,cod-r,7,0.00204,60644,17.71176,342394
1766,cohix,7,0.00204,60651,17.71380,342394
1767,Dagon0577,7,0.00204,60658,17.71585,342394
1768,DanteAndroid,7,0.00204,60665,17.71789,342394
1769,dbason,7,0.00204,60672,17.71994,342394
1770,dboreham,7,0.00204,60679,17.72198,342394
1771,debbyku,7,0.00204,60686,17.72403,342394
1772,devinjeon,7,0.00204,60693,17.72607,342394
1773,dmartin35,7,0.00204,60700,17.72811,342394
1774,Drugoy,7,0.00204,60707,17.73016,342394
1775,dwindsor,7,0.00204,60714,17.73220,342394
1776,eagle4567,7,0.00204,60721,17.73425,342394
1777,ederst,7,0.00204,60728,17.73629,342394
1778,egoisz,7,0.00204,60735,17.73834,342394
1779,Ehco1996,7,0.00204,60742,17.74038,342394
1780,eiffel-fl,7,0.00204,60749,17.74243,342394
1781,elfring,7,0.00204,60756,17.74447,342394
1782,felixhuettner,7,0.00204,60763,17.74651,342394
1783,finalha,7,0.00204,60770,17.74856,342394
1784,fsxxzjpbp,7,0.00204,60777,17.75060,342394
1785,ghostsquad,7,0.00204,60784,17.75265,342394
1786,gituserjava,7,0.00204,60791,17.75469,342394
1787,glitchcrab,7,0.00204,60798,17.75674,342394
1788,haitch,7,0.00204,60805,17.75878,342394
1789,haizi-cui,7,0.00204,60812,17.76083,342394
1790,hansh0801,7,0.00204,60819,17.76287,342394
1791,haoxins,7,0.00204,60826,17.76491,342394
1792,Harshita-Kanal,7,0.00204,60833,17.76696,342394
1793,hatati,7,0.00204,60840,17.76900,342394
1794,hoffe86,7,0.00204,60847,17.77105,342394
1795,holmesb,7,0.00204,60854,17.77309,342394
1796,hrithiksawhney,7,0.00204,60861,17.77514,342394
1797,huanghantao,7,0.00204,60868,17.77718,342394
1798,hubwoop,7,0.00204,60875,17.77923,342394
1799,huuzing,7,0.00204,60882,17.78127,342394
1800,hxcGit,7,0.00204,60889,17.78331,342394
1801,ianroberts,7,0.00204,60896,17.78536,342394
1802,IkshuDM,7,0.00204,60903,17.78740,342394
1803,irejanodev,7,0.00204,60910,17.78945,342394
1804,ishan16696,7,0.00204,60917,17.79149,342394
1805,itamarkam,7,0.00204,60924,17.79354,342394
1806,jainpratik163,7,0.00204,60931,17.79558,342394
1807,jameskim0987,7,0.00204,60938,17.79762,342394
1808,jan0ski,7,0.00204,60945,17.79967,342394
1809,jerrac,7,0.00204,60952,17.80171,342394
1810,jgershater,7,0.00204,60959,17.80376,342394
1811,jjyao,7,0.00204,60966,17.80580,342394
1812,jkschulz,7,0.00204,60973,17.80785,342394
1813,jmwurst,7,0.00204,60980,17.80989,342394
1814,johnnyoshika,7,0.00204,60987,17.81194,342394
1815,Joj3j,7,0.00204,60994,17.81398,342394
1816,jokerZhou,7,0.00204,61001,17.81602,342394
1817,JooKS-me,7,0.00204,61008,17.81807,342394
1818,jr0dd,7,0.00204,61015,17.82011,342394
1819,juliohm1978,7,0.00204,61022,17.82216,342394
1820,Justin-Jin,7,0.00204,61029,17.82420,342394
1821,jwhb,7,0.00204,61036,17.82625,342394
1822,jwomackgsa,7,0.00204,61043,17.82829,342394
1823,kaldyka,7,0.00204,61050,17.83034,342394
1824,Kazurin-775,7,0.00204,61057,17.83238,342394
1825,kbmanseau,7,0.00204,61064,17.83442,342394
1826,kdalporto,7,0.00204,61071,17.83647,342394
1827,KerinPithawala,7,0.00204,61078,17.83851,342394
1828,kleferbe,7,0.00204,61085,17.84056,342394
1829,kotreshhr,7,0.00204,61092,17.84260,342394
1830,koushikmgithub,7,0.00204,61099,17.84465,342394
1831,ks2211,7,0.00204,61106,17.84669,342394
1832,ktpktr0,7,0.00204,61113,17.84874,342394
1833,KushalP,7,0.00204,61120,17.85078,342394
1834,kxzonly,7,0.00204,61127,17.85282,342394
1835,laziobird,7,0.00204,61134,17.85487,342394
1836,LeoYang90,7,0.00204,61141,17.85691,342394
1837,LukasAuerbeck,7,0.00204,61148,17.85896,342394
1838,lynn447742,7,0.00204,61155,17.86100,342394
1839,Lyt99,7,0.00204,61162,17.86305,342394
1840,MahnoorAsghar,7,0.00204,61169,17.86509,342394
1841,MainLarabootMachine,7,0.00204,61176,17.86714,342394
1842,markofranjic,7,0.00204,61183,17.86918,342394
1843,marthydavid,7,0.00204,61190,17.87122,342394
1844,matteoga,7,0.00204,61197,17.87327,342394
1845,mayurwaghmode,7,0.00204,61204,17.87531,342394
1846,metisy,7,0.00204,61211,17.87736,342394
1847,mfz85,7,0.00204,61218,17.87940,342394
1848,mgiessing,7,0.00204,61225,17.88145,342394
1849,michaljasionowski,7,0.00204,61232,17.88349,342394
1850,MileyFu,7,0.00204,61239,17.88554,342394
1851,minjungsung1994,7,0.00204,61246,17.88758,342394
1852,missingcharacter,7,0.00204,61253,17.88962,342394
1853,mmiller1,7,0.00204,61260,17.89167,342394
1854,moadz,7,0.00204,61267,17.89371,342394
1855,mohitruhaan,7,0.00204,61274,17.89576,342394
1856,Monokaix,7,0.00204,61281,17.89780,342394
1857,Mossaka,7,0.00204,61288,17.89985,342394
1858,msAlcantara,7,0.00204,61295,17.90189,342394
1859,mubarak-j,7,0.00204,61302,17.90394,342394
1860,Muscule,7,0.00204,61309,17.90598,342394
1861,my-git9,7,0.00204,61316,17.90802,342394
1862,myspotontheweb,7,0.00204,61323,17.91007,342394
1863,nathan-415,7,0.00204,61330,17.91211,342394
1864,nccurry,7,0.00204,61337,17.91416,342394
1865,Nctllnty,7,0.00204,61344,17.91620,342394
1866,nexcode,7,0.00204,61351,17.91825,342394
1867,ngranander,7,0.00204,61358,17.92029,342394
1868,nicolas-goudry,7,0.00204,61365,17.92234,342394
1869,ni-todo-spot,7,0.00204,61372,17.92438,342394
1870,nuckydong,7,0.00204,61379,17.92642,342394
1871,nuriel77,7,0.00204,61386,17.92847,342394
1872,ohmyglb,7,0.00204,61393,17.93051,342394
1873,olamiko,7,0.00204,61400,17.93256,342394
1874,onimsha,7,0.00204,61407,17.93460,342394
1875,pa250194,7,0.00204,61414,17.93665,342394
1876,Pallavi-PH,7,0.00204,61421,17.93869,342394
1877,parulagg-1199,7,0.00204,61428,17.94073,342394
1878,patrickxiong,7,0.00204,61435,17.94278,342394
1879,paul-bormans,7,0.00204,61442,17.94482,342394
1880,PauliusB,7,0.00204,61449,17.94687,342394
1881,pawelpabich,7,0.00204,61456,17.94891,342394
1882,pbusko,7,0.00204,61463,17.95096,342394
1883,pbxqdown,7,0.00204,61470,17.95300,342394
1884,Perhurb,7,0.00204,61477,17.95505,342394
1885,perrinj3,7,0.00204,61484,17.95709,342394
1886,petedmarsh,7,0.00204,61491,17.95913,342394
1887,pjachowi,7,0.00204,61498,17.96118,342394
1888,pjamenaja,7,0.00204,61505,17.96322,342394
1889,PKizzle,7,0.00204,61512,17.96527,342394
1890,ppintogbm,7,0.00204,61519,17.96731,342394
1891,praveen-accuknox,7,0.00204,61526,17.96936,342394
1892,PSanetra,7,0.00204,61533,17.97140,342394
1893,psarossy,7,0.00204,61540,17.97345,342394
1894,qq253498229,7,0.00204,61547,17.97549,342394
1895,raffis,7,0.00204,61554,17.97753,342394
1896,raftario,7,0.00204,61561,17.97958,342394
1897,rahulpoddar-fyndna,7,0.00204,61568,17.98162,342394
1898,rameshmishra777,7,0.00204,61575,17.98367,342394
1899,randomthingsandstuff,7,0.00204,61582,17.98571,342394
1900,robherley,7,0.00204,61589,17.98776,342394
1901,robkooper,7,0.00204,61596,17.98980,342394
1902,RomanBednar,7,0.00204,61603,17.99185,342394
1903,rsickles,7,0.00204,61610,17.99389,342394
1904,rtsp,7,0.00204,61617,17.99593,342394
1905,RunzhongHuang,7,0.00204,61624,17.99798,342394
1906,SanjayVas,7,0.00204,61631,18.00002,342394
1907,saodis,7,0.00204,61638,18.00207,342394
1908,satrushn,7,0.00204,61645,18.00411,342394
1909,sayaoailun,7,0.00204,61652,18.00616,342394
1910,scrocquesel,7,0.00204,61659,18.00820,342394
1911,scuzhanglei,7,0.00204,61666,18.01025,342394
1912,sebfere,7,0.00204,61673,18.01229,342394
1913,seblaz,7,0.00204,61680,18.01433,342394
1914,sejr,7,0.00204,61687,18.01638,342394
1915,sepulworld,7,0.00204,61694,18.01842,342394
1916,serlina,7,0.00204,61701,18.02047,342394
1917,shaojielinux,7,0.00204,61708,18.02251,342394
1918,shinigambit,7,0.00204,61715,18.02456,342394
1919,shumintao,7,0.00204,61722,18.02660,342394
1920,shyimo,7,0.00204,61729,18.02865,342394
1921,siegenthalerroger,7,0.00204,61736,18.03069,342394
1922,sinhaashish,7,0.00204,61743,18.03273,342394
1923,sl1316,7,0.00204,61750,18.03478,342394
1924,snprajwal,7,0.00204,61757,18.03682,342394
1925,sonder-joker,7,0.00204,61764,18.03887,342394
1926,sonro,7,0.00204,61771,18.04091,342394
1927,SoujanyaMangipudi,7,0.00204,61778,18.04296,342394
1928,SpectralHiss,7,0.00204,61785,18.04500,342394
1929,spenczar,7,0.00204,61792,18.04705,342394
1930,steveazz,7,0.00204,61799,18.04909,342394
1931,steven-my,7,0.00204,61806,18.05113,342394
1932,Summer-Field,7,0.00204,61813,18.05318,342394
1933,talboren,7,0.00204,61820,18.05522,342394
1934,Tamas-Biro1,7,0.00204,61827,18.05727,342394
1935,tcarrio,7,0.00204,61834,18.05931,342394
1936,TeamTeaTime,7,0.00204,61841,18.06136,342394
1937,TennyZhuang,7,0.00204,61848,18.06340,342394
1938,thalleslmF,7,0.00204,61855,18.06545,342394
1939,thechubbypanda,7,0.00204,61862,18.06749,342394
1940,thhous-msft,7,0.00204,61869,18.06953,342394
1941,tkennes,7,0.00204,61876,18.07158,342394
1942,tmsxk,7,0.00204,61883,18.07362,342394
1943,tobiasmuehl,7,0.00204,61890,18.07567,342394
1944,univerio,7,0.00204,61897,18.07771,342394
1945,villanel,7,0.00204,61904,18.07976,342394
1946,vinid223,7,0.00204,61911,18.08180,342394
1947,vinitmasaun,7,0.00204,61918,18.08384,342394
1948,vivek-koppuru,7,0.00204,61925,18.08589,342394
1949,vss96,7,0.00204,61932,18.08793,342394
1950,waheedshahani,7,0.00204,61939,18.08998,342394
1951,wangzd1,7,0.00204,61946,18.09202,342394
1952,WarlenRodrigues,7,0.00204,61953,18.09407,342394
1953,webbertakken,7,0.00204,61960,18.09611,342394
1954,weiwenli97,7,0.00204,61967,18.09816,342394
1955,weizhouBlue,7,0.00204,61974,18.10020,342394
1956,WhoAteDaCake,7,0.00204,61981,18.10224,342394
1957,wilkinsona,7,0.00204,61988,18.10429,342394
1958,Windrow14,7,0.00204,61995,18.10633,342394
1959,wirespecter,7,0.00204,62002,18.10838,342394
1960,witsch,7,0.00204,62009,18.11042,342394
1961,xavidop,7,0.00204,62016,18.11247,342394
1962,xi2817-aajgaonkar,7,0.00204,62023,18.11451,342394
1963,xiaoma2015,7,0.00204,62030,18.11656,342394
1964,xiaoping8385,7,0.00204,62037,18.11860,342394
1965,xiaoxiaobaba,7,0.00204,62044,18.12064,342394
1966,xuxant,7,0.00204,62051,18.12269,342394
1967,yanlingsishao,7,0.00204,62058,18.12473,342394
1968,yeicandoit,7,0.00204,62065,18.12678,342394
1969,yeqown,7,0.00204,62072,18.12882,342394
1970,YikSanChan,7,0.00204,62079,18.13087,342394
1971,yorelog,7,0.00204,62086,18.13291,342394
1972,younaman,7,0.00204,62093,18.13496,342394
1973,Yui-Song,7,0.00204,62100,18.13700,342394
1974,yunjianzhong,7,0.00204,62107,18.13904,342394
1975,yyrdl,7,0.00204,62114,18.14109,342394
1976,Zhanxueyou,7,0.00204,62121,18.14313,342394
1977,zhaogaolong,7,0.00204,62128,18.14518,342394
1978,zzzkl,7,0.00204,62135,18.14722,342394
1979,0x1ee7,6,0.00175,62141,18.14897,342394
1980,243f6a8885a308d313198a2e037,6,0.00175,62147,18.15073,342394
1981,519859716,6,0.00175,62153,18.15248,342394
1982,abalmos,6,0.00175,62159,18.15423,342394
1983,abelperezok,6,0.00175,62165,18.15598,342394
1984,Abhijit-Mane,6,0.00175,62171,18.15774,342394
1985,abishai,6,0.00175,62177,18.15949,342394
1986,achandrasekar,6,0.00175,62183,18.16124,342394
1987,acjohnson,6,0.00175,62189,18.16299,342394
1988,acxz,6,0.00175,62195,18.16475,342394
1989,adityajalkhare,6,0.00175,62201,18.16650,342394
1990,aidewn,6,0.00175,62207,18.16825,342394
1991,akshitgrover,6,0.00175,62213,18.17000,342394
1992,Alan01252,6,0.00175,62219,18.17176,342394
1993,alexbaeza,6,0.00175,62225,18.17351,342394
1994,Alexcei88,6,0.00175,62231,18.17526,342394
1995,alisakotliarova,6,0.00175,62237,18.17701,342394
1996,amirhadadi,6,0.00175,62243,18.17876,342394
1997,Andreagit97,6,0.00175,62249,18.18052,342394
1998,andreib1,6,0.00175,62255,18.18227,342394
1999,andrewshaoyu,6,0.00175,62261,18.18402,342394
2000,andriihrachov,6,0.00175,62267,18.18577,342394
2001,anya-sverdlova,6,0.00175,62273,18.18753,342394
2002,AnyISalIn,6,0.00175,62279,18.18928,342394
2003,aramperes,6,0.00175,62285,18.19103,342394
2004,artifacthubio,6,0.00175,62291,18.19278,342394
2005,arun-vasudev,6,0.00175,62297,18.19454,342394
2006,ashok-arora,6,0.00175,62303,18.19629,342394
2007,asm582,6,0.00175,62309,18.19804,342394
2008,atorrescogollo,6,0.00175,62315,18.19979,342394
2009,basert,6,0.00175,62321,18.20155,342394
2010,Ben-Mark,6,0.00175,62327,18.20330,342394
2011,benridley,6,0.00175,62333,18.20505,342394
2012,bgolding355,6,0.00175,62339,18.20680,342394
2013,bharathnoddy,6,0.00175,62345,18.20856,342394
2014,bhoriuchi,6,0.00175,62351,18.21031,342394
2015,bloodbare,6,0.00175,62357,18.21206,342394
2016,blue928,6,0.00175,62363,18.21381,342394
2017,bobfuru,6,0.00175,62369,18.21556,342394
2018,boyanguber,6,0.00175,62375,18.21732,342394
2019,bputt,6,0.00175,62381,18.21907,342394
2020,BryanDollery,6,0.00175,62387,18.22082,342394
2021,bskim-mantech,6,0.00175,62393,18.22257,342394
2022,burkempers,6,0.00175,62399,18.22433,342394
2023,bwhaley,6,0.00175,62405,18.22608,342394
2024,byblakeorriver,6,0.00175,62411,18.22783,342394
2025,caitmulholland,6,0.00175,62417,18.22958,342394
2026,careless6666,6,0.00175,62423,18.23134,342394
2027,cchesser,6,0.00175,62429,18.23309,342394
2028,cescoffier,6,0.00175,62435,18.23484,342394
2029,ch0mik,6,0.00175,62441,18.23659,342394
2030,chaholl,6,0.00175,62447,18.23835,342394
2031,chenaoxd,6,0.00175,62453,18.24010,342394
2032,chrispsplash,6,0.00175,62459,18.24185,342394
2033,christian-oudard,6,0.00175,62465,18.24360,342394
2034,cncal,6,0.00175,62471,18.24535,342394
2035,cotjoey,6,0.00175,62477,18.24711,342394
2036,crisboarna,6,0.00175,62483,18.24886,342394
2037,CrossingTheRiverPeole,6,0.00175,62489,18.25061,342394
2038,damienleger,6,0.00175,62495,18.25236,342394
2039,damnever,6,0.00175,62501,18.25412,342394
2040,danhngo-lx,6,0.00175,62507,18.25587,342394
2041,daniellemcook,6,0.00175,62513,18.25762,342394
2042,daniel-yavorovich,6,0.00175,62519,18.25937,342394
2043,DARKBOW923,6,0.00175,62525,18.26113,342394
2044,dasl-,6,0.00175,62531,18.26288,342394
2045,davinkevin,6,0.00175,62537,18.26463,342394
2046,DavyJohnes,6,0.00175,62543,18.26638,342394
2047,demonCoder95,6,0.00175,62549,18.26814,342394
2048,dengqian,6,0.00175,62555,18.26989,342394
2049,dennismeister93,6,0.00175,62561,18.27164,342394
2050,derekedmondflutter,6,0.00175,62567,18.27339,342394
2051,derek-pryor,6,0.00175,62573,18.27515,342394
2052,derekyle,6,0.00175,62579,18.27690,342394
2053,dgengtek,6,0.00175,62585,18.27865,342394
2054,Dice21,6,0.00175,62591,18.28040,342394
2055,dino-ma,6,0.00175,62597,18.28215,342394
2056,Dkaykay,6,0.00175,62603,18.28391,342394
2057,dmitry-j-mikhin,6,0.00175,62609,18.28566,342394
2058,dobharweim,6,0.00175,62615,18.28741,342394
2059,dodiadodia,6,0.00175,62621,18.28916,342394
2060,dpiraud,6,0.00175,62627,18.29092,342394
2061,dudicoco,6,0.00175,62633,18.29267,342394
2062,Dutchy-,6,0.00175,62639,18.29442,342394
2063,edma2,6,0.00175,62645,18.29617,342394
2064,EdmundsEcho,6,0.00175,62651,18.29793,342394
2065,eminaktas,6,0.00175,62657,18.29968,342394
2066,ericksoen,6,0.00175,62663,18.30143,342394
2067,eryugey,6,0.00175,62669,18.30318,342394
2068,Eun,6,0.00175,62675,18.30494,342394
2069,evanmcclure,6,0.00175,62681,18.30669,342394
2070,faisalchishtii,6,0.00175,62687,18.30844,342394
2071,fardarter,6,0.00175,62693,18.31019,342394
2072,feitian124,6,0.00175,62699,18.31194,342394
2073,feuyeux,6,0.00175,62705,18.31370,342394
2074,filhodanuvem,6,0.00175,62711,18.31545,342394
2075,fishman,6,0.00175,62717,18.31720,342394
2076,fjbecerra,6,0.00175,62723,18.31895,342394
2077,flbla,6,0.00175,62729,18.32071,342394
2078,flexoid,6,0.00175,62735,18.32246,342394
2079,gaby,6,0.00175,62741,18.32421,342394
2080,garloff,6,0.00175,62747,18.32596,342394
2081,geezyx,6,0.00175,62753,18.32772,342394
2082,gelleson,6,0.00175,62759,18.32947,342394
2083,GeroL,6,0.00175,62765,18.33122,342394
2084,g-ongenae,6,0.00175,62771,18.33297,342394
2085,grafjo,6,0.00175,62777,18.33473,342394
2086,Gre8t,6,0.00175,62783,18.33648,342394
2087,gregwhorley,6,0.00175,62789,18.33823,342394
2088,groggemans,6,0.00175,62795,18.33998,342394
2089,grzn,6,0.00175,62801,18.34173,342394
2090,gujun4990,6,0.00175,62807,18.34349,342394
2091,gusfcarvalho,6,0.00175,62813,18.34524,342394
2092,harshal1605,6,0.00175,62819,18.34699,342394
2093,heitorrbarros,6,0.00175,62825,18.34874,342394
2094,hjorth,6,0.00175,62831,18.35050,342394
2095,hsiangkao,6,0.00175,62837,18.35225,342394
2096,hsparmar1,6,0.00175,62843,18.35400,342394
2097,hw4liu,6,0.00175,62849,18.35575,342394
2098,hxsf,6,0.00175,62855,18.35751,342394
2099,hzliangbin,6,0.00175,62861,18.35926,342394
2100,ibihim,6,0.00175,62867,18.36101,342394
2101,ifplusor,6,0.00175,62873,18.36276,342394
2102,iGene,6,0.00175,62879,18.36452,342394
2103,IKRozhkov,6,0.00175,62885,18.36627,342394
2104,Inorysky,6,0.00175,62891,18.36802,342394
2105,intech,6,0.00175,62897,18.36977,342394
2106,iquirino,6,0.00175,62903,18.37153,342394
2107,ivgenis,6,0.00175,62909,18.37328,342394
2108,Jack-256,6,0.00175,62915,18.37503,342394
2109,Jacobious52,6,0.00175,62921,18.37678,342394
2110,jakoberpf,6,0.00175,62927,18.37853,342394
2111,jdomag,6,0.00175,62933,18.38029,342394
2112,jeanpommier,6,0.00175,62939,18.38204,342394
2113,jefchien,6,0.00175,62945,18.38379,342394
2114,jek-bao-choo,6,0.00175,62951,18.38554,342394
2115,jghiloni,6,0.00175,62957,18.38730,342394
2116,jhbae200,6,0.00175,62963,18.38905,342394
2117,jiangfenghua123,6,0.00175,62969,18.39080,342394
2118,jinzhangvmw,6,0.00175,62975,18.39255,342394
2119,JoeKuan,6,0.00175,62981,18.39431,342394
2120,jonasbn,6,0.00175,62987,18.39606,342394
2121,josephharrington,6,0.00175,62993,18.39781,342394
2122,jpgkudo,6,0.00175,62999,18.39956,342394
2123,jvilhuber,6,0.00175,63005,18.40132,342394
2124,jwerre,6,0.00175,63011,18.40307,342394
2125,k100956,6,0.00175,63017,18.40482,342394
2126,kalirajann,6,0.00175,63023,18.40657,342394
2127,kandeshvari,6,0.00175,63029,18.40832,342394
2128,kay07,6,0.00175,63035,18.41008,342394
2129,Kaylleur,6,0.00175,63041,18.41183,342394
2130,kdubb,6,0.00175,63047,18.41358,342394
2131,KeesCBakker,6,0.00175,63053,18.41533,342394
2132,kevinanderson1,6,0.00175,63059,18.41709,342394
2133,kgibm,6,0.00175,63065,18.41884,342394
2134,khayyamsaleem,6,0.00175,63071,18.42059,342394
2135,kinderyj,6,0.00175,63077,18.42234,342394
2136,kke,6,0.00175,63083,18.42410,342394
2137,kleini,6,0.00175,63089,18.42585,342394
2138,knusperkrone,6,0.00175,63095,18.42760,342394
2139,knvpk,6,0.00175,63101,18.42935,342394
2140,kolbe,6,0.00175,63107,18.43111,342394
2141,KqLLL,6,0.00175,63113,18.43286,342394
2142,kralicky,6,0.00175,63119,18.43461,342394
2143,l8huang,6,0.00175,63125,18.43636,342394
2144,lajiao117,6,0.00175,63131,18.43812,342394
2145,lannyyip,6,0.00175,63137,18.43987,342394
2146,lapo-luchini,6,0.00175,63143,18.44162,342394
2147,lazybetrayer,6,0.00175,63149,18.44337,342394
2148,ldsenow,6,0.00175,63155,18.44512,342394
2149,legendsnow,6,0.00175,63161,18.44688,342394
2150,letuer,6,0.00175,63167,18.44863,342394
2151,lilongfeng0902,6,0.00175,63173,18.45038,342394
2152,liujiong1982,6,0.00175,63179,18.45213,342394
2153,llhhbc,6,0.00175,63185,18.45389,342394
2154,loliklol,6,0.00175,63191,18.45564,342394
2155,lucian-vanghele,6,0.00175,63197,18.45739,342394
2156,lzhfromustc,6,0.00175,63203,18.45914,342394
2157,maciejgwizdala,6,0.00175,63209,18.46090,342394
2158,marciogmorales,6,0.00175,63215,18.46265,342394
2159,mateinavidad,6,0.00175,63221,18.46440,342394
2160,mattmccleary,6,0.00175,63227,18.46615,342394
2161,mayank-reynencourt,6,0.00175,63233,18.46791,342394
2162,mbendtsen,6,0.00175,63239,18.46966,342394
2163,m-Bilal,6,0.00175,63245,18.47141,342394
2164,mboutet,6,0.00175,63251,18.47316,342394
2165,meilihao,6,0.00175,63257,18.47491,342394
2166,Miles-Garnsey,6,0.00175,63263,18.47667,342394
2167,mishamo,6,0.00175,63269,18.47842,342394
2168,misteruly,6,0.00175,63275,18.48017,342394
2169,MKrupauskas,6,0.00175,63281,18.48192,342394
2170,mobin102,6,0.00175,63287,18.48368,342394
2171,modzilla99,6,0.00175,63293,18.48543,342394
2172,moguraion,6,0.00175,63299,18.48718,342394
2173,mohsinonxrm,6,0.00175,63305,18.48893,342394
2174,momom-i,6,0.00175,63311,18.49069,342394
2175,morremeyer,6,0.00175,63317,18.49244,342394
2176,MoXinQian,6,0.00175,63323,18.49419,342394
2177,mrksngl,6,0.00175,63329,18.49594,342394
2178,mrproliu,6,0.00175,63335,18.49770,342394
2179,mrsabapathy,6,0.00175,63341,18.49945,342394
2180,msessa,6,0.00175,63347,18.50120,342394
2181,mtilson,6,0.00175,63353,18.50295,342394
2182,muffl0n,6,0.00175,63359,18.50471,342394
2183,mukhoakash,6,0.00175,63365,18.50646,342394
2184,murrayh,6,0.00175,63371,18.50821,342394
2185,namnp081296,6,0.00175,63377,18.50996,342394
2186,nc-ruth,6,0.00175,63383,18.51171,342394
2187,nick-homex,6,0.00175,63389,18.51347,342394
2188,nickjn92,6,0.00175,63395,18.51522,342394
2189,nickmango,6,0.00175,63401,18.51697,342394
2190,nickytd,6,0.00175,63407,18.51872,342394
2191,nigupta1,6,0.00175,63413,18.52048,342394
2192,NiharDudam,6,0.00175,63419,18.52223,342394
2193,nine01223,6,0.00175,63425,18.52398,342394
2194,niteshseram,6,0.00175,63431,18.52573,342394
2195,novahe,6,0.00175,63437,18.52749,342394
2196,oleg-kulyk,6,0.00175,63443,18.52924,342394
2197,omertuc,6,0.00175,63449,18.53099,342394
2198,omidb,6,0.00175,63455,18.53274,342394
2199,onthegit,6,0.00175,63461,18.53450,342394
2200,oprudkyi,6,0.00175,63467,18.53625,342394
2201,oshi36,6,0.00175,63473,18.53800,342394
2202,p53,6,0.00175,63479,18.53975,342394
2203,pantosha,6,0.00175,63485,18.54150,342394
2204,paragones92,6,0.00175,63491,18.54326,342394
2205,paulaylingdev,6,0.00175,63497,18.54501,342394
2206,paulbarfuss,6,0.00175,63503,18.54676,342394
2207,pengliangyou,6,0.00175,63509,18.54851,342394
2208,philipp1992,6,0.00175,63515,18.55027,342394
2209,polarstormx,6,0.00175,63521,18.55202,342394
2210,popomen,6,0.00175,63527,18.55377,342394
2211,PoweredByWill,6,0.00175,63533,18.55552,342394
2212,ppadevski,6,0.00175,63539,18.55728,342394
2213,prasadrajesh,6,0.00175,63545,18.55903,342394
2214,pstanton237,6,0.00175,63551,18.56078,342394
2215,punkfest,6,0.00175,63557,18.56253,342394
2216,pytimer,6,0.00175,63563,18.56429,342394
2217,qiansheng91,6,0.00175,63569,18.56604,342394
2218,qingvincentyin,6,0.00175,63575,18.56779,342394
2219,r0mdau,6,0.00175,63581,18.56954,342394
2220,rahil-p,6,0.00175,63587,18.57130,342394
2221,randomnoise,6,0.00175,63593,18.57305,342394
2222,redriverhong,6,0.00175,63599,18.57480,342394
2223,reinoudk,6,0.00175,63605,18.57655,342394
2224,renlei-ibm,6,0.00175,63611,18.57830,342394
2225,rhlarora84,6,0.00175,63617,18.58006,342394
2226,RicardormDev,6,0.00175,63623,18.58181,342394
2227,robinAwallace,6,0.00175,63629,18.58356,342394
2228,robinp-tw,6,0.00175,63635,18.58531,342394
2229,robjtede,6,0.00175,63641,18.58707,342394
2230,rparree,6,0.00175,63647,18.58882,342394
2231,rrupapara,6,0.00175,63653,18.59057,342394
2232,rthamrin,6,0.00175,63659,18.59232,342394
2233,rwxrob,6,0.00175,63665,18.59408,342394
2234,sachaos,6,0.00175,63671,18.59583,342394
2235,samriley,6,0.00175,63677,18.59758,342394
2236,SamYuan1990,6,0.00175,63683,18.59933,342394
2237,sding3,6,0.00175,63689,18.60109,342394
2238,sduo,6,0.00175,63695,18.60284,342394
2239,sebas2day,6,0.00175,63701,18.60459,342394
2240,sergey-safarov,6,0.00175,63707,18.60634,342394
2241,seunggs,6,0.00175,63713,18.60809,342394
2242,sgolod,6,0.00175,63719,18.60985,342394
2243,shafeeqes,6,0.00175,63725,18.61160,342394
2244,shawkins,6,0.00175,63731,18.61335,342394
2245,shawnsong,6,0.00175,63737,18.61510,342394
2246,shivamanipatil,6,0.00175,63743,18.61686,342394
2247,shuker85,6,0.00175,63749,18.61861,342394
2248,shvmbisht,6,0.00175,63755,18.62036,342394
2249,sizowie,6,0.00175,63761,18.62211,342394
2250,slashben,6,0.00175,63767,18.62387,342394
2251,Slyke,6,0.00175,63773,18.62562,342394
2252,spaparaju,6,0.00175,63779,18.62737,342394
2253,spiffcs,6,0.00175,63785,18.62912,342394
2254,ssrahul96,6,0.00175,63791,18.63088,342394
2255,ssst0n3,6,0.00175,63797,18.63263,342394
2256,StefanSa,6,0.00175,63803,18.63438,342394
2257,steven-aerts,6,0.00175,63809,18.63613,342394
2258,StevenLeiZhang,6,0.00175,63815,18.63789,342394
2259,stu01509,6,0.00175,63821,18.63964,342394
2260,suchen-sci,6,0.00175,63827,18.64139,342394
2261,sudomateo,6,0.00175,63833,18.64314,342394
2262,sylzd,6,0.00175,63839,18.64489,342394
2263,tanuj-soni2,6,0.00175,63845,18.64665,342394
2264,tanvp112,6,0.00175,63851,18.64840,342394
2265,tcnt,6,0.00175,63857,18.65015,342394
2266,Tenzer,6,0.00175,63863,18.65190,342394
2267,tg137,6,0.00175,63869,18.65366,342394
2268,th3M1ke,6,0.00175,63875,18.65541,342394
2269,tie,6,0.00175,63881,18.65716,342394
2270,tjefferson08,6,0.00175,63887,18.65891,342394
2271,tommyp1ckles,6,0.00175,63893,18.66067,342394
2272,toplordsaito,6,0.00175,63899,18.66242,342394
2273,tpetrov-lp,6,0.00175,63905,18.66417,342394
2274,trathborne,6,0.00175,63911,18.66592,342394
2275,Tristan971,6,0.00175,63917,18.66768,342394
2276,tychedelia,6,0.00175,63923,18.66943,342394
2277,typecampo,6,0.00175,63929,18.67118,342394
2278,uesyn,6,0.00175,63935,18.67293,342394
2279,unicomp21,6,0.00175,63941,18.67468,342394
2280,updogliu,6,0.00175,63947,18.67644,342394
2281,utianayuba,6,0.00175,63953,18.67819,342394
2282,vatsa287,6,0.00175,63959,18.67994,342394
2283,vavdoshka,6,0.00175,63965,18.68169,342394
2284,Venkatamrudula,6,0.00175,63971,18.68345,342394
2285,venkatramanchandirasekaran,6,0.00175,63977,18.68520,342394
2286,vincentbriglia,6,0.00175,63983,18.68695,342394
2287,vmasule,6,0.00175,63989,18.68870,342394
2288,voro015,6,0.00175,63995,18.69046,342394
2289,vulndev,6,0.00175,64001,18.69221,342394
2290,vuzunov-vmware,6,0.00175,64007,18.69396,342394
2291,w0wka91,6,0.00175,64013,18.69571,342394
2292,Warxcell,6,0.00175,64019,18.69747,342394
2293,waynr,6,0.00175,64025,18.69922,342394
2294,Willem1987,6,0.00175,64031,18.70097,342394
2295,willsond01,6,0.00175,64037,18.70272,342394
2296,wttat,6,0.00175,64043,18.70447,342394
2297,wxw-matt,6,0.00175,64049,18.70623,342394
2298,xhejtman,6,0.00175,64055,18.70798,342394
2299,YairHalberstadt,6,0.00175,64061,18.70973,342394
2300,YangLiang3,6,0.00175,64067,18.71148,342394
2301,yangliyl,6,0.00175,64073,18.71324,342394
2302,yangwwei,6,0.00175,64079,18.71499,342394
2303,yankay,6,0.00175,64085,18.71674,342394
2304,ycyxuehan,6,0.00175,64091,18.71849,342394
2305,ydp,6,0.00175,64097,18.72025,342394
2306,yoshwata,6,0.00175,64103,18.72200,342394
2307,ysjjovo,6,0.00175,64109,18.72375,342394
2308,ysmolyar,6,0.00175,64115,18.72550,342394
2309,yuqiuw,6,0.00175,64121,18.72726,342394
2310,yuvaldolev,6,0.00175,64127,18.72901,342394
2311,YuviGold,6,0.00175,64133,18.73076,342394
2312,zeminzhou,6,0.00175,64139,18.73251,342394
2313,zewelor,6,0.00175,64145,18.73427,342394
2314,zhammer,6,0.00175,64151,18.73602,342394
2315,zhoufeitest,6,0.00175,64157,18.73777,342394
2316,zhubuntu,6,0.00175,64163,18.73952,342394
2317,ziaulhasanhamim,6,0.00175,64169,18.74127,342394
2318,zohebs341,6,0.00175,64175,18.74303,342394
2319,zqwlai,6,0.00175,64181,18.74478,342394
2320,Zsolt-LazarZsolt,6,0.00175,64187,18.74653,342394
2321,Zyava,6,0.00175,64193,18.74828,342394
2322,zyfo2,6,0.00175,64199,18.75004,342394
2323,123vivekr,5,0.00146,64204,18.75150,342394
2324,1448376744,5,0.00146,64209,18.75296,342394
2325,4integration,5,0.00146,64214,18.75442,342394
2326,aaseem,5,0.00146,64219,18.75588,342394
2327,aasraoui,5,0.00146,64224,18.75734,342394
2328,abhradeepkundu,5,0.00146,64229,18.75880,342394
2329,achilles-git,5,0.00146,64234,18.76026,342394
2330,AchimBursian,5,0.00146,64239,18.76172,342394
2331,agantuk,5,0.00146,64244,18.76318,342394
2332,AH2000141,5,0.00146,64249,18.76464,342394
2333,ahmedTouati,5,0.00146,64254,18.76610,342394
2334,ahmedyarub,5,0.00146,64259,18.76756,342394
2335,AidanDelaney,5,0.00146,64264,18.76902,342394
2336,Ai-yoo,5,0.00146,64269,18.77048,342394
2337,AJadhav29,5,0.00146,64274,18.77194,342394
2338,alan-ma,5,0.00146,64279,18.77340,342394
2339,aldredb,5,0.00146,64284,18.77486,342394
2340,AlecIsaacson,5,0.00146,64289,18.77632,342394
2341,alefcarlos,5,0.00146,64294,18.77778,342394
2342,algebrot,5,0.00146,64299,18.77924,342394
2343,alias-rahil,5,0.00146,64304,18.78070,342394
2344,alibahrami744,5,0.00146,64309,18.78216,342394
2345,aliokaitis,5,0.00146,64314,18.78362,342394
2346,ali-sattari,5,0.00146,64319,18.78508,342394
2347,AljoschaP,5,0.00146,64324,18.78654,342394
2348,Allianzcortex,5,0.00146,64329,18.78800,342394
2349,AmarendraSingh88,5,0.00146,64334,18.78946,342394
2350,ambasta,5,0.00146,64339,18.79093,342394
2351,amccague,5,0.00146,64344,18.79239,342394
2352,AndriiMaliuta,5,0.00146,64349,18.79385,342394
2353,anfoxtrot,5,0.00146,64354,18.79531,342394
2354,anvouk,5,0.00146,64359,18.79677,342394
2355,apphe,5,0.00146,64364,18.79823,342394
2356,aprohorov-gd,5,0.00146,64369,18.79969,342394
2357,aq17,5,0.00146,64374,18.80115,342394
2358,areebrtc,5,0.00146,64379,18.80261,342394
2359,areveny,5,0.00146,64384,18.80407,342394
2360,asafpelegcodes,5,0.00146,64389,18.80553,342394
2361,aschleck,5,0.00146,64394,18.80699,342394
2362,ashishmax31,5,0.00146,64399,18.80845,342394
2363,ashwin153,5,0.00146,64404,18.80991,342394
2364,aswathysen,5,0.00146,64409,18.81137,342394
2365,avivtur,5,0.00146,64414,18.81283,342394
2366,baadc0de,5,0.00146,64419,18.81429,342394
2367,Bakrog,5,0.00146,64424,18.81575,342394
2368,bangarharshit,5,0.00146,64429,18.81721,342394
2369,Banger,5,0.00146,64434,18.81867,342394
2370,baselica,5,0.00146,64439,18.82013,342394
2371,bazzuka,5,0.00146,64444,18.82159,342394
2372,belanasaikiran,5,0.00146,64449,18.82305,342394
2373,bemipefe,5,0.00146,64454,18.82451,342394
2374,bengbeng-pp,5,0.00146,64459,18.82597,342394
2375,bengl,5,0.00146,64464,18.82743,342394
2376,bino98,5,0.00146,64469,18.82889,342394
2377,bj-1795,5,0.00146,64474,18.83035,342394
2378,BlakeWills,5,0.00146,64479,18.83181,342394
2379,bmmiller,5,0.00146,64484,18.83327,342394
2380,bndbsh,5,0.00146,64489,18.83473,342394
2381,Borchies,5,0.00146,64494,18.83619,342394
2382,boskiv,5,0.00146,64499,18.83765,342394
2383,bstolz,5,0.00146,64504,18.83912,342394
2384,calltosantosh,5,0.00146,64509,18.84058,342394
2385,captainarcher,5,0.00146,64514,18.84204,342394
2386,carlitose,5,0.00146,64519,18.84350,342394
2387,cbjjensen,5,0.00146,64524,18.84496,342394
2388,ccppoo,5,0.00146,64529,18.84642,342394
2389,cgchinmay,5,0.00146,64534,18.84788,342394
2390,ChameleonRed,5,0.00146,64539,18.84934,342394
2391,charcharan,5,0.00146,64544,18.85080,342394
2392,cheesetree,5,0.00146,64549,18.85226,342394
2393,chengguruchun,5,0.00146,64554,18.85372,342394
2394,chertby,5,0.00146,64559,18.85518,342394
2395,ChezCrawford,5,0.00146,64564,18.85664,342394
2396,choo-stripe,5,0.00146,64569,18.85810,342394
2397,chris-fengtian-guo,5,0.00146,64574,18.85956,342394
2398,chwetion,5,0.00146,64579,18.86102,342394
2399,cityofwang,5,0.00146,64584,18.86248,342394
2400,conclusionlogic,5,0.00146,64589,18.86394,342394
2401,creydr,5,0.00146,64594,18.86540,342394
2402,cuyl,5,0.00146,64599,18.86686,342394
2403,cyzFC,5,0.00146,64604,18.86832,342394
2404,d19dotca,5,0.00146,64609,18.86978,342394
2405,dalgibbard,5,0.00146,64614,18.87124,342394
2406,damiendawreck,5,0.00146,64619,18.87270,342394
2407,danksim,5,0.00146,64624,18.87416,342394
2408,darxkies,5,0.00146,64629,18.87562,342394
2409,davidleitw,5,0.00146,64634,18.87708,342394
2410,daydy16,5,0.00146,64639,18.87854,342394
2411,dbgoytia,5,0.00146,64644,18.88000,342394
2412,deepak-bhardwaj-ps,5,0.00146,64649,18.88146,342394
2413,deining,5,0.00146,64654,18.88292,342394
2414,desjardd1,5,0.00146,64659,18.88438,342394
2415,devedse,5,0.00146,64664,18.88584,342394
2416,devopstales,5,0.00146,64669,18.88731,342394
2417,DexManx,5,0.00146,64674,18.88877,342394
2418,dheerajjoshim,5,0.00146,64679,18.89023,342394
2419,digambar15,5,0.00146,64684,18.89169,342394
2420,dilyanpalauzov,5,0.00146,64689,18.89315,342394
2421,divya-prakash2,5,0.00146,64694,18.89461,342394
2422,dlm,5,0.00146,64699,18.89607,342394
2423,dmeytin,5,0.00146,64704,18.89753,342394
2424,domechn,5,0.00146,64709,18.89899,342394
2425,dominikjeske,5,0.00146,64714,18.90045,342394
2426,domvo,5,0.00146,64719,18.90191,342394
2427,don4of4,5,0.00146,64724,18.90337,342394
2428,dqzgkyh,5,0.00146,64729,18.90483,342394
2429,dragondscv,5,0.00146,64734,18.90629,342394
2430,drdkadtr,5,0.00146,64739,18.90775,342394
2431,drmorr0,5,0.00146,64744,18.90921,342394
2432,dschwank,5,0.00146,64749,18.91067,342394
2433,dublx,5,0.00146,64754,18.91213,342394
2434,duncan485,5,0.00146,64759,18.91359,342394
2435,DylanPrinsITScripts,5,0.00146,64764,18.91505,342394
2436,DysphoricUnicorn,5,0.00146,64769,18.91651,342394
2437,dzhi-lyft,5,0.00146,64774,18.91797,342394
2438,eduser25,5,0.00146,64779,18.91943,342394
2439,edwardxia,5,0.00146,64784,18.92089,342394
2440,elruwen,5,0.00146,64789,18.92235,342394
2441,eltociear,5,0.00146,64794,18.92381,342394
2442,emilytao,5,0.00146,64799,18.92527,342394
2443,EricWvi,5,0.00146,64804,18.92673,342394
2444,essie-chiang,5,0.00146,64809,18.92819,342394
2445,etamarw,5,0.00146,64814,18.92965,342394
2446,evertrain,5,0.00146,64819,18.93111,342394
2447,ewerton-silva00,5,0.00146,64824,18.93257,342394
2448,fagiani,5,0.00146,64829,18.93404,342394
2449,fatiiates,5,0.00146,64834,18.93550,342394
2450,fdr,5,0.00146,64839,18.93696,342394
2451,feedmypixel,5,0.00146,64844,18.93842,342394
2452,fengypants,5,0.00146,64849,18.93988,342394
2453,fernando-az-cloudkite,5,0.00146,64854,18.94134,342394
2454,fkocik,5,0.00146,64859,18.94280,342394
2455,flouthoc,5,0.00146,64864,18.94426,342394
2456,fmeum,5,0.00146,64869,18.94572,342394
2457,fOO223Fr,5,0.00146,64874,18.94718,342394
2458,forging2012,5,0.00146,64879,18.94864,342394
2459,fourstepper,5,0.00146,64884,18.95010,342394
2460,frzifus,5,0.00146,64889,18.95156,342394
2461,gaellm,5,0.00146,64894,18.95302,342394
2462,gaganso,5,0.00146,64899,18.95448,342394
2463,Gammal-Skalbagge,5,0.00146,64904,18.95594,342394
2464,garrygerber,5,0.00146,64909,18.95740,342394
2465,genkami,5,0.00146,64914,18.95886,342394
2466,geraldnolan,5,0.00146,64919,18.96032,342394
2467,getkub,5,0.00146,64924,18.96178,342394
2468,gferon,5,0.00146,64929,18.96324,342394
2469,ggardet,5,0.00146,64934,18.96470,342394
2470,gi8lino,5,0.00146,64939,18.96616,342394
2471,gidde8,5,0.00146,64944,18.96762,342394
2472,GiGurra,5,0.00146,64949,18.96908,342394
2473,git102347501,5,0.00146,64954,18.97054,342394
2474,Goend,5,0.00146,64959,18.97200,342394
2475,gongcon,5,0.00146,64964,18.97346,342394
2476,gowrisankar22,5,0.00146,64969,18.97492,342394
2477,gowthamgts,5,0.00146,64974,18.97638,342394
2478,gregbuehler,5,0.00146,64979,18.97784,342394
2479,gtskaushik,5,0.00146,64984,18.97930,342394
2480,haddasbronfman,5,0.00146,64989,18.98076,342394
2481,hammadk373,5,0.00146,64994,18.98223,342394
2482,hammadzz,5,0.00146,64999,18.98369,342394
2483,hardoverflow,5,0.00146,65004,18.98515,342394
2484,headkm,5,0.00146,65009,18.98661,342394
2485,HemanthMarella,5,0.00146,65014,18.98807,342394
2486,hiteshp39,5,0.00146,65019,18.98953,342394
2487,hl10105210,5,0.00146,65024,18.99099,342394
2488,horovits,5,0.00146,65029,18.99245,342394
2489,hugovk,5,0.00146,65034,18.99391,342394
2490,hydrapolic,5,0.00146,65039,18.99537,342394
2491,iamejboy,5,0.00146,65044,18.99683,342394
2492,ichmachnixichgucknur,5,0.00146,65049,18.99829,342394
2493,IliaGe,5,0.00146,65054,18.99975,342394
2494,imageschool,5,0.00146,65059,19.00121,342394
2495,isaac88,5,0.00146,65064,19.00267,342394
2496,Ishizuka427,5,0.00146,65069,19.00413,342394
2497,isloveh,5,0.00146,65074,19.00559,342394
2498,itoffshore,5,0.00146,65079,19.00705,342394
2499,itshaungmu,5,0.00146,65084,19.00851,342394
2500,itsMeShon,5,0.00146,65089,19.00997,342394
2501,ixxeL2097,5,0.00146,65094,19.01143,342394
2502,JakeStanger,5,0.00146,65099,19.01289,342394
2503,jak-sdk,5,0.00146,65104,19.01435,342394
2504,jan-pokorny,5,0.00146,65109,19.01581,342394
2505,jarmee,5,0.00146,65114,19.01727,342394
2506,Jason-Liu-Dream,5,0.00146,65119,19.01873,342394
2507,jaywayjayway,5,0.00146,65124,19.02019,342394
2508,jccarte,5,0.00146,65129,19.02165,342394
2509,jceb,5,0.00146,65134,19.02311,342394
2510,jdftapi,5,0.00146,65139,19.02457,342394
2511,Jeansen,5,0.00146,65144,19.02603,342394
2512,jefferbrecht,5,0.00146,65149,19.02749,342394
2513,jhnine,5,0.00146,65154,19.02895,342394
2514,jiangdongzi,5,0.00146,65159,19.03042,342394
2515,jimdaga,5,0.00146,65164,19.03188,342394
2516,jkmw,5,0.00146,65169,19.03334,342394
2517,jodevsa,5,0.00146,65174,19.03480,342394
2518,jodybro,5,0.00146,65179,19.03626,342394
2519,joejustesen,5,0.00146,65184,19.03772,342394
2520,JohanElmis,5,0.00146,65189,19.03918,342394
2521,JohnGalt1717,5,0.00146,65194,19.04064,342394
2522,jonathanmetzman,5,0.00146,65199,19.04210,342394
2523,josh-ferrell,5,0.00146,65204,19.04356,342394
2524,jossemargt-3pillar,5,0.00146,65209,19.04502,342394
2525,JoThomsen,5,0.00146,65214,19.04648,342394
2526,juliasimon,5,0.00146,65219,19.04794,342394
2527,JuozasVainauskas,5,0.00146,65224,19.04940,342394
2528,justlucknb,5,0.00146,65229,19.05086,342394
2529,k0000k,5,0.00146,65234,19.05232,342394
2530,kalyanaj,5,0.00146,65239,19.05378,342394
2531,kathan24,5,0.00146,65244,19.05524,342394
2532,kayamaty,5,0.00146,65249,19.05670,342394
2533,kc8421,5,0.00146,65254,19.05816,342394
2534,kc-dot-io,5,0.00146,65259,19.05962,342394
2535,Ketonmi,5,0.00146,65264,19.06108,342394
2536,kiapanahi,5,0.00146,65269,19.06254,342394
2537,kien-truong,5,0.00146,65274,19.06400,342394
2538,kimhongji,5,0.00146,65279,19.06546,342394
2539,kirankumar26,5,0.00146,65284,19.06692,342394
2540,kirecek,5,0.00146,65289,19.06838,342394
2541,koktlzz,5,0.00146,65294,19.06984,342394
2542,konekoya,5,0.00146,65299,19.07130,342394
2543,KosrenDQ,5,0.00146,65304,19.07276,342394
2544,kpaschen,5,0.00146,65309,19.07422,342394
2545,Krumbelfix,5,0.00146,65314,19.07568,342394
2546,kumy,5,0.00146,65319,19.07715,342394
2547,l1990790120,5,0.00146,65324,19.07861,342394
2548,laojianzi,5,0.00146,65329,19.08007,342394
2549,laurie-kepford,5,0.00146,65334,19.08153,342394
2550,lcsbaroni,5,0.00146,65339,19.08299,342394
2551,LDawns,5,0.00146,65344,19.08445,342394
2552,leongross,5,0.00146,65349,19.08591,342394
2553,leroy-chen,5,0.00146,65354,19.08737,342394
2554,li1234yun,5,0.00146,65359,19.08883,342394
2555,lifeoncloud,5,0.00146,65364,19.09029,342394
2556,linkingli,5,0.00146,65369,19.09175,342394
2557,litmusbot,5,0.00146,65374,19.09321,342394
2558,little-fang,5,0.00146,65379,19.09467,342394
2559,Liversage,5,0.00146,65384,19.09613,342394
2560,liyinxin,5,0.00146,65389,19.09759,342394
2561,ljakimczuk,5,0.00146,65394,19.09905,342394
2562,lokeshcse6,5,0.00146,65399,19.10051,342394
2563,Lol3rrr,5,0.00146,65404,19.10197,342394
2564,loveyana,5,0.00146,65409,19.10343,342394
2565,lubingfeng,5,0.00146,65414,19.10489,342394
2566,luckyfengyong,5,0.00146,65419,19.10635,342394
2567,luigibk,5,0.00146,65424,19.10781,342394
2568,LvLs9,5,0.00146,65429,19.10927,342394
2569,lykkeaxlin,5,0.00146,65434,19.11073,342394
2570,lzctxwd,5,0.00146,65439,19.11219,342394
2571,MaayanFarchi,5,0.00146,65444,19.11365,342394
2572,maikoulin,5,0.00146,65449,19.11511,342394
2573,malderete,5,0.00146,65454,19.11657,342394
2574,Manasi25,5,0.00146,65459,19.11803,342394
2575,maplebeats,5,0.00146,65464,19.11949,342394
2576,MarekLani,5,0.00146,65469,19.12095,342394
2577,marffin,5,0.00146,65474,19.12241,342394
2578,markuman,5,0.00146,65479,19.12387,342394
2579,MartinTrojans,5,0.00146,65484,19.12534,342394
2580,masonkmeyer,5,0.00146,65489,19.12680,342394
2581,matchaxnb,5,0.00146,65494,19.12826,342394
2582,mathew-fleisch,5,0.00146,65499,19.12972,342394
2583,matiasrege,5,0.00146,65504,19.13118,342394
2584,mattfysh,5,0.00146,65509,19.13264,342394
2585,mattjs,5,0.00146,65514,19.13410,342394
2586,MaxHorstmann,5,0.00146,65519,19.13556,342394
2587,mberrueta1,5,0.00146,65524,19.13702,342394
2588,mcjhknauf,5,0.00146,65529,19.13848,342394
2589,mdraijer,5,0.00146,65534,19.13994,342394
2590,MeinhardZhou,5,0.00146,65539,19.14140,342394
2591,mgeri,5,0.00146,65544,19.14286,342394
2592,mhoff,5,0.00146,65549,19.14432,342394
2593,mhubig,5,0.00146,65554,19.14578,342394
2594,michaelb990,5,0.00146,65559,19.14724,342394
2595,mihaitodor,5,0.00146,65564,19.14870,342394
2596,Mikadore,5,0.00146,65569,19.15016,342394
2597,miketice22,5,0.00146,65574,19.15162,342394
2598,miraculli,5,0.00146,65579,19.15308,342394
2599,mirayadav,5,0.00146,65584,19.15454,342394
2600,mmib,5,0.00146,65589,19.15600,342394
2601,Mohammed-0,5,0.00146,65594,19.15746,342394
2602,mokarage,5,0.00146,65599,19.15892,342394
2603,moonovo,5,0.00146,65604,19.16038,342394
2604,mot256,5,0.00146,65609,19.16184,342394
2605,Mr-Destructive,5,0.00146,65614,19.16330,342394
2606,ms2008,5,0.00146,65619,19.16476,342394
2607,msciabarra,5,0.00146,65624,19.16622,342394
2608,Msunshineboy,5,0.00146,65629,19.16768,342394
2609,muicoder,5,0.00146,65634,19.16914,342394
2610,mukeshkwm,5,0.00146,65639,19.17060,342394
2611,multimac,5,0.00146,65644,19.17206,342394
2612,mvh-stripe,5,0.00146,65649,19.17353,342394
2613,My-pleasure,5,0.00146,65654,19.17499,342394
2614,m-yukio,5,0.00146,65659,19.17645,342394
2615,Nankeadream,5,0.00146,65664,19.17791,342394
2616,natalisucks,5,0.00146,65669,19.17937,342394
2617,naveedyahyazadeh,5,0.00146,65674,19.18083,342394
2618,ncapps,5,0.00146,65679,19.18229,342394
2619,Neilblaze,5,0.00146,65684,19.18375,342394
2620,Nello-Angelo,5,0.00146,65689,19.18521,342394
2621,nemat-rakhmatov,5,0.00146,65694,19.18667,342394
2622,nerdeveloper,5,0.00146,65699,19.18813,342394
2623,nicolacdnll,5,0.00146,65704,19.18959,342394
2624,nicolasadeo,5,0.00146,65709,19.19105,342394
2625,nikkhn,5,0.00146,65714,19.19251,342394
2626,NilimaC04,5,0.00146,65719,19.19397,342394
2627,nimrodishi,5,0.00146,65724,19.19543,342394
2628,nmarandi,5,0.00146,65729,19.19689,342394
2629,nonylene,5,0.00146,65734,19.19835,342394
2630,npnwdev,5,0.00146,65739,19.19981,342394
2631,ntdt,5,0.00146,65744,19.20127,342394
2632,oDn,5,0.00146,65749,19.20273,342394
2633,OJumpyo,5,0.00146,65754,19.20419,342394
2634,OleksandrShtepa,5,0.00146,65759,19.20565,342394
2635,oliverb123,5,0.00146,65764,19.20711,342394
2636,onlyacat,5,0.00146,65769,19.20857,342394
2637,oskarirauta,5,0.00146,65774,19.21003,342394
2638,otassetti-talend,5,0.00146,65779,19.21149,342394
2639,oxeye-ron,5,0.00146,65784,19.21295,342394
2640,oxeye-yuval,5,0.00146,65789,19.21441,342394
2641,oxr463,5,0.00146,65794,19.21587,342394
2642,ozhankaraman,5,0.00146,65799,19.21733,342394
2643,pablodgonzalez,5,0.00146,65804,19.21879,342394
2644,paleloser,5,0.00146,65809,19.22026,342394
2645,panyuenlau,5,0.00146,65814,19.22172,342394
2646,paoloteti,5,0.00146,65819,19.22318,342394
2647,parul5sahoo,5,0.00146,65824,19.22464,342394
2648,patsevanton,5,0.00146,65829,19.22610,342394
2649,peiniliu,5,0.00146,65834,19.22756,342394
2650,phenixrizen,5,0.00146,65839,19.22902,342394
2651,philipcwhite,5,0.00146,65844,19.23048,342394
2652,philnichol,5,0.00146,65849,19.23194,342394
2653,piotrrotter,5,0.00146,65854,19.23340,342394
2654,pkuma001,5,0.00146,65859,19.23486,342394
2655,pozsgaic,5,0.00146,65864,19.23632,342394
2656,prankulmahajan,5,0.00146,65869,19.23778,342394
2657,Praveenrajmani,5,0.00146,65874,19.23924,342394
2658,qingfengfenga,5,0.00146,65879,19.24070,342394
2659,qls152,5,0.00146,65884,19.24216,342394
2660,qsyqian,5,0.00146,65889,19.24362,342394
2661,QWQyyy,5,0.00146,65894,19.24508,342394
2662,Raag007,5,0.00146,65899,19.24654,342394
2663,rabenhorst,5,0.00146,65904,19.24800,342394
2664,rabollin,5,0.00146,65909,19.24946,342394
2665,ramgiteng,5,0.00146,65914,19.25092,342394
2666,raoptimus,5,0.00146,65919,19.25238,342394
2667,RashmiRam,5,0.00146,65924,19.25384,342394
2668,ravenblackx,5,0.00146,65929,19.25530,342394
2669,ravimalvia,5,0.00146,65934,19.25676,342394
2670,rbiassoni,5,0.00146,65939,19.25822,342394
2671,redradrat,5,0.00146,65944,19.25968,342394
2672,reesericci,5,0.00146,65949,19.26114,342394
2673,reggie-k,5,0.00146,65954,19.26260,342394
2674,remus-corneliu,5,0.00146,65959,19.26406,342394
2675,rguske,5,0.00146,65964,19.26552,342394
2676,richardstone,5,0.00146,65969,19.26698,342394
2677,riza-wartek,5,0.00146,65974,19.26845,342394
2678,rjoly-qlik,5,0.00146,65979,19.26991,342394
2679,robdimsdale,5,0.00146,65984,19.27137,342394
2680,RoboticHuman,5,0.00146,65989,19.27283,342394
2681,rockmenjack,5,0.00146,65994,19.27429,342394
2682,rodrigoscferraz,5,0.00146,65999,19.27575,342394
2683,roitalpaz,5,0.00146,66004,19.27721,342394
2684,RoniKishner,5,0.00146,66009,19.27867,342394
2685,rparke,5,0.00146,66014,19.28013,342394
2686,rpiotrow,5,0.00146,66019,19.28159,342394
2687,rsalmond,5,0.00146,66024,19.28305,342394
2688,rsbala,5,0.00146,66029,19.28451,342394
2689,rubroboletus,5,0.00146,66034,19.28597,342394
2690,rudolfbyker,5,0.00146,66039,19.28743,342394
2691,rujews,5,0.00146,66044,19.28889,342394
2692,runebaas,5,0.00146,66049,19.29035,342394
2693,rverenich,5,0.00146,66054,19.29181,342394
2694,RyoKawabata0,5,0.00146,66059,19.29327,342394
2695,samuel-form3,5,0.00146,66064,19.29473,342394
2696,sanjaytangudu230,5,0.00146,66069,19.29619,342394
2697,sanya301,5,0.00146,66074,19.29765,342394
2698,SanZhiYuan,5,0.00146,66079,19.29911,342394
2699,Sarabadu,5,0.00146,66084,19.30057,342394
2700,sathishsoundharajan,5,0.00146,66089,19.30203,342394
2701,schwichtgit,5,0.00146,66094,19.30349,342394
2702,scravy,5,0.00146,66099,19.30495,342394
2703,sejust,5,0.00146,66104,19.30641,342394
2704,seveirbian,5,0.00146,66109,19.30787,342394
2705,sgmac,5,0.00146,66114,19.30933,342394
2706,ShabiDabi,5,0.00146,66119,19.31079,342394
2707,shambannaa,5,0.00146,66124,19.31225,342394
2708,shawqi-voice,5,0.00146,66129,19.31371,342394
2709,shazadbrohi,5,0.00146,66134,19.31517,342394
2710,shippomx,5,0.00146,66139,19.31664,342394
2711,shnmorimoto,5,0.00146,66144,19.31810,342394
2712,Siddhesh-Swami,5,0.00146,66149,19.31956,342394
2713,sid-uni,5,0.00146,66154,19.32102,342394
2714,Siebjee,5,0.00146,66159,19.32248,342394
2715,silence-coding,5,0.00146,66164,19.32394,342394
2716,siliconbrain,5,0.00146,66169,19.32540,342394
2717,SilverBut,5,0.00146,66174,19.32686,342394
2718,simonoff,5,0.00146,66179,19.32832,342394
2719,s-jlatusek,5,0.00146,66184,19.32978,342394
2720,skrlin,5,0.00146,66189,19.33124,342394
2721,skupjoe,5,0.00146,66194,19.33270,342394
2722,sluetze,5,0.00146,66199,19.33416,342394
2723,Snaipe,5,0.00146,66204,19.33562,342394
2724,snickell,5,0.00146,66209,19.33708,342394
2725,snuramjirajukammila,5,0.00146,66214,19.33854,342394
2726,somnusfish,5,0.00146,66219,19.34000,342394
2727,sonali-mishra-94,5,0.00146,66224,19.34146,342394
2728,songlh-psu,5,0.00146,66229,19.34292,342394
2729,songminglong,5,0.00146,66234,19.34438,342394
2730,sossickd,5,0.00146,66239,19.34584,342394
2731,souradeepmoe,5,0.00146,66244,19.34730,342394
2732,spottedmahn,5,0.00146,66249,19.34876,342394
2733,sribee,5,0.00146,66254,19.35022,342394
2734,sshota0809,5,0.00146,66259,19.35168,342394
2735,sstoner,5,0.00146,66264,19.35314,342394
2736,St0rmingBr4in,5,0.00146,66269,19.35460,342394
2737,st9540808,5,0.00146,66274,19.35606,342394
2738,stop-coding,5,0.00146,66279,19.35752,342394
2739,sudeeptoroy,5,0.00146,66284,19.35898,342394
2740,sumit84mca,5,0.00146,66289,19.36044,342394
2741,SunilManthenaG01,5,0.00146,66294,19.36190,342394
2742,sunli829,5,0.00146,66299,19.36337,342394
2743,suzaku,5,0.00146,66304,19.36483,342394
2744,svalaskevicius,5,0.00146,66309,19.36629,342394
2745,SvenScheurer,5,0.00146,66314,19.36775,342394
2746,swartzkevinPFG,5,0.00146,66319,19.36921,342394
2747,syxunion,5,0.00146,66324,19.37067,342394
2748,syyama-net,5,0.00146,66329,19.37213,342394
2749,szucsitg,5,0.00146,66334,19.37359,342394
2750,szvincze,5,0.00146,66339,19.37505,342394
2751,tamir-michaeli,5,0.00146,66344,19.37651,342394
2752,tarun-asthana,5,0.00146,66349,19.37797,342394
2753,tcherel,5,0.00146,66354,19.37943,342394
2754,tearfulDalvik,5,0.00146,66359,19.38089,342394
2755,theduke,5,0.00146,66364,19.38235,342394
2756,theidexisted,5,0.00146,66369,19.38381,342394
2757,themarcelor,5,0.00146,66374,19.38527,342394
2758,theunknownport,5,0.00146,66379,19.38673,342394
2759,thomas-tribus,5,0.00146,66384,19.38819,342394
2760,Thunderlight1,5,0.00146,66389,19.38965,342394
2761,tiero,5,0.00146,66394,19.39111,342394
2762,timbrd,5,0.00146,66399,19.39257,342394
2763,timonmasberg,5,0.00146,66404,19.39403,342394
2764,tim-sendible,5,0.00146,66409,19.39549,342394
2765,t-lo,5,0.00146,66414,19.39695,342394
2766,tmcatch,5,0.00146,66419,19.39841,342394
2767,TobiasLierzer,5,0.00146,66424,19.39987,342394
2768,tom-engineering,5,0.00146,66429,19.40133,342394
2769,TomJKing,5,0.00146,66434,19.40279,342394
2770,truongmd,5,0.00146,66439,19.40425,342394
2771,trv-smaksym3,5,0.00146,66444,19.40571,342394
2772,tyler-lloyd,5,0.00146,66449,19.40717,342394
2773,tyriis,5,0.00146,66454,19.40863,342394
2774,umialpha,5,0.00146,66459,19.41009,342394
2775,untcha,5,0.00146,66464,19.41156,342394
2776,VadimZy,5,0.00146,66469,19.41302,342394
2777,vaibhav-ak,5,0.00146,66474,19.41448,342394
2778,ValeriiVozniuk,5,0.00146,66479,19.41594,342394
2779,vcc-huf,5,0.00146,66484,19.41740,342394
2780,vdelau,5,0.00146,66489,19.41886,342394
2781,veast,5,0.00146,66494,19.42032,342394
2782,venugopalthati,5,0.00146,66499,19.42178,342394
2783,veperales,5,0.00146,66504,19.42324,342394
2784,Veryclouder,5,0.00146,66509,19.42470,342394
2785,VictoryAnn,5,0.00146,66514,19.42616,342394
2786,vidarlx,5,0.00146,66519,19.42762,342394
2787,vieirajluis,5,0.00146,66524,19.42908,342394
2788,vijaymateti,5,0.00146,66529,19.43054,342394
2789,VincentQiu2018,5,0.00146,66534,19.43200,342394
2790,vinusorout,5,0.00146,66539,19.43346,342394
2791,vitruvvius,5,0.00146,66544,19.43492,342394
2792,viveknuna,5,0.00146,66549,19.43638,342394
2793,vivekskrishna,5,0.00146,66554,19.43784,342394
2794,VladimirKhvostov,5,0.00146,66559,19.43930,342394
2795,vrushch,5,0.00146,66564,19.44076,342394
2796,vshender,5,0.00146,66569,19.44222,342394
2797,wangchanggan,5,0.00146,66574,19.44368,342394
2798,wangjie1513,5,0.00146,66579,19.44514,342394
2799,wanrui,5,0.00146,66584,19.44660,342394
2800,wciq1208,5,0.00146,66589,19.44806,342394
2801,wdma,5,0.00146,66594,19.44952,342394
2802,wdoekes,5,0.00146,66599,19.45098,342394
2803,WillMorrison,5,0.00146,66604,19.45244,342394
2804,withernet,5,0.00146,66609,19.45390,342394
2805,wma1729,5,0.00146,66614,19.45536,342394
2806,wpbrown,5,0.00146,66619,19.45682,342394
2807,XiaoWeiKIN,5,0.00146,66624,19.45828,342394
2808,xiejiandong,5,0.00146,66629,19.45975,342394
2809,XingZYu,5,0.00146,66634,19.46121,342394
2810,xinxiao,5,0.00146,66639,19.46267,342394
2811,xinzhongyoumeng,5,0.00146,66644,19.46413,342394
2812,xlyk,5,0.00146,66649,19.46559,342394
2813,yakirgb,5,0.00146,66654,19.46705,342394
2814,yanxingponyai,5,0.00146,66659,19.46851,342394
2815,yedamao,5,0.00146,66664,19.46997,342394
2816,yehiyam,5,0.00146,66669,19.47143,342394
2817,Yitaek,5,0.00146,66674,19.47289,342394
2818,yojay11717,5,0.00146,66679,19.47435,342394
2819,YukhoY,5,0.00146,66684,19.47581,342394
2820,YutaroHayakawa,5,0.00146,66689,19.47727,342394
2821,zapotah,5,0.00146,66694,19.47873,342394
2822,zemkogabor,5,0.00146,66699,19.48019,342394
2823,zhan9san,5,0.00146,66704,19.48165,342394
2824,zhendongcmss,5,0.00146,66709,19.48311,342394
2825,Zhongya-Yan,5,0.00146,66714,19.48457,342394
2826,zhugelianglongming,5,0.00146,66719,19.48603,342394
2827,zlseu-edu,5,0.00146,66724,19.48749,342394
2828,zychina,5,0.00146,66729,19.48895,342394
2829,zyliu0402,5,0.00146,66734,19.49041,342394
2830,zzr88,5,0.00146,66739,19.49187,342394
2831,00pf00,4,0.00117,66743,19.49304,342394
2832,0xff-dev,4,0.00117,66747,19.49421,342394
2833,110y,4,0.00117,66751,19.49538,342394
2834,15669072513,4,0.00117,66755,19.49654,342394
2835,15926273249,4,0.00117,66759,19.49771,342394
2836,18133880978,4,0.00117,66763,19.49888,342394
2837,21kyu,4,0.00117,66767,19.50005,342394
2838,24sama,4,0.00117,66771,19.50122,342394
2839,5wjdgns2,4,0.00117,66775,19.50239,342394
2840,aagten,4,0.00117,66779,19.50355,342394
2841,aalcaraz97,4,0.00117,66783,19.50472,342394
2842,aaranmcguire,4,0.00117,66787,19.50589,342394
2843,aarongoulet,4,0.00117,66791,19.50706,342394
2844,AbdElRhman2111,4,0.00117,66795,19.50823,342394
2845,abdidarmawan007,4,0.00117,66799,19.50940,342394
2846,abhaykumarPS,4,0.00117,66803,19.51056,342394
2847,abhinb,4,0.00117,66807,19.51173,342394
2848,abousias,4,0.00117,66811,19.51290,342394
2849,abroglesc,4,0.00117,66815,19.51407,342394
2850,adamkirk,4,0.00117,66819,19.51524,342394
2851,AdamSLevy,4,0.00117,66823,19.51641,342394
2852,AdmiralGT,4,0.00117,66827,19.51757,342394
2853,afro-coder,4,0.00117,66831,19.51874,342394
2854,AGhost-7,4,0.00117,66835,19.51991,342394
2855,agustindaguerre,4,0.00117,66839,19.52108,342394
2856,ahmadzaikk,4,0.00117,66843,19.52225,342394
2857,Ajarmar,4,0.00117,66847,19.52341,342394
2858,aksdb,4,0.00117,66851,19.52458,342394
2859,akulpillai,4,0.00117,66855,19.52575,342394
2860,akz08,4,0.00117,66859,19.52692,342394
2861,alanhg,4,0.00117,66863,19.52809,342394
2862,AlbMor,4,0.00117,66867,19.52926,342394
2863,alebedev87,4,0.00117,66871,19.53042,342394
2864,aleksandrbog,4,0.00117,66875,19.53159,342394
2865,alexglatt,4,0.00117,66879,19.53276,342394
2866,Alexis-M51,4,0.00117,66883,19.53393,342394
2867,alexoughton,4,0.00117,66887,19.53510,342394
2868,aloisbarreras,4,0.00117,66891,19.53627,342394
2869,AlverezYari,4,0.00117,66895,19.53743,342394
2870,amandapunch,4,0.00117,66899,19.53860,342394
2871,a-mcf,4,0.00117,66903,19.53977,342394
2872,amisevsk,4,0.00117,66907,19.54094,342394
2873,amitgud-doordash,4,0.00117,66911,19.54211,342394
2874,amitlevy21,4,0.00117,66915,19.54327,342394
2875,amshankaran,4,0.00117,66919,19.54444,342394
2876,anand-abgis,4,0.00117,66923,19.54561,342394
2877,ananda-chintalapati,4,0.00117,66927,19.54678,342394
2878,andrewchen5678,4,0.00117,66931,19.54795,342394
2879,andrey-gava,4,0.00117,66935,19.54912,342394
2880,angelowolf,4,0.00117,66939,19.55028,342394
2881,anjanmadaram,4,0.00117,66943,19.55145,342394
2882,anjayajodha,4,0.00117,66947,19.55262,342394
2883,antifuchs,4,0.00117,66951,19.55379,342394
2884,antmoveh,4,0.00117,66955,19.55496,342394
2885,anton-danielsson,4,0.00117,66959,19.55613,342394
2886,aquaeye,4,0.00117,66963,19.55729,342394
2887,arcosx,4,0.00117,66967,19.55846,342394
2888,arhamahmed,4,0.00117,66971,19.55963,342394
2889,arman-zhumakhan,4,0.00117,66975,19.56080,342394
2890,arnesacnussem,4,0.00117,66979,19.56197,342394
2891,arnitolog,4,0.00117,66983,19.56313,342394
2892,arosh,4,0.00117,66987,19.56430,342394
2893,arsenalpoll,4,0.00117,66991,19.56547,342394
2894,arundathi-nirmata,4,0.00117,66995,19.56664,342394
2895,asanderson,4,0.00117,66999,19.56781,342394
2896,ashish6976,4,0.00117,67003,19.56898,342394
2897,asimhon,4,0.00117,67007,19.57014,342394
2898,Askill,4,0.00117,67011,19.57131,342394
2899,asonix,4,0.00117,67015,19.57248,342394
2900,Avers90,4,0.00117,67019,19.57365,342394
2901,averzicco,4,0.00117,67023,19.57482,342394
2902,awoimbee,4,0.00117,67027,19.57599,342394
2903,badouralix,4,0.00117,67031,19.57715,342394
2904,balajinarayanaa,4,0.00117,67035,19.57832,342394
2905,Bananenbieger1234,4,0.00117,67039,19.57949,342394
2906,BaoYuwei,4,0.00117,67043,19.58066,342394
2907,baromm14,4,0.00117,67047,19.58183,342394
2908,basit9958,4,0.00117,67051,19.58300,342394
2909,basuotian,4,0.00117,67055,19.58416,342394
2910,benjaminsky,4,0.00117,67059,19.58533,342394
2911,benpbrown,4,0.00117,67063,19.58650,342394
2912,Berreek,4,0.00117,67067,19.58767,342394
2913,bestbeforetoday,4,0.00117,67071,19.58884,342394
2914,beyonderyue,4,0.00117,67075,19.59000,342394
2915,bglimepoint,4,0.00117,67079,19.59117,342394
2916,bgregg,4,0.00117,67083,19.59234,342394
2917,bherw,4,0.00117,67087,19.59351,342394
2918,bigclouds,4,0.00117,67091,19.59468,342394
2919,Bjohnson131,4,0.00117,67095,19.59585,342394
2920,bk201,4,0.00117,67099,19.59701,342394
2921,Blacksmoke16,4,0.00117,67103,19.59818,342394
2922,blakyaks,4,0.00117,67107,19.59935,342394
2923,blevine,4,0.00117,67111,19.60052,342394
2924,bmacher,4,0.00117,67115,19.60169,342394
2925,bmalynovytch,4,0.00117,67119,19.60286,342394
2926,bmon,4,0.00117,67123,19.60402,342394
2927,boris-ilijic,4,0.00117,67127,19.60519,342394
2928,bosorawis00,4,0.00117,67131,19.60636,342394
2929,bradyma1,4,0.00117,67135,19.60753,342394
2930,braydonk,4,0.00117,67139,19.60870,342394
2931,brunoguidone,4,0.00117,67143,19.60986,342394
2932,BryanStenson-okta,4,0.00117,67147,19.61103,342394
2933,bryding,4,0.00117,67151,19.61220,342394
2934,btwnsvll,4,0.00117,67155,19.61337,342394
2935,bugg123,4,0.00117,67159,19.61454,342394
2936,busyboy-ws,4,0.00117,67163,19.61571,342394
2937,cafruv,4,0.00117,67167,19.61687,342394
2938,CalvinKirs,4,0.00117,67171,19.61804,342394
2939,cameronmwall,4,0.00117,67175,19.61921,342394
2940,cangyin,4,0.00117,67179,19.62038,342394
2941,caphrim007,4,0.00117,67183,19.62155,342394
2942,cardyok,4,0.00117,67187,19.62272,342394
2943,care0717,4,0.00117,67191,19.62388,342394
2944,caseywebdev,4,0.00117,67195,19.62505,342394
2945,Cavvar,4,0.00117,67199,19.62622,342394
2946,cawoodm,4,0.00117,67203,19.62739,342394
2947,ccaillet1974,4,0.00117,67207,19.62856,342394
2948,ccqy66,4,0.00117,67211,19.62972,342394
2949,chary1112004,4,0.00117,67215,19.63089,342394
2950,cheersalam,4,0.00117,67219,19.63206,342394
2951,ChengyangDu,4,0.00117,67223,19.63323,342394
2952,chenziya,4,0.00117,67227,19.63440,342394
2953,chienfuchen32,4,0.00117,67231,19.63557,342394
2954,chinaran,4,0.00117,67235,19.63673,342394
2955,Choko256,4,0.00117,67239,19.63790,342394
2956,ChrisERo,4,0.00117,67243,19.63907,342394
2957,chris-kruining,4,0.00117,67247,19.64024,342394
2958,christianrowlands,4,0.00117,67251,19.64141,342394
2959,Chwetion,4,0.00117,67255,19.64258,342394
2960,ckruegerkpmg,4,0.00117,67259,19.64374,342394
2961,cksac,4,0.00117,67263,19.64491,342394
2962,claudiarmamede,4,0.00117,67267,19.64608,342394
2963,cloris-cc,4,0.00117,67271,19.64725,342394
2964,Cloudzp,4,0.00117,67275,19.64842,342394
2965,clp01,4,0.00117,67279,19.64958,342394
2966,cmanzur,4,0.00117,67283,19.65075,342394
2967,Coder63,4,0.00117,67287,19.65192,342394
2968,CodingSpiderFox,4,0.00117,67291,19.65309,342394
2969,ComradePashka,4,0.00117,67295,19.65426,342394
2970,crazywill,4,0.00117,67299,19.65543,342394
2971,ctrought,4,0.00117,67303,19.65659,342394
2972,cuericlee,4,0.00117,67307,19.65776,342394
2973,cxhiano,4,0.00117,67311,19.65893,342394
2974,cydergoth,4,0.00117,67315,19.66010,342394
2975,cyfdecyf,4,0.00117,67319,19.66127,342394
2976,dabaooline,4,0.00117,67323,19.66244,342394
2977,dancamdev,4,0.00117,67327,19.66360,342394
2978,DanielSmrecnik,4,0.00117,67331,19.66477,342394
2979,Dani-Ionescu,4,0.00117,67335,19.66594,342394
2980,dan-j,4,0.00117,67339,19.66711,342394
2981,danlenar,4,0.00117,67343,19.66828,342394
2982,dannykopping,4,0.00117,67347,19.66945,342394
2983,dan-tw,4,0.00117,67351,19.67061,342394
2984,darkl0rd,4,0.00117,67355,19.67178,342394
2985,darryl-sw,4,0.00117,67359,19.67295,342394
2986,Dave-Dush,4,0.00117,67363,19.67412,342394
2987,davidg-sainsbury,4,0.00117,67367,19.67529,342394
2988,davidstauffer,4,0.00117,67371,19.67645,342394
2989,deamwork,4,0.00117,67375,19.67762,342394
2990,DeathBorn,4,0.00117,67379,19.67879,342394
2991,debu99,4,0.00117,67383,19.67996,342394
2992,deejgregor,4,0.00117,67387,19.68113,342394
2993,Deepakktripathy,4,0.00117,67391,19.68230,342394
2994,deepio,4,0.00117,67395,19.68346,342394
2995,delthas,4,0.00117,67399,19.68463,342394
2996,Demon520-coder,4,0.00117,67403,19.68580,342394
2997,DemonLee0719,4,0.00117,67407,19.68697,342394
2998,denniseffing,4,0.00117,67411,19.68814,342394
2999,derekguo001,4,0.00117,67415,19.68931,342394
3000,devadapter,4,0.00117,67419,19.69047,342394
3001,dfernandezm,4,0.00117,67423,19.69164,342394
3002,dhess,4,0.00117,67427,19.69281,342394
3003,digibank-rons,4,0.00117,67431,19.69398,342394
3004,dimatha,4,0.00117,67435,19.69515,342394
3005,dirathea,4,0.00117,67439,19.69631,342394
3006,disraelig444,4,0.00117,67443,19.69748,342394
3007,Divsigma,4,0.00117,67447,19.69865,342394
3008,dixitsatyam,4,0.00117,67451,19.69982,342394
3009,dkeven,4,0.00117,67455,19.70099,342394
3010,dlaube,4,0.00117,67459,19.70216,342394
3011,dlouvier,4,0.00117,67463,19.70332,342394
3012,doberkofler,4,0.00117,67467,19.70449,342394
3013,dogukantuna,4,0.00117,67471,19.70566,342394
3014,domcai,4,0.00117,67475,19.70683,342394
3015,domik82,4,0.00117,67479,19.70800,342394
3016,donaldh,4,0.00117,67483,19.70917,342394
3017,donorp,4,0.00117,67487,19.71033,342394
3018,donovan-lampa,4,0.00117,67491,19.71150,342394
3019,dora56,4,0.00117,67495,19.71267,342394
3020,dovholuknf,4,0.00117,67499,19.71384,342394
3021,dp-42,4,0.00117,67503,19.71501,342394
3022,DrAuYueng,4,0.00117,67507,19.71617,342394
3023,dravenk,4,0.00117,67511,19.71734,342394
3024,drazul,4,0.00117,67515,19.71851,342394
3025,drduker,4,0.00117,67519,19.71968,342394
3026,Drew40B,4,0.00117,67523,19.72085,342394
3027,dubeau,4,0.00117,67527,19.72202,342394
3028,dudinea,4,0.00117,67531,19.72318,342394
3029,dunefro,4,0.00117,67535,19.72435,342394
3030,dzediar,4,0.00117,67539,19.72552,342394
3031,edib,4,0.00117,67543,19.72669,342394
3032,eduever,4,0.00117,67547,19.72786,342394
3033,eero-t,4,0.00117,67551,19.72903,342394
3034,EJTJ3,4,0.00117,67555,19.73019,342394
3035,elaguerta,4,0.00117,67559,19.73136,342394
3036,elialgranti,4,0.00117,67563,19.73253,342394
3037,emmayang,4,0.00117,67567,19.73370,342394
3038,Entropy70,4,0.00117,67571,19.73487,342394
3039,eobianwu,4,0.00117,67575,19.73604,342394
3040,epaitoo,4,0.00117,67579,19.73720,342394
3041,ericofusco,4,0.00117,67583,19.73837,342394
3042,ericsampson,4,0.00117,67587,19.73954,342394
3043,errge,4,0.00117,67591,19.74071,342394
3044,euskadi31,4,0.00117,67595,19.74188,342394
3045,evercast-chris,4,0.00117,67599,19.74304,342394
3046,evindunn,4,0.00117,67603,19.74421,342394
3047,ewash1,4,0.00117,67607,19.74538,342394
3048,Expalex,4,0.00117,67611,19.74655,342394
3049,eyinwag,4,0.00117,67615,19.74772,342394
3050,fabioviana-hotmart,4,0.00117,67619,19.74889,342394
3051,fainle,4,0.00117,67623,19.75005,342394
3052,farukranabappy89,4,0.00117,67627,19.75122,342394
3053,fblgit,4,0.00117,67631,19.75239,342394
3054,felix-dpg,4,0.00117,67635,19.75356,342394
3055,fernandrone,4,0.00117,67639,19.75473,342394
3056,ffuentes,4,0.00117,67643,19.75590,342394
3057,fgrelaud,4,0.00117,67647,19.75706,342394
3058,fidesachates,4,0.00117,67651,19.75823,342394
3059,fisabelle-lmi,4,0.00117,67655,19.75940,342394
3060,flaviomoringa,4,0.00117,67659,19.76057,342394
3061,flippy1345,4,0.00117,67663,19.76174,342394
3062,flo-mic,4,0.00117,67667,19.76290,342394
3063,florianpaulhoberg,4,0.00117,67671,19.76407,342394
3064,floyola,4,0.00117,67675,19.76524,342394
3065,flyaways,4,0.00117,67679,19.76641,342394
3066,Foge9627,4,0.00117,67683,19.76758,342394
3067,formichunter,4,0.00117,67687,19.76875,342394
3068,foxracle,4,0.00117,67691,19.76991,342394
3069,fubinzh,4,0.00117,67695,19.77108,342394
3070,Fudell,4,0.00117,67699,19.77225,342394
3071,gandhipr,4,0.00117,67703,19.77342,342394
3072,gbarceloPIB,4,0.00117,67707,19.77459,342394
3073,gcatanese,4,0.00117,67711,19.77576,342394
3074,Gerarddp,4,0.00117,67715,19.77692,342394
3075,gf457832386,4,0.00117,67719,19.77809,342394
3076,gibmat,4,0.00117,67723,19.77926,342394
3077,gioppoluca,4,0.00117,67727,19.78043,342394
3078,gjmzj,4,0.00117,67731,19.78160,342394
3079,glebiller,4,0.00117,67735,19.78276,342394
3080,gmintoco,4,0.00117,67739,19.78393,342394
3081,goafabric,4,0.00117,67743,19.78510,342394
3082,goj,4,0.00117,67747,19.78627,342394
3083,gpanagiotidis,4,0.00117,67751,19.78744,342394
3084,gravelg,4,0.00117,67755,19.78861,342394
3085,greenchapter,4,0.00117,67759,19.78977,342394
3086,gregx73,4,0.00117,67763,19.79094,342394
3087,griffint61,4,0.00117,67767,19.79211,342394
3088,Groostav,4,0.00117,67771,19.79328,342394
3089,gstramandinoli,4,0.00117,67775,19.79445,342394
3090,gtsystem,4,0.00117,67779,19.79562,342394
3091,GuilleAmutio,4,0.00117,67783,19.79678,342394
3092,hackerboy01,4,0.00117,67787,19.79795,342394
3093,hafkaM,4,0.00117,67791,19.79912,342394
3094,Halamix2,4,0.00117,67795,19.80029,342394
3095,Hampedude,4,0.00117,67799,19.80146,342394
3096,handlerww,4,0.00117,67803,19.80263,342394
3097,hansongChina,4,0.00117,67807,19.80379,342394
3098,haobiaosheng,4,0.00117,67811,19.80496,342394
3099,haouc,4,0.00117,67815,19.80613,342394
3100,HardBrainer,4,0.00117,67819,19.80730,342394
3101,hareesh-mandaloju,4,0.00117,67823,19.80847,342394
3102,harel-e,4,0.00117,67827,19.80963,342394
3103,HarryKroes,4,0.00117,67831,19.81080,342394
3104,harshasrimal,4,0.00117,67835,19.81197,342394
3105,harshmathurx,4,0.00117,67839,19.81314,342394
3106,harsimranmaan,4,0.00117,67843,19.81431,342394
3107,haskell42,4,0.00117,67847,19.81548,342394
3108,HaveFun83,4,0.00117,67851,19.81664,342394
3109,headconnect,4,0.00117,67855,19.81781,342394
3110,helletheone,4,0.00117,67859,19.81898,342394
3111,henrymori,4,0.00117,67863,19.82015,342394
3112,hezise,4,0.00117,67867,19.82132,342394
3113,hoejun,4,0.00117,67871,19.82249,342394
3114,hongaar,4,0.00117,67875,19.82365,342394
3115,hq6,4,0.00117,67879,19.82482,342394
3116,huan,4,0.00117,67883,19.82599,342394
3117,huangfangfeng,4,0.00117,67887,19.82716,342394
3118,huangzx3,4,0.00117,67891,19.82833,342394
3119,hughhm,4,0.00117,67895,19.82949,342394
3120,huynhsontung,4,0.00117,67899,19.83066,342394
3121,hypsrizzari,4,0.00117,67903,19.83183,342394
3122,iamatsundere,4,0.00117,67907,19.83300,342394
3123,ibumarskov,4,0.00117,67911,19.83417,342394
3124,ICEBERG98,4,0.00117,67915,19.83534,342394
3125,ichxxx,4,0.00117,67919,19.83650,342394
3126,ideepika,4,0.00117,67923,19.83767,342394
3127,Ikalinichev,4,0.00117,67927,19.83884,342394
3128,integral424,4,0.00117,67931,19.84001,342394
3129,ioanc,4,0.00117,67935,19.84118,342394
3130,iompo,4,0.00117,67939,19.84235,342394
3131,is,4,0.00117,67943,19.84351,342394
3132,isuftin,4,0.00117,67947,19.84468,342394
3133,iterativestudios,4,0.00117,67951,19.84585,342394
3134,itmisx,4,0.00117,67955,19.84702,342394
3135,ivanrnld,4,0.00117,67959,19.84819,342394
3136,JaideepGuntupalli,4,0.00117,67963,19.84935,342394
3137,JaimeHolland,4,0.00117,67967,19.85052,342394
3138,JamesSmith2,4,0.00117,67971,19.85169,342394
3139,jan-hudec,4,0.00117,67975,19.85286,342394
3140,janosmiko,4,0.00117,67979,19.85403,342394
3141,jasonpraful,4,0.00117,67983,19.85520,342394
3142,jcdelarosa7,4,0.00117,67987,19.85636,342394
3143,jceresini,4,0.00117,67991,19.85753,342394
3144,jcpittman144,4,0.00117,67995,19.85870,342394
3145,jcpuzic,4,0.00117,67999,19.85987,342394
3146,jdoiro3,4,0.00117,68003,19.86104,342394
3147,Jeaniowang,4,0.00117,68007,19.86221,342394
3148,jelel-fliss,4,0.00117,68011,19.86337,342394
3149,jemag,4,0.00117,68015,19.86454,342394
3150,JensenJian,4,0.00117,68019,19.86571,342394
3151,JesperTerkelsen,4,0.00117,68023,19.86688,342394
3152,jggc,4,0.00117,68027,19.86805,342394
3153,jiaxzeng,4,0.00117,68031,19.86921,342394
3154,Jimmy-Newtron,4,0.00117,68035,19.87038,342394
3155,jingliming,4,0.00117,68039,19.87155,342394
3156,jinjiang2009,4,0.00117,68043,19.87272,342394
3157,jinq0123,4,0.00117,68047,19.87389,342394
3158,JintaoXIAO,4,0.00117,68051,19.87506,342394
3159,jjsadek,4,0.00117,68055,19.87622,342394
3160,jjz921024,4,0.00117,68059,19.87739,342394
3161,jkonecny75,4,0.00117,68063,19.87856,342394
3162,jmeridth,4,0.00117,68067,19.87973,342394
3163,jmezach,4,0.00117,68071,19.88090,342394
3164,jmingtan,4,0.00117,68075,19.88207,342394
3165,jnarowski,4,0.00117,68079,19.88323,342394
3166,joeycumines,4,0.00117,68083,19.88440,342394
3167,joez,4,0.00117,68087,19.88557,342394
3168,johnson-prabu,4,0.00117,68091,19.88674,342394
3169,jonasmatthias,4,0.00117,68095,19.88791,342394
3170,jonassteinberg1,4,0.00117,68099,19.88908,342394
3171,jonbender-stripe,4,0.00117,68103,19.89024,342394
3172,josephlim75,4,0.00117,68107,19.89141,342394
3173,jplindquist,4,0.00117,68111,19.89258,342394
3174,JuHyung-Son,4,0.00117,68115,19.89375,342394
3175,julienlau,4,0.00117,68119,19.89492,342394
3176,justchris1,4,0.00117,68123,19.89608,342394
3177,juzhiyuan,4,0.00117,68127,19.89725,342394
3178,k3env,4,0.00117,68131,19.89842,342394
3179,kaihoffman,4,0.00117,68135,19.89959,342394
3180,kaiju,4,0.00117,68139,19.90076,342394
3181,kalantar,4,0.00117,68143,19.90193,342394
3182,kanrenibm,4,0.00117,68147,19.90309,342394
3183,kant777,4,0.00117,68151,19.90426,342394
3184,karma-git,4,0.00117,68155,19.90543,342394
3185,kartikzheng,4,0.00117,68159,19.90660,342394
3186,kbrs-miaha,4,0.00117,68163,19.90777,342394
3187,kcrawley-supernatural,4,0.00117,68167,19.90894,342394
3188,kennedy,4,0.00117,68171,19.91010,342394
3189,khoa-hatch,4,0.00117,68175,19.91127,342394
3190,Kielek,4,0.00117,68179,19.91244,342394
3191,kimcagayat,4,0.00117,68183,19.91361,342394
3192,kim-codefresh,4,0.00117,68187,19.91478,342394
3193,KingJ,4,0.00117,68191,19.91594,342394
3194,kirin-13,4,0.00117,68195,19.91711,342394
3195,kkhaidukov,4,0.00117,68199,19.91828,342394
3196,knack-roque,4,0.00117,68203,19.91945,342394
3197,knelasevero,4,0.00117,68207,19.92062,342394
3198,kobus-v-schoor,4,0.00117,68211,19.92179,342394
3199,komi1230,4,0.00117,68215,19.92295,342394
3200,konrad-kaminski,4,0.00117,68219,19.92412,342394
3201,kon-s,4,0.00117,68223,19.92529,342394
3202,korenlev,4,0.00117,68227,19.92646,342394
3203,krispenner,4,0.00117,68231,19.92763,342394
3204,kulmam92,4,0.00117,68235,19.92880,342394
3205,kumabuchi,4,0.00117,68239,19.92996,342394
3206,kumashun8,4,0.00117,68243,19.93113,342394
3207,kwri-avongluck,4,0.00117,68247,19.93230,342394
3208,kylev,4,0.00117,68251,19.93347,342394
3209,lakshikaparihar,4,0.00117,68255,19.93464,342394
3210,Lannnnh,4,0.00117,68259,19.93580,342394
3211,LarsBingBong,4,0.00117,68263,19.93697,342394
3212,Lebronbingcheng,4,0.00117,68267,19.93814,342394
3213,Lee-Jong-Woo,4,0.00117,68271,19.93931,342394
3214,Leem0sh,4,0.00117,68275,19.94048,342394
3215,leiw324,4,0.00117,68279,19.94165,342394
3216,lemeurherve,4,0.00117,68283,19.94281,342394
3217,leonanu,4,0.00117,68287,19.94398,342394
3218,LeoQuote,4,0.00117,68291,19.94515,342394
3219,LetLifeStop,4,0.00117,68295,19.94632,342394
3220,lewisdiamond,4,0.00117,68299,19.94749,342394
3221,LFsWang,4,0.00117,68303,19.94866,342394
3222,lhidalgo89,4,0.00117,68307,19.94982,342394
3223,lht,4,0.00117,68311,19.95099,342394
3224,lhzw,4,0.00117,68315,19.95216,342394
3225,lihanping2016,4,0.00117,68319,19.95333,342394
3226,liiri,4,0.00117,68323,19.95450,342394
3227,lijinfeng2011,4,0.00117,68327,19.95567,342394
3228,lining2020x,4,0.00117,68331,19.95683,342394
3229,linuxgcc,4,0.00117,68335,19.95800,342394
3230,Lionelpang,4,0.00117,68339,19.95917,342394
3231,lirui79,4,0.00117,68343,19.96034,342394
3232,littleplus,4,0.00117,68347,19.96151,342394
3233,Liu-JJ97,4,0.00117,68351,19.96267,342394
3234,liuzhilin12,4,0.00117,68355,19.96384,342394
3235,liyang516,4,0.00117,68359,19.96501,342394
3236,ljk,4,0.00117,68363,19.96618,342394
3237,ljmcgann,4,0.00117,68367,19.96735,342394
3238,lkruger,4,0.00117,68371,19.96852,342394
3239,llange,4,0.00117,68375,19.96968,342394
3240,locol-media-dev,4,0.00117,68379,19.97085,342394
3241,loeffel-io,4,0.00117,68383,19.97202,342394
3242,longXboy,4,0.00117,68387,19.97319,342394
3243,loopingz,4,0.00117,68391,19.97436,342394
3244,loveplxf,4,0.00117,68395,19.97553,342394
3245,lowkeyrd,4,0.00117,68399,19.97669,342394
3246,lrewega,4,0.00117,68403,19.97786,342394
3247,lstolcman,4,0.00117,68407,19.97903,342394
3248,lucasvieirazup,4,0.00117,68411,19.98020,342394
3249,LuChenjing,4,0.00117,68415,19.98137,342394
3250,luhring,4,0.00117,68419,19.98253,342394
3251,luisrojas17,4,0.00117,68423,19.98370,342394
3252,lukaszraczylo,4,0.00117,68427,19.98487,342394
3253,luyou86,4,0.00117,68431,19.98604,342394
3254,lvboxin1,4,0.00117,68435,19.98721,342394
3255,m4wh6k,4,0.00117,68439,19.98838,342394
3256,maciej-szlosarczyk,4,0.00117,68443,19.98954,342394
3257,Macrow,4,0.00117,68447,19.99071,342394
3258,madeline-k,4,0.00117,68451,19.99188,342394
3259,Madhan-SWE,4,0.00117,68455,19.99305,342394
3260,Madhur97,4,0.00117,68459,19.99422,342394
3261,madhureddy08,4,0.00117,68463,19.99539,342394
3262,MaitreDede,4,0.00117,68467,19.99655,342394
3263,majidghs,4,0.00117,68471,19.99772,342394
3264,majinghe,4,0.00117,68475,19.99889,342394
3265,majolo,4,0.00117,68479,20.00006,342394
3266,makeavish,4,0.00117,68483,20.00123,342394
3267,manabusakai,4,0.00117,68487,20.00239,342394
3268,mannharleen,4,0.00117,68491,20.00356,342394
3269,manuelbonk,4,0.00117,68495,20.00473,342394
3270,mariuslpop,4,0.00117,68499,20.00590,342394
3271,markusheinemann,4,0.00117,68503,20.00707,342394
3272,MartianGreed,4,0.00117,68507,20.00824,342394
3273,MartinDai,4,0.00117,68511,20.00940,342394
3274,MartinEmrich,4,0.00117,68515,20.01057,342394
3275,martin-marko,4,0.00117,68519,20.01174,342394
3276,Martin-Weiss,4,0.00117,68523,20.01291,342394
3277,marwatk,4,0.00117,68527,20.01408,342394
3278,maurosala,4,0.00117,68531,20.01525,342394
3279,maxwellxxx,4,0.00117,68535,20.01641,342394
3280,max-wittig,4,0.00117,68539,20.01758,342394
3281,mazak-ui,4,0.00117,68543,20.01875,342394
3282,mbfaust19,4,0.00117,68547,20.01992,342394
3283,mdaur,4,0.00117,68551,20.02109,342394
3284,medz,4,0.00117,68555,20.02226,342394
3285,mengmengy,4,0.00117,68559,20.02342,342394
3286,merryzhou,4,0.00117,68563,20.02459,342394
3287,meteorlxy,4,0.00117,68567,20.02576,342394
3288,mgebundy,4,0.00117,68571,20.02693,342394
3289,mgruener,4,0.00117,68575,20.02810,342394
3290,MHDante,4,0.00117,68579,20.02926,342394
3291,mhozhda-agiliway,4,0.00117,68583,20.03043,342394
3292,mhyeon-lee,4,0.00117,68587,20.03160,342394
3293,miadabrin,4,0.00117,68591,20.03277,342394
3294,miaucl,4,0.00117,68595,20.03394,342394
3295,michael12312,4,0.00117,68599,20.03511,342394
3296,MichaelDavisTSN,4,0.00117,68603,20.03627,342394
3297,michaelli321,4,0.00117,68607,20.03744,342394
3298,michaelraskansky,4,0.00117,68611,20.03861,342394
3299,mikalai-t,4,0.00117,68615,20.03978,342394
3300,mikegajda,4,0.00117,68619,20.04095,342394
3301,M-Indyukov,4,0.00117,68623,20.04212,342394
3302,mint570,4,0.00117,68627,20.04328,342394
3303,MinvenX,4,0.00117,68631,20.04445,342394
3304,miparnisari,4,0.00117,68635,20.04562,342394
3305,mjtansin,4,0.00117,68639,20.04679,342394
3306,mmckane,4,0.00117,68643,20.04796,342394
3307,mohan-nagandlla,4,0.00117,68647,20.04912,342394
3308,MordecaiMalignatus,4,0.00117,68651,20.05029,342394
3309,Mountaincnc,4,0.00117,68655,20.05146,342394
3310,mprimeaux,4,0.00117,68659,20.05263,342394
3311,mr-002,4,0.00117,68663,20.05380,342394
3312,mramakrishnaprasad,4,0.00117,68667,20.05497,342394
3313,MrNeocore,4,0.00117,68671,20.05613,342394
3314,mtenrero,4,0.00117,68675,20.05730,342394
3315,murilodag,4,0.00117,68679,20.05847,342394
3316,MustDie95,4,0.00117,68683,20.05964,342394
3317,mutomasa,4,0.00117,68687,20.06081,342394
3318,muyu-dev,4,0.00117,68691,20.06198,342394
3319,Myothas,4,0.00117,68695,20.06314,342394
3320,naor2013,4,0.00117,68699,20.06431,342394
3321,Narayan-dasari,4,0.00117,68703,20.06548,342394
3322,natcl,4,0.00117,68707,20.06665,342394
3323,Naughty-Monkey,4,0.00117,68711,20.06782,342394
3324,Navya-Andra,4,0.00117,68715,20.06898,342394
3325,nberkley,4,0.00117,68719,20.07015,342394
3326,ncsibra,4,0.00117,68723,20.07132,342394
3327,NearchPasipou,4,0.00117,68727,20.07249,342394
3328,NeckBeardPrince,4,0.00117,68731,20.07366,342394
3329,necrolyte2,4,0.00117,68735,20.07483,342394
3330,nekia,4,0.00117,68739,20.07599,342394
3331,nelson-wu,4,0.00117,68743,20.07716,342394
3332,netcmcc,4,0.00117,68747,20.07833,342394
3333,newedward,4,0.00117,68751,20.07950,342394
3334,nhatmicls,4,0.00117,68755,20.08067,342394
3335,nicksieger,4,0.00117,68759,20.08184,342394
3336,nicsmith,4,0.00117,68763,20.08300,342394
3337,nikhil-nomula,4,0.00117,68767,20.08417,342394
3338,Nimmsy,4,0.00117,68771,20.08534,342394
3339,ninlil,4,0.00117,68775,20.08651,342394
3340,nirandaperera,4,0.00117,68779,20.08768,342394
3341,Nishant27Saini,4,0.00117,68783,20.08885,342394
3342,nistei,4,0.00117,68787,20.09001,342394
3343,njuszj,4,0.00117,68791,20.09118,342394
3344,nmathew,4,0.00117,68795,20.09235,342394
3345,NMinhNguyen,4,0.00117,68799,20.09352,342394
3346,noelleleigh,4,0.00117,68803,20.09469,342394
3347,noly,4,0.00117,68807,20.09585,342394
3348,NorseGaud,4,0.00117,68811,20.09702,342394
3349,ntaylor1781,4,0.00117,68815,20.09819,342394
3350,Nuatu,4,0.00117,68819,20.09936,342394
3351,nuritzi,4,0.00117,68823,20.10053,342394
3352,ofiry-tm,4,0.00117,68827,20.10170,342394
3353,olahallvall,4,0.00117,68831,20.10286,342394
3354,omichels,4,0.00117,68835,20.10403,342394
3355,onelittlenightmusic,4,0.00117,68839,20.10520,342394
3356,OOPMan,4,0.00117,68843,20.10637,342394
3357,or-shachar,4,0.00117,68847,20.10754,342394
3358,oscar-dela,4,0.00117,68851,20.10871,342394
3359,ovesco,4,0.00117,68855,20.10987,342394
3360,ozairasim,4,0.00117,68859,20.11104,342394
3361,pabrahamusa,4,0.00117,68863,20.11221,342394
3362,paladin-devops,4,0.00117,68867,20.11338,342394
3363,ParameshP45,4,0.00117,68871,20.11455,342394
3364,PatrickHuetter,4,0.00117,68875,20.11571,342394
3365,Patrick-LuoYu,4,0.00117,68879,20.11688,342394
3366,paulgrav,4,0.00117,68883,20.11805,342394
3367,pavanfhw,4,0.00117,68887,20.11922,342394
3368,paynejacob,4,0.00117,68891,20.12039,342394
3369,pcfens,4,0.00117,68895,20.12156,342394
3370,PepijnK,4,0.00117,68899,20.12272,342394
3371,pere3,4,0.00117,68903,20.12389,342394
3372,peterclauterbach,4,0.00117,68907,20.12506,342394
3373,PeterGerrard,4,0.00117,68911,20.12623,342394
3374,pevans-lutron,4,0.00117,68915,20.12740,342394
3375,PheonixS,4,0.00117,68919,20.12857,342394
3376,PHLens,4,0.00117,68923,20.12973,342394
3377,Phoaster-wry,4,0.00117,68927,20.13090,342394
3378,pierreilki,4,0.00117,68931,20.13207,342394
3379,pipern,4,0.00117,68935,20.13324,342394
3380,pixelicous,4,0.00117,68939,20.13441,342394
3381,piyushsingariya,4,0.00117,68943,20.13557,342394
3382,pmeffre,4,0.00117,68947,20.13674,342394
3383,pokusak,4,0.00117,68951,20.13791,342394
3384,polivbr,4,0.00117,68955,20.13908,342394
3385,pontaoski,4,0.00117,68959,20.14025,342394
3386,portertech,4,0.00117,68963,20.14142,342394
3387,pparshin,4,0.00117,68967,20.14258,342394
3388,Prabakaranmkd,4,0.00117,68971,20.14375,342394
3389,pranayk01,4,0.00117,68975,20.14492,342394
3390,prateeknischal,4,0.00117,68979,20.14609,342394
3391,prathapdasari,4,0.00117,68983,20.14726,342394
3392,PratikDeoghare,4,0.00117,68987,20.14843,342394
3393,preflightsiren,4,0.00117,68991,20.14959,342394
3394,presidenten,4,0.00117,68995,20.15076,342394
3395,projectindex,4,0.00117,68999,20.15193,342394
3396,PSjoe,4,0.00117,69003,20.15310,342394
3397,QAQ-rookie,4,0.00117,69007,20.15427,342394
3398,qgtim,4,0.00117,69011,20.15543,342394
3399,qichengzx,4,0.00117,69015,20.15660,342394
3400,qusc,4,0.00117,69019,20.15777,342394
3401,radiantone,4,0.00117,69023,20.15894,342394
3402,rahulanand16nov,4,0.00117,69027,20.16011,342394
3403,rahuls2,4,0.00117,69031,20.16128,342394
3404,rakeshreddyrg09,4,0.00117,69035,20.16244,342394
3405,ralphgj,4,0.00117,69039,20.16361,342394
3406,raphael1021,4,0.00117,69043,20.16478,342394
3407,RayAsh37,4,0.00117,69047,20.16595,342394
3408,RayYe586,4,0.00117,69051,20.16712,342394
3409,rdeteix,4,0.00117,69055,20.16829,342394
3410,red8888,4,0.00117,69059,20.16945,342394
3411,reespozzi,4,0.00117,69063,20.17062,342394
3412,rensx5514,4,0.00117,69067,20.17179,342394
3413,rfyiamcool,4,0.00117,69071,20.17296,342394
3414,rh2048,4,0.00117,69075,20.17413,342394
3415,RichardoC,4,0.00117,69079,20.17530,342394
3416,rizzi37,4,0.00117,69083,20.17646,342394
3417,robin1900,4,0.00117,69087,20.17763,342394
3418,robinYin996,4,0.00117,69091,20.17880,342394
3419,rocLv,4,0.00117,69095,20.17997,342394
3420,RocMarshal,4,0.00117,69099,20.18114,342394
3421,rodnymolina,4,0.00117,69103,20.18230,342394
3422,rpelissi,4,0.00117,69107,20.18347,342394
3423,rptaylor,4,0.00117,69111,20.18464,342394
3424,rradillen,4,0.00117,69115,20.18581,342394
3425,rsotogar,4,0.00117,69119,20.18698,342394
3426,rstular,4,0.00117,69123,20.18815,342394
3427,rthakur-est,4,0.00117,69127,20.18931,342394
3428,runningcode,4,0.00117,69131,20.19048,342394
3429,rushirg,4,0.00117,69135,20.19165,342394
3430,rustamsmax,4,0.00117,69139,20.19282,342394
3431,Rutam21,4,0.00117,69143,20.19399,342394
3432,rv-ddeloff,4,0.00117,69147,20.19516,342394
3433,ryanmrodriguez,4,0.00117,69151,20.19632,342394
3434,sadityalal,4,0.00117,69155,20.19749,342394
3435,sairameshv,4,0.00117,69159,20.19866,342394
3436,SalimiHabib,4,0.00117,69163,20.19983,342394
3437,salvoravida,4,0.00117,69167,20.20100,342394
3438,samidbb,4,0.00117,69171,20.20216,342394
3439,samuelhnrq,4,0.00117,69175,20.20333,342394
3440,satr,4,0.00117,69179,20.20450,342394
3441,sbathgate,4,0.00117,69183,20.20567,342394
3442,sberkovich,4,0.00117,69187,20.20684,342394
3443,sbochoa,4,0.00117,69191,20.20801,342394
3444,scila1996,4,0.00117,69195,20.20917,342394
3445,scorpius81,4,0.00117,69199,20.21034,342394
3446,scottlaird,4,0.00117,69203,20.21151,342394
3447,sdghchj,4,0.00117,69207,20.21268,342394
3448,SeanTse,4,0.00117,69211,20.21385,342394
3449,seb-835,4,0.00117,69215,20.21502,342394
3450,sebastianhutter,4,0.00117,69219,20.21618,342394
3451,Sebor,4,0.00117,69223,20.21735,342394
3452,sehz,4,0.00117,69227,20.21852,342394
3453,seredot,4,0.00117,69231,20.21969,342394
3454,sethp,4,0.00117,69235,20.22086,342394
3455,setood,4,0.00117,69239,20.22202,342394
3456,sfeng1996,4,0.00117,69243,20.22319,342394
3457,Shabahang,4,0.00117,69247,20.22436,342394
3458,shamwow,4,0.00117,69251,20.22553,342394
3459,shankarramesh16,4,0.00117,69255,20.22670,342394
3460,Shanmugapriya03,4,0.00117,69259,20.22787,342394
3461,shapirus,4,0.00117,69263,20.22903,342394
3462,sha-rath,4,0.00117,69267,20.23020,342394
3463,sharninder,4,0.00117,69271,20.23137,342394
3464,shaypi,4,0.00117,69275,20.23254,342394
3465,Shivkumar13,4,0.00117,69279,20.23371,342394
3466,shivrajjadhav733,4,0.00117,69283,20.23488,342394
3467,shiw13,4,0.00117,69287,20.23604,342394
3468,shoukathmd,4,0.00117,69291,20.23721,342394
3469,shybbko,4,0.00117,69295,20.23838,342394
3470,SiarheiBortnik,4,0.00117,69299,20.23955,342394
3471,sid8489,4,0.00117,69303,20.24072,342394
3472,sigurdfalk,4,0.00117,69307,20.24189,342394
3473,sikanderiqbal,4,0.00117,69311,20.24305,342394
3474,simbou2000,4,0.00117,69315,20.24422,342394
3475,sitilge,4,0.00117,69319,20.24539,342394
3476,sjentzsch,4,0.00117,69323,20.24656,342394
3477,sjqnn,4,0.00117,69327,20.24773,342394
3478,SlyngDK,4,0.00117,69331,20.24889,342394
3479,smallAttr,4,0.00117,69335,20.25006,342394
3480,smarunich,4,0.00117,69339,20.25123,342394
3481,smlx,4,0.00117,69343,20.25240,342394
3482,Sniper91,4,0.00117,69347,20.25357,342394
3483,sodaRyCN,4,0.00117,69351,20.25474,342394
3484,SoftTissues,4,0.00117,69355,20.25590,342394
3485,soider,4,0.00117,69359,20.25707,342394
3486,spider-network,4,0.00117,69363,20.25824,342394
3487,Spoonbender,4,0.00117,69367,20.25941,342394
3488,sqerison,4,0.00117,69371,20.26058,342394
3489,Srikrishnabh,4,0.00117,69375,20.26175,342394
3490,ssanders1449,4,0.00117,69379,20.26291,342394
3491,St4NNi,4,0.00117,69383,20.26408,342394
3492,sTb1337,4,0.00117,69387,20.26525,342394
3493,stdll00,4,0.00117,69391,20.26642,342394
3494,StefanYohansson,4,0.00117,69395,20.26759,342394
3495,stmaute,4,0.00117,69399,20.26875,342394
3496,stoetti,4,0.00117,69403,20.26992,342394
3497,stoupance,4,0.00117,69407,20.27109,342394
3498,strideynet,4,0.00117,69411,20.27226,342394
3499,stumueller,4,0.00117,69415,20.27343,342394
3500,sturlath,4,0.00117,69419,20.27460,342394
3501,suneclausen,4,0.00117,69423,20.27576,342394
3502,sunface,4,0.00117,69427,20.27693,342394
3503,sunmiao0301,4,0.00117,69431,20.27810,342394
3504,sunmiaoa,4,0.00117,69435,20.27927,342394
3505,sureshballa,4,0.00117,69439,20.28044,342394
3506,sureshg,4,0.00117,69443,20.28161,342394
3507,swati-delphix,4,0.00117,69447,20.28277,342394
3508,swestner-loyalty,4,0.00117,69451,20.28394,342394
3509,Syuparn,4,0.00117,69455,20.28511,342394
3510,tabnul,4,0.00117,69459,20.28628,342394
3511,Taiwrash,4,0.00117,69463,20.28745,342394
3512,Tal-or,4,0.00117,69467,20.28861,342394
3513,tamilaban,4,0.00117,69471,20.28978,342394
3514,tasos71,4,0.00117,69475,20.29095,342394
3515,tauu,4,0.00117,69479,20.29212,342394
3516,tbolon,4,0.00117,69483,20.29329,342394
3517,tech4242,4,0.00117,69487,20.29446,342394
3518,teshsharma,4,0.00117,69491,20.29562,342394
3519,tete17,4,0.00117,69495,20.29679,342394
3520,tgquan67,4,0.00117,69499,20.29796,342394
3521,ThatDeveloper,4,0.00117,69503,20.29913,342394
3522,thekuwayama,4,0.00117,69507,20.30030,342394
3523,thepeterstone,4,0.00117,69511,20.30147,342394
3524,TheXs,4,0.00117,69515,20.30263,342394
3525,thisisbillall,4,0.00117,69519,20.30380,342394
3526,Thiyagu2009,4,0.00117,69523,20.30497,342394
3527,thrawny,4,0.00117,69527,20.30614,342394
3528,timofurrer,4,0.00117,69531,20.30731,342394
3529,tiwarisanjay,4,0.00117,69535,20.30848,342394
3530,tmeckel,4,0.00117,69539,20.30964,342394
3531,TobiasDeBruijn,4,0.00117,69543,20.31081,342394
3532,Toenail81,4,0.00117,69547,20.31198,342394
3533,tomekit,4,0.00117,69551,20.31315,342394
3534,tonivj5,4,0.00117,69555,20.31432,342394
3535,tonybaloney,4,0.00117,69559,20.31548,342394
3536,tonycoder0525,4,0.00117,69563,20.31665,342394
3537,totycro,4,0.00117,69567,20.31782,342394
3538,TqrHsn,4,0.00117,69571,20.31899,342394
3539,travisspencer,4,0.00117,69575,20.32016,342394
3540,tshaiman,4,0.00117,69579,20.32133,342394
3541,tsndqst,4,0.00117,69583,20.32249,342394
3542,tuesdaycodes,4,0.00117,69587,20.32366,342394
3543,twa16,4,0.00117,69591,20.32483,342394
3544,ubergesundheit,4,0.00117,69595,20.32600,342394
3545,ulikl,4,0.00117,69599,20.32717,342394
3546,ultrastdn,4,0.00117,69603,20.32834,342394
3547,umairadeeb,4,0.00117,69607,20.32950,342394
3548,umapriyadarsi,4,0.00117,69611,20.33067,342394
3549,unixlab,4,0.00117,69615,20.33184,342394
3550,venkataphaniv,4,0.00117,69619,20.33301,342394
3551,verysonglaa,4,0.00117,69623,20.33418,342394
3552,vfrans,4,0.00117,69627,20.33534,342394
3553,vilkaspilkas,4,0.00117,69631,20.33651,342394
3554,vinisdl,4,0.00117,69635,20.33768,342394
3555,virtualdogbert,4,0.00117,69639,20.33885,342394
3556,visualzhou,4,0.00117,69643,20.34002,342394
3557,vivekpatani,4,0.00117,69647,20.34119,342394
3558,vracademy2999,4,0.00117,69651,20.34235,342394
3559,vsychov,4,0.00117,69655,20.34352,342394
3560,VuongAnhh,4,0.00117,69659,20.34469,342394
3561,vyhid,4,0.00117,69663,20.34586,342394
3562,WalkerWang731,4,0.00117,69667,20.34703,342394
3563,WANGPILANG,4,0.00117,69671,20.34820,342394
3564,wangxiaoq,4,0.00117,69675,20.34936,342394
3565,wangyuan0916,4,0.00117,69679,20.35053,342394
3566,waynerv,4,0.00117,69683,20.35170,342394
3567,waywardmonkeys,4,0.00117,69687,20.35287,342394
3568,Wenliang-CHEN,4,0.00117,69691,20.35404,342394
3569,WestEnlarged,4,0.00117,69695,20.35520,342394
3570,William-Mou,4,0.00117,69699,20.35637,342394
3571,WoodpeckerBaby,4,0.00117,69703,20.35754,342394
3572,woyaodeyangguang,4,0.00117,69707,20.35871,342394
3573,wubn2000,4,0.00117,69711,20.35988,342394
3574,wu-hui,4,0.00117,69715,20.36105,342394
3575,wuxin66,4,0.00117,69719,20.36221,342394
3576,wvolkov,4,0.00117,69723,20.36338,342394
3577,wyckster,4,0.00117,69727,20.36455,342394
3578,xiujuanx,4,0.00117,69731,20.36572,342394
3579,xj524598,4,0.00117,69735,20.36689,342394
3580,xometry-johnny,4,0.00117,69739,20.36806,342394
3581,xuanyingcool,4,0.00117,69743,20.36922,342394
3582,xwang0818,4,0.00117,69747,20.37039,342394
3583,y0zg,4,0.00117,69751,20.37156,342394
3584,yang-le,4,0.00117,69755,20.37273,342394
3585,yangmarcyang,4,0.00117,69759,20.37390,342394
3586,yanhongchang,4,0.00117,69763,20.37506,342394
3587,YannickLecroart21,4,0.00117,69767,20.37623,342394
3588,yashmehrotra,4,0.00117,69771,20.37740,342394
3589,Yayotron,4,0.00117,69775,20.37857,342394
3590,YchauWang,4,0.00117,69779,20.37974,342394
3591,ychumpov,4,0.00117,69783,20.38091,342394
3592,yevhenvolchenko,4,0.00117,69787,20.38207,342394
3593,yildirima,4,0.00117,69791,20.38324,342394
3594,yingqunpku,4,0.00117,69795,20.38441,342394
3595,yingziisme,4,0.00117,69799,20.38558,342394
3596,yitingdc,4,0.00117,69803,20.38675,342394
3597,YokeCheng,4,0.00117,69807,20.38792,342394
3598,ypicard,4,0.00117,69811,20.38908,342394
3599,yuanlin-yoyo-worker,4,0.00117,69815,20.39025,342394
3600,yuchunyun,4,0.00117,69819,20.39142,342394
3601,yylt,4,0.00117,69823,20.39259,342394
3602,z0mb1ek,4,0.00117,69827,20.39376,342394
3603,zcerhub,4,0.00117,69831,20.39493,342394
3604,zhanbinHo,4,0.00117,69835,20.39609,342394
3605,zhaomoy,4,0.00117,69839,20.39726,342394
3606,zhengxianlin,4,0.00117,69843,20.39843,342394
3607,zhiweiv,4,0.00117,69847,20.39960,342394
3608,zhiyxu,4,0.00117,69851,20.40077,342394
3609,zmx,4,0.00117,69855,20.40193,342394
3610,zziawan,4,0.00117,69859,20.40310,342394
3611,zzxgzgz,4,0.00117,69863,20.40427,342394
3612,zzy987,4,0.00117,69867,20.40544,342394
3613,0123hoang,3,0.00088,69870,20.40632,342394
3614,0Delta,3,0.00088,69873,20.40719,342394
3615,0x022b,3,0.00088,69876,20.40807,342394
3616,0xE282B0,3,0.00088,69879,20.40894,342394
3617,0xVox,3,0.00088,69882,20.40982,342394
3618,1285yvonne,3,0.00088,69885,20.41070,342394
3619,13013SwagR,3,0.00088,69888,20.41157,342394
3620,1Const1,3,0.00088,69891,20.41245,342394
3621,1stewart,3,0.00088,69894,20.41332,342394
3622,212850a,3,0.00088,69897,20.41420,342394
3623,2fst4u,3,0.00088,69900,20.41508,342394
3624,3ch01c,3,0.00088,69903,20.41595,342394
3625,56KBs,3,0.00088,69906,20.41683,342394
3626,647-coder,3,0.00088,69909,20.41771,342394
3627,a2ush,3,0.00088,69912,20.41858,342394
3628,aantn,3,0.00088,69915,20.41946,342394
3629,Aaron3S,3,0.00088,69918,20.42033,342394
3630,Aartsie,3,0.00088,69921,20.42121,342394
3631,aasserzo,3,0.00088,69924,20.42209,342394
3632,abagnacani,3,0.00088,69927,20.42296,342394
3633,abdelrazekrizk,3,0.00088,69930,20.42384,342394
3634,Abdul1929,3,0.00088,69933,20.42472,342394
3635,abogdanov37,3,0.00088,69936,20.42559,342394
3636,abstractalchemist,3,0.00088,69939,20.42647,342394
3637,acartcat,3,0.00088,69942,20.42734,342394
3638,acastong,3,0.00088,69945,20.42822,342394
3639,adabuleanu,3,0.00088,69948,20.42910,342394
3640,adamcstephens,3,0.00088,69951,20.42997,342394
3641,Adarshkumar14,3,0.00088,69954,20.43085,342394
3642,addersuk,3,0.00088,69957,20.43172,342394
3643,adetunjiakintundeakinde,3,0.00088,69960,20.43260,342394
3644,adgerrits,3,0.00088,69963,20.43348,342394
3645,adityaborgaonkar,3,0.00088,69966,20.43435,342394
3646,Adphi,3,0.00088,69969,20.43523,342394
3647,adq,3,0.00088,69972,20.43611,342394
3648,adrdc,3,0.00088,69975,20.43698,342394
3649,adrianmiron,3,0.00088,69978,20.43786,342394
3650,adzshaf,3,0.00088,69981,20.43873,342394
3651,afshin1394,3,0.00088,69984,20.43961,342394
3652,agates4,3,0.00088,69987,20.44049,342394
3653,ahayworth,3,0.00088,69990,20.44136,342394
3654,Ailsa-Wu,3,0.00088,69993,20.44224,342394
3655,airkewld,3,0.00088,69996,20.44312,342394
3656,aiyijing,3,0.00088,69999,20.44399,342394
3657,ajacques,3,0.00088,70002,20.44487,342394
3658,ajdecon,3,0.00088,70005,20.44574,342394
3659,ajski1701,3,0.00088,70008,20.44662,342394
3660,ajtomato,3,0.00088,70011,20.44750,342394
3661,akashsinghal,3,0.00088,70014,20.44837,342394
3662,alanjjenkins,3,0.00088,70017,20.44925,342394
3663,al-awstest,3,0.00088,70020,20.45012,342394
3664,alberk8,3,0.00088,70023,20.45100,342394
3665,Alberto97,3,0.00088,70026,20.45188,342394
3666,Aldjinn,3,0.00088,70029,20.45275,342394
3667,aledegano,3,0.00088,70032,20.45363,342394
3668,alexadmin,3,0.00088,70035,20.45451,342394
3669,alexcern,3,0.00088,70038,20.45538,342394
3670,alexsimon1,3,0.00088,70041,20.45626,342394
3671,AliDotS,3,0.00088,70044,20.45713,342394
3672,AlissonRS,3,0.00088,70047,20.45801,342394
3673,alllexandrz,3,0.00088,70050,20.45889,342394
3674,almas33,3,0.00088,70053,20.45976,342394
3675,almostchristian,3,0.00088,70056,20.46064,342394
3676,alonana,3,0.00088,70059,20.46152,342394
3677,alxn,3,0.00088,70062,20.46239,342394
3678,amckinney,3,0.00088,70065,20.46327,342394
3679,aminalaee,3,0.00088,70068,20.46414,342394
3680,amitkatyal,3,0.00088,70071,20.46502,342394
3681,ammarzuberi,3,0.00088,70074,20.46590,342394
3682,ammmze,3,0.00088,70077,20.46677,342394
3683,amoravek,3,0.00088,70080,20.46765,342394
3684,am-sebastiankunze,3,0.00088,70083,20.46852,342394
3685,a-muk,3,0.00088,70086,20.46940,342394
3686,amustaque97,3,0.00088,70089,20.47028,342394
3687,Anakin100100,3,0.00088,70092,20.47115,342394
3688,anandg112,3,0.00088,70095,20.47203,342394
3689,andrewd-sysdig,3,0.00088,70098,20.47291,342394
3690,andyfleming-shopify,3,0.00088,70101,20.47378,342394
3691,anemyte,3,0.00088,70104,20.47466,342394
3692,ANKAMBLE,3,0.00088,70107,20.47553,342394
3693,anongitmous,3,0.00088,70110,20.47641,342394
3694,anpatellll,3,0.00088,70113,20.47729,342394
3695,ansjsun,3,0.00088,70116,20.47816,342394
3696,antempus,3,0.00088,70119,20.47904,342394
3697,anvo1115,3,0.00088,70122,20.47991,342394
3698,apham0001,3,0.00088,70125,20.48079,342394
3699,aplanas,3,0.00088,70128,20.48167,342394
3700,apmasell,3,0.00088,70131,20.48254,342394
3701,Apollorion,3,0.00088,70134,20.48342,342394
3702,aquiladayc,3,0.00088,70137,20.48430,342394
3703,arcanjoaq,3,0.00088,70140,20.48517,342394
3704,architjugran,3,0.00088,70143,20.48605,342394
3705,arnarg,3,0.00088,70146,20.48692,342394
3706,Arnatious,3,0.00088,70149,20.48780,342394
3707,Arnavion,3,0.00088,70152,20.48868,342394
3708,ArshiAAkhavan,3,0.00088,70155,20.48955,342394
3709,arthurh4,3,0.00088,70158,20.49043,342394
3710,asadali,3,0.00088,70161,20.49131,342394
3711,asalbers,3,0.00088,70164,20.49218,342394
3712,ashaker-cig,3,0.00088,70167,20.49306,342394
3713,ashNext,3,0.00088,70170,20.49393,342394
3714,Ashtonian,3,0.00088,70173,20.49481,342394
3715,Ashwin901,3,0.00088,70176,20.49569,342394
3716,AshwiniGhanwat,3,0.00088,70179,20.49656,342394
3717,assaf-grth,3,0.00088,70182,20.49744,342394
3718,asselin,3,0.00088,70185,20.49831,342394
3719,atercattus,3,0.00088,70188,20.49919,342394
3720,atharvagunjkar,3,0.00088,70191,20.50007,342394
3721,aurel333,3,0.00088,70194,20.50094,342394
3722,aviralharsh,3,0.00088,70197,20.50182,342394
3723,avorima,3,0.00088,70200,20.50270,342394
3724,ax-jgriffiths,3,0.00088,70203,20.50357,342394
3725,bachmanity1,3,0.00088,70206,20.50445,342394
3726,baikai,3,0.00088,70209,20.50532,342394
3727,baklpc,3,0.00088,70212,20.50620,342394
3728,baldey-nz,3,0.00088,70215,20.50708,342394
3729,baloian,3,0.00088,70218,20.50795,342394
3730,Banck,3,0.00088,70221,20.50883,342394
3731,baramundi-tweyer,3,0.00088,70224,20.50971,342394
3732,bartlomiejdanek,3,0.00088,70227,20.51058,342394
3733,baseely,3,0.00088,70230,20.51146,342394
3734,baturozgur,3,0.00088,70233,20.51233,342394
3735,bautagebuch,3,0.00088,70236,20.51321,342394
3736,ba-work,3,0.00088,70239,20.51409,342394
3737,baznikin,3,0.00088,70242,20.51496,342394
3738,bazuchan,3,0.00088,70245,20.51584,342394
3739,bbarnes52,3,0.00088,70248,20.51671,342394
3740,bbensky,3,0.00088,70251,20.51759,342394
3741,bd-br,3,0.00088,70254,20.51847,342394
3742,bennbollay,3,0.00088,70257,20.51934,342394
3743,bennycornelissen,3,0.00088,70260,20.52022,342394
3744,benoitg31,3,0.00088,70263,20.52110,342394
3745,benruland,3,0.00088,70266,20.52197,342394
3746,bforbis,3,0.00088,70269,20.52285,342394
3747,bfoxstudio,3,0.00088,70272,20.52372,342394
3748,bigfacewo,3,0.00088,70275,20.52460,342394
3749,bin3377,3,0.00088,70278,20.52548,342394
3750,bipinkm,3,0.00088,70281,20.52635,342394
3751,bitbrain,3,0.00088,70284,20.52723,342394
3752,bizrad,3,0.00088,70287,20.52811,342394
3753,bizy01,3,0.00088,70290,20.52898,342394
3754,bkabrda,3,0.00088,70293,20.52986,342394
3755,BKnights,3,0.00088,70296,20.53073,342394
3756,blottn,3,0.00088,70299,20.53161,342394
3757,Blue-Hope,3,0.00088,70302,20.53249,342394
3758,blueskyjunkie,3,0.00088,70305,20.53336,342394
3759,bmv126,3,0.00088,70308,20.53424,342394
3760,bnevis-i,3,0.00088,70311,20.53511,342394
3761,bob-rohan,3,0.00088,70314,20.53599,342394
3762,bodilb,3,0.00088,70317,20.53687,342394
3763,bomkamp,3,0.00088,70320,20.53774,342394
3764,boniek83,3,0.00088,70323,20.53862,342394
3765,Bonuspunkt,3,0.00088,70326,20.53950,342394
3766,bopohaa,3,0.00088,70329,20.54037,342394
3767,bostikforever,3,0.00088,70332,20.54125,342394
3768,boydgreenfield,3,0.00088,70335,20.54212,342394
3769,bpschmitt,3,0.00088,70338,20.54300,342394
3770,brainfair,3,0.00088,70341,20.54388,342394
3771,bram-abe,3,0.00088,70344,20.54475,342394
3772,braye,3,0.00088,70347,20.54563,342394
3773,breygonsnow,3,0.00088,70350,20.54650,342394
3774,briandenicola,3,0.00088,70353,20.54738,342394
3775,brokoli18,3,0.00088,70356,20.54826,342394
3776,brunnels,3,0.00088,70359,20.54913,342394
3777,bruth,3,0.00088,70362,20.55001,342394
3778,bryanasdev000,3,0.00088,70365,20.55089,342394
3779,bsloeserwij,3,0.00088,70368,20.55176,342394
3780,BudhirajaMadhav,3,0.00088,70371,20.55264,342394
3781,BulkBeing,3,0.00088,70374,20.55351,342394
3782,buraksekili,3,0.00088,70377,20.55439,342394
3783,BurhanuddinMerchant,3,0.00088,70380,20.55527,342394
3784,bwncp,3,0.00088,70383,20.55614,342394
3785,caesuric,3,0.00088,70386,20.55702,342394
3786,calvinpark,3,0.00088,70389,20.55790,342394
3787,calvinShan,3,0.00088,70392,20.55877,342394
3788,camaeel,3,0.00088,70395,20.55965,342394
3789,campos-ddc,3,0.00088,70398,20.56052,342394
3790,cape-man,3,0.00088,70401,20.56140,342394
3791,CaptAintHere,3,0.00088,70404,20.56228,342394
3792,cardil,3,0.00088,70407,20.56315,342394
3793,carlocab,3,0.00088,70410,20.56403,342394
3794,carlosbustillordguez,3,0.00088,70413,20.56490,342394
3795,CarlosDomingues,3,0.00088,70416,20.56578,342394
3796,carlye,3,0.00088,70419,20.56666,342394
3797,carolize,3,0.00088,70422,20.56753,342394
3798,Carus11,3,0.00088,70425,20.56841,342394
3799,CatalinCnif,3,0.00088,70428,20.56929,342394
3800,catardif,3,0.00088,70431,20.57016,342394
3801,catblade,3,0.00088,70434,20.57104,342394
3802,cbeams,3,0.00088,70437,20.57191,342394
3803,cbuto,3,0.00088,70440,20.57279,342394
3804,ccureau,3,0.00088,70443,20.57367,342394
3805,cdhunt,3,0.00088,70446,20.57454,342394
3806,cdtomkins,3,0.00088,70449,20.57542,342394
3807,cedarkuo,3,0.00088,70452,20.57630,342394
3808,ceyhunn,3,0.00088,70455,20.57717,342394
3809,cfloressuazo,3,0.00088,70458,20.57805,342394
3810,chaewonkk,3,0.00088,70461,20.57892,342394
3811,ChamMach,3,0.00088,70464,20.57980,342394
3812,chanakaudaya,3,0.00088,70467,20.58068,342394
3813,CharlesL0924,3,0.00088,70470,20.58155,342394
3814,Charliekenney23,3,0.00088,70473,20.58243,342394
3815,ChaseHuangxu,3,0.00088,70476,20.58330,342394
3816,chedim,3,0.00088,70479,20.58418,342394
3817,cheeseprocedure,3,0.00088,70482,20.58506,342394
3818,chenk008,3,0.00088,70485,20.58593,342394
3819,chenpfeisoo,3,0.00088,70488,20.58681,342394
3820,chenyanshan,3,0.00088,70491,20.58769,342394
3821,ChethanUK,3,0.00088,70494,20.58856,342394
3822,chf007,3,0.00088,70497,20.58944,342394
3823,chijinxina,3,0.00088,70500,20.59031,342394
3824,Chillitzel,3,0.00088,70503,20.59119,342394
3825,chimurai,3,0.00088,70506,20.59207,342394
3826,chintan-episource,3,0.00088,70509,20.59294,342394
3827,Choppra,3,0.00088,70512,20.59382,342394
3828,chris-echoz,3,0.00088,70515,20.59470,342394
3829,ChrisJBurns,3,0.00088,70518,20.59557,342394
3830,Chup4Chups,3,0.00088,70521,20.59645,342394
3831,cijohnson,3,0.00088,70524,20.59732,342394
3832,cite,3,0.00088,70527,20.59820,342394
3833,cjhallman,3,0.00088,70530,20.59908,342394
3834,cjmaliao,3,0.00088,70533,20.59995,342394
3835,cjmcgraw,3,0.00088,70536,20.60083,342394
3836,clive-jevons,3,0.00088,70539,20.60170,342394
3837,Clivern,3,0.00088,70542,20.60258,342394
3838,clwluvw,3,0.00088,70545,20.60346,342394
3839,cmschuetz,3,0.00088,70548,20.60433,342394
3840,cocaccola,3,0.00088,70551,20.60521,342394
3841,Cogax,3,0.00088,70554,20.60609,342394
3842,colinhusanmao,3,0.00088,70557,20.60696,342394
3843,computerphilosopher,3,0.00088,70560,20.60784,342394
3844,CONeal,3,0.00088,70563,20.60871,342394
3845,connatix-cradulescu,3,0.00088,70566,20.60959,342394
3846,containerpope,3,0.00088,70569,20.61047,342394
3847,corneliarauch,3,0.00088,70572,20.61134,342394
3848,coronabytes,3,0.00088,70575,20.61222,342394
3849,Cosrider,3,0.00088,70578,20.61309,342394
3850,counter2015,3,0.00088,70581,20.61397,342394
3851,cppwfs,3,0.00088,70584,20.61485,342394
3852,cptkng23,3,0.00088,70587,20.61572,342394
3853,Creatone,3,0.00088,70590,20.61660,342394
3854,CristianJena,3,0.00088,70593,20.61748,342394
3855,crliu3227,3,0.00088,70596,20.61835,342394
3856,ctheune,3,0.00088,70599,20.61923,342394
3857,ctrlsam,3,0.00088,70602,20.62010,342394
3858,cwstrommer,3,0.00088,70605,20.62098,342394
3859,cwyj,3,0.00088,70608,20.62186,342394
3860,Cybermaxke,3,0.00088,70611,20.62273,342394
3861,D1abloRUS,3,0.00088,70614,20.62361,342394
3862,D1StrX,3,0.00088,70617,20.62449,342394
3863,d3p4rt,3,0.00088,70620,20.62536,342394
3864,d3vpasha,3,0.00088,70623,20.62624,342394
3865,DaemonWalker,3,0.00088,70626,20.62711,342394
3866,daiyinong,3,0.00088,70629,20.62799,342394
3867,dalia-frank,3,0.00088,70632,20.62887,342394
3868,DameonSmith,3,0.00088,70635,20.62974,342394
3869,danBamikiya,3,0.00088,70638,20.63062,342394
3870,dancaugherty,3,0.00088,70641,20.63149,342394
3871,dangarthwaite,3,0.00088,70644,20.63237,342394
3872,danhcole,3,0.00088,70647,20.63325,342394
3873,danielbecroft,3,0.00088,70650,20.63412,342394
3874,danielcweber,3,0.00088,70653,20.63500,342394
3875,daper,3,0.00088,70656,20.63588,342394
3876,Darkclainer,3,0.00088,70659,20.63675,342394
3877,Daryjusz,3,0.00088,70662,20.63763,342394
3878,dashanji,3,0.00088,70665,20.63850,342394
3879,databasedav,3,0.00088,70668,20.63938,342394
3880,davazp,3,0.00088,70671,20.64026,342394
3881,davelajoie,3,0.00088,70674,20.64113,342394
3882,daveman1010221,3,0.00088,70677,20.64201,342394
3883,davidgamero,3,0.00088,70680,20.64289,342394
3884,davidmpaz,3,0.00088,70683,20.64376,342394
3885,David-N-Perkins,3,0.00088,70686,20.64464,342394
3886,davinchia,3,0.00088,70689,20.64551,342394
3887,dberardo-com,3,0.00088,70692,20.64639,342394
3888,dberecz,3,0.00088,70695,20.64727,342394
3889,dbrownecu,3,0.00088,70698,20.64814,342394
3890,dch,3,0.00088,70701,20.64902,342394
3891,ddevaal,3,0.00088,70704,20.64989,342394
3892,debuggerboy,3,0.00088,70707,20.65077,342394
3893,deepakmega,3,0.00088,70710,20.65165,342394
3894,DeepspaceFreelancer,3,0.00088,70713,20.65252,342394
3895,degeens,3,0.00088,70716,20.65340,342394
3896,Denissa89,3,0.00088,70719,20.65428,342394
3897,derdanne,3,0.00088,70722,20.65515,342394
3898,derekkraan,3,0.00088,70725,20.65603,342394
3899,derust,3,0.00088,70728,20.65690,342394
3900,Dever4eg,3,0.00088,70731,20.65778,342394
3901,devholic77,3,0.00088,70734,20.65866,342394
3902,devopsguru339,3,0.00088,70737,20.65953,342394
3903,dginhoux,3,0.00088,70740,20.66041,342394
3904,dhaus67,3,0.00088,70743,20.66128,342394
3905,dheras-lmes,3,0.00088,70746,20.66216,342394
3906,dhs-rec,3,0.00088,70749,20.66304,342394
3907,dibosh,3,0.00088,70752,20.66391,342394
3908,dillenmeister,3,0.00088,70755,20.66479,342394
3909,dirien,3,0.00088,70758,20.66567,342394
3910,dj-wasabi,3,0.00088,70761,20.66654,342394
3911,dkkb,3,0.00088,70764,20.66742,342394
3912,dm4,3,0.00088,70767,20.66829,342394
3913,dmaljovec,3,0.00088,70770,20.66917,342394
3914,dnaprawa,3,0.00088,70773,20.67005,342394
3915,dnxorjs1,3,0.00088,70776,20.67092,342394
3916,doaaperf,3,0.00088,70779,20.67180,342394
3917,dolisss,3,0.00088,70782,20.67268,342394
3918,dominch,3,0.00088,70785,20.67355,342394
3919,doniacld,3,0.00088,70788,20.67443,342394
3920,dopeter,3,0.00088,70791,20.67530,342394
3921,dorisd0102,3,0.00088,70794,20.67618,342394
3922,dorroddorrod,3,0.00088,70797,20.67706,342394
3923,doughgle,3,0.00088,70800,20.67793,342394
3924,dove-young,3,0.00088,70803,20.67881,342394
3925,dpotapov,3,0.00088,70806,20.67968,342394
3926,draeath,3,0.00088,70809,20.68056,342394
3927,Dragon1573,3,0.00088,70812,20.68144,342394
3928,Dream2zz,3,0.00088,70815,20.68231,342394
3929,DreamWorldHua,3,0.00088,70818,20.68319,342394
3930,dripchar,3,0.00088,70821,20.68407,342394
3931,dsaydon90,3,0.00088,70824,20.68494,342394
3932,dsoguet,3,0.00088,70827,20.68582,342394
3933,dspruell,3,0.00088,70830,20.68669,342394
3934,du86796922,3,0.00088,70833,20.68757,342394
3935,dweekly,3,0.00088,70836,20.68845,342394
3936,dwillist,3,0.00088,70839,20.68932,342394
3937,dzhang-b,3,0.00088,70842,20.69020,342394
3938,eacdy,3,0.00088,70845,20.69108,342394
3939,eastlunar,3,0.00088,70848,20.69195,342394
3940,echoontheway,3,0.00088,70851,20.69283,342394
3941,edeandrea,3,0.00088,70854,20.69370,342394
3942,eero-thia,3,0.00088,70857,20.69458,342394
3943,ehlesp,3,0.00088,70860,20.69546,342394
3944,eifelmicha,3,0.00088,70863,20.69633,342394
3945,ejose19,3,0.00088,70866,20.69721,342394
3946,ekuiper-sbp,3,0.00088,70869,20.69808,342394
3947,ElapsedSoul,3,0.00088,70872,20.69896,342394
3948,elbasan,3,0.00088,70875,20.69984,342394
3949,elijah-stytch,3,0.00088,70878,20.70071,342394
3950,emadolsky,3,0.00088,70881,20.70159,342394
3951,emctl,3,0.00088,70884,20.70247,342394
3952,empath-nirvana,3,0.00088,70887,20.70334,342394
3953,endersonmaia,3,0.00088,70890,20.70422,342394
3954,EnicZhang,3,0.00088,70893,20.70509,342394
3955,enilsen16,3,0.00088,70896,20.70597,342394
3956,enthr,3,0.00088,70899,20.70685,342394
3957,eostermueller,3,0.00088,70902,20.70772,342394
3958,epg-mori-k,3,0.00088,70905,20.70860,342394
3959,Erfan-Motallebi,3,0.00088,70908,20.70948,342394
3960,erno123,3,0.00088,70911,20.71035,342394
3961,erpel,3,0.00088,70914,20.71123,342394
3962,esemeniuc,3,0.00088,70917,20.71210,342394
3963,espenairmine,3,0.00088,70920,20.71298,342394
3964,et1975,3,0.00088,70923,20.71386,342394
3965,EthanAlban,3,0.00088,70926,20.71473,342394
3966,ethnhll,3,0.00088,70929,20.71561,342394
3967,EugeneLugovtsov,3,0.00088,70932,20.71648,342394
3968,Excpt0r,3,0.00088,70935,20.71736,342394
3969,explogx,3,0.00088,70938,20.71824,342394
3970,expoli,3,0.00088,70941,20.71911,342394
3971,EyalAbadi,3,0.00088,70944,20.71999,342394
3972,ezh,3,0.00088,70947,20.72087,342394
3973,F0xedb,3,0.00088,70950,20.72174,342394
3974,f9n,3,0.00088,70953,20.72262,342394
3975,fabio-mrocha,3,0.00088,70956,20.72349,342394
3976,FanForerver,3,0.00088,70959,20.72437,342394
3977,fangfenghuang,3,0.00088,70962,20.72525,342394
3978,fangqyou,3,0.00088,70965,20.72612,342394
3979,fanliquan,3,0.00088,70968,20.72700,342394
3980,fanspace,3,0.00088,70971,20.72787,342394
3981,fardin01,3,0.00088,70974,20.72875,342394
3982,FarhanSajid1,3,0.00088,70977,20.72963,342394
3983,fb33,3,0.00088,70980,20.73050,342394
3984,fbernier,3,0.00088,70983,20.73138,342394
3985,Fcscanf,3,0.00088,70986,20.73226,342394
3986,fculpo,3,0.00088,70989,20.73313,342394
3987,fe80,3,0.00088,70992,20.73401,342394
3988,FeLvi-zzz,3,0.00088,70995,20.73488,342394
3989,fengqi2019,3,0.00088,70998,20.73576,342394
3990,Fengrui-Liu,3,0.00088,71001,20.73664,342394
3991,fhitchen,3,0.00088,71004,20.73751,342394
3992,figassis,3,0.00088,71007,20.73839,342394
3993,Fiono11,3,0.00088,71010,20.73927,342394
3994,Flauschbaellchen,3,0.00088,71013,20.74014,342394
3995,fliespl,3,0.00088,71016,20.74102,342394
3996,floating-yuan,3,0.00088,71019,20.74189,342394
3997,florianstoeber,3,0.00088,71022,20.74277,342394
3998,flying-kestrel,3,0.00088,71025,20.74365,342394
3999,flyingyang,3,0.00088,71028,20.74452,342394
4000,Fredborg,3,0.00088,71031,20.74540,342394
4001,fredwangwang,3,0.00088,71034,20.74627,342394
4002,FTFX,3,0.00088,71037,20.74715,342394
4003,fuchstim,3,0.00088,71040,20.74803,342394
4004,fungusakafungus,3,0.00088,71043,20.74890,342394
4005,fyqls,3,0.00088,71046,20.74978,342394
4006,gabrielbatir,3,0.00088,71049,20.75066,342394
4007,gaetancollaud,3,0.00088,71052,20.75153,342394
4008,gambtho,3,0.00088,71055,20.75241,342394
4009,GarimaBathla,3,0.00088,71058,20.75328,342394
4010,gbonnefille,3,0.00088,71061,20.75416,342394
4011,gdziwoki,3,0.00088,71064,20.75504,342394
4012,gebn,3,0.00088,71067,20.75591,342394
4013,GeertvanHorrik,3,0.00088,71070,20.75679,342394
4014,geoffo-dev,3,0.00088,71073,20.75767,342394
4015,geraldcombs,3,0.00088,71076,20.75854,342394
4016,ggermis,3,0.00088,71079,20.75942,342394
4017,ghabarid,3,0.00088,71082,20.76029,342394
4018,ghaithTK,3,0.00088,71085,20.76117,342394
4019,Gilwe,3,0.00088,71088,20.76205,342394
4020,gitbluf,3,0.00088,71091,20.76292,342394
4021,GitFrol,3,0.00088,71094,20.76380,342394
4022,GitHubThinking,3,0.00088,71097,20.76467,342394
4023,gitpushdashf,3,0.00088,71100,20.76555,342394
4024,gjacobsatl,3,0.00088,71103,20.76643,342394
4025,glassnick,3,0.00088,71106,20.76730,342394
4026,glenjamin,3,0.00088,71109,20.76818,342394
4027,glongzh,3,0.00088,71112,20.76906,342394
4028,glycerin-ce,3,0.00088,71115,20.76993,342394
4029,gmcbrien,3,0.00088,71118,20.77081,342394
4030,GopiChandra25,3,0.00088,71121,20.77168,342394
4031,gossion,3,0.00088,71124,20.77256,342394
4032,Grace-1024,3,0.00088,71127,20.77344,342394
4033,GrahamLea,3,0.00088,71130,20.77431,342394
4034,gravufo,3,0.00088,71133,20.77519,342394
4035,GreenShadeZhang,3,0.00088,71136,20.77607,342394
4036,gregpavl,3,0.00088,71139,20.77694,342394
4037,GULSHAN6,3,0.00088,71142,20.77782,342394
4038,guyluz11,3,0.00088,71145,20.77869,342394
4039,gwatts,3,0.00088,71148,20.77957,342394
4040,gxglls,3,0.00088,71151,20.78045,342394
4041,haihongren,3,0.00088,71154,20.78132,342394
4042,haijianyang,3,0.00088,71157,20.78220,342394
4043,haliyev,3,0.00088,71160,20.78307,342394
4044,HaloFour,3,0.00088,71163,20.78395,342394
4045,Hamidhasan,3,0.00088,71166,20.78483,342394
4046,hampus77,3,0.00088,71169,20.78570,342394
4047,hansedong,3,0.00088,71172,20.78658,342394
4048,haotaogeng,3,0.00088,71175,20.78746,342394
4049,haoxuebing,3,0.00088,71178,20.78833,342394
4050,harikiranvusirikala,3,0.00088,71181,20.78921,342394
4051,harridu,3,0.00088,71184,20.79008,342394
4052,Harshit-Anand,3,0.00088,71187,20.79096,342394
4053,hasakilol,3,0.00088,71190,20.79184,342394
4054,hds,3,0.00088,71193,20.79271,342394
4055,hdurand0710,3,0.00088,71196,20.79359,342394
4056,headyj,3,0.00088,71199,20.79446,342394
4057,heckelmann,3,0.00088,71202,20.79534,342394
4058,hedrox,3,0.00088,71205,20.79622,342394
4059,henjue,3,0.00088,71208,20.79709,342394
4060,henriblancke,3,0.00088,71211,20.79797,342394
4061,henriknj,3,0.00088,71214,20.79885,342394
4062,HenriWilliams,3,0.00088,71217,20.79972,342394
4063,heurekus,3,0.00088,71220,20.80060,342394
4064,hhyasdf,3,0.00088,71223,20.80147,342394
4065,hinklec,3,0.00088,71226,20.80235,342394
4066,hitenlulla,3,0.00088,71229,20.80323,342394
4067,hkloudou,3,0.00088,71232,20.80410,342394
4068,hlacik,3,0.00088,71235,20.80498,342394
4069,hliangzhao,3,0.00088,71238,20.80586,342394
4070,hoepfnerj,3,0.00088,71241,20.80673,342394
4071,holmes1412,3,0.00088,71244,20.80761,342394
4072,hostalp,3,0.00088,71247,20.80848,342394
4073,houstar,3,0.00088,71250,20.80936,342394
4074,Hoxxx,3,0.00088,71253,20.81024,342394
4075,hritikgupta,3,0.00088,71256,20.81111,342394
4076,hsnotebook,3,0.00088,71259,20.81199,342394
4077,HuaxinTang,3,0.00088,71262,20.81286,342394
4078,huchen2021,3,0.00088,71265,20.81374,342394
4079,HudsonWu,3,0.00088,71268,20.81462,342394
4080,Hugh-yw,3,0.00088,71271,20.81549,342394
4081,hugo345816,3,0.00088,71274,20.81637,342394
4082,HybridReaverHD,3,0.00088,71277,20.81725,342394
4083,hyingreborn,3,0.00088,71280,20.81812,342394
4084,hykych,3,0.00088,71283,20.81900,342394
4085,hyperloglogy,3,0.00088,71286,20.81987,342394
4086,i053322,3,0.00088,71289,20.82075,342394
4087,i5Js,3,0.00088,71292,20.82163,342394
4088,iamleot,3,0.00088,71295,20.82250,342394
4089,ianwoolf,3,0.00088,71298,20.82338,342394
4090,ibootstrapper,3,0.00088,71301,20.82426,342394
4091,IceCodeNew,3,0.00088,71304,20.82513,342394
4092,IcerBean,3,0.00088,71307,20.82601,342394
4093,icicimov,3,0.00088,71310,20.82688,342394
4094,ievseev,3,0.00088,71313,20.82776,342394
4095,igwejk,3,0.00088,71316,20.82864,342394
4096,ikewabo,3,0.00088,71319,20.82951,342394
4097,ilya-git,3,0.00088,71322,20.83039,342394
4098,inaryart,3,0.00088,71325,20.83126,342394
4099,InderpreetSaini,3,0.00088,71328,20.83214,342394
4100,indianmifan,3,0.00088,71331,20.83302,342394
4101,indigo-saito,3,0.00088,71334,20.83389,342394
4102,indreias,3,0.00088,71337,20.83477,342394
4103,inevity,3,0.00088,71340,20.83565,342394
4104,inforzip,3,0.00088,71343,20.83652,342394
4105,inglor,3,0.00088,71346,20.83740,342394
4106,initial-nj,3,0.00088,71349,20.83827,342394
4107,introom,3,0.00088,71352,20.83915,342394
4108,ira-gordin-sap,3,0.00088,71355,20.84003,342394
4109,isatfg,3,0.00088,71358,20.84090,342394
4110,ischoll,3,0.00088,71361,20.84178,342394
4111,ishishow,3,0.00088,71364,20.84265,342394
4112,isthereaspoon,3,0.00088,71367,20.84353,342394
4113,iswbm,3,0.00088,71370,20.84441,342394
4114,ITG001,3,0.00088,71373,20.84528,342394
4115,ivan-claire,3,0.00088,71376,20.84616,342394
4116,ixe013,3,0.00088,71379,20.84704,342394
4117,Izvi-digibank,3,0.00088,71382,20.84791,342394
4118,j2gg0s,3,0.00088,71385,20.84879,342394
4119,JackRhodes,3,0.00088,71388,20.84966,342394
4120,jacktwilliams,3,0.00088,71391,20.85054,342394
4121,jacobstr,3,0.00088,71394,20.85142,342394
4122,jaehnri,3,0.00088,71397,20.85229,342394
4123,JaimeMagiera,3,0.00088,71400,20.85317,342394
4124,JameKeal,3,0.00088,71403,20.85405,342394
4125,jamesjhhan,3,0.00088,71406,20.85492,342394
4126,james-nesbitt,3,0.00088,71409,20.85580,342394
4127,jaredhancock31,3,0.00088,71412,20.85667,342394
4128,jasonhadi,3,0.00088,71415,20.85755,342394
4129,jasonviviano,3,0.00088,71418,20.85843,342394
4130,JatinNarang1,3,0.00088,71421,20.85930,342394
4131,javageek79,3,0.00088,71424,20.86018,342394
4132,JBodkin-LH,3,0.00088,71427,20.86105,342394
4133,jbury,3,0.00088,71430,20.86193,342394
4134,jchau207,3,0.00088,71433,20.86281,342394
4135,jduepmeier,3,0.00088,71436,20.86368,342394
4136,jedcunningham,3,0.00088,71439,20.86456,342394
4137,jektvik-si,3,0.00088,71442,20.86544,342394
4138,jemygraw,3,0.00088,71445,20.86631,342394
4139,Jenniferyingni,3,0.00088,71448,20.86719,342394
4140,JeongyoonMoon,3,0.00088,71451,20.86806,342394
4141,jeremyspykerman,3,0.00088,71454,20.86894,342394
4142,jessequinn,3,0.00088,71457,20.86982,342394
4143,JesusRo,3,0.00088,71460,20.87069,342394
4144,jetmuffin,3,0.00088,71463,20.87157,342394
4145,jetpacula,3,0.00088,71466,20.87245,342394
4146,jeyrce,3,0.00088,71469,20.87332,342394
4147,jfilipcz,3,0.00088,71472,20.87420,342394
4148,jgavinray,3,0.00088,71475,20.87507,342394
4149,jhart99,3,0.00088,71478,20.87595,342394
4150,Jimbo4794,3,0.00088,71481,20.87683,342394
4151,jimtoniq,3,0.00088,71484,20.87770,342394
4152,jinyongyoo,3,0.00088,71487,20.87858,342394
4153,jithine,3,0.00088,71490,20.87945,342394
4154,jividijuvent,3,0.00088,71493,20.88033,342394
4155,JJJJJones,3,0.00088,71496,20.88121,342394
4156,jkl92,3,0.00088,71499,20.88208,342394
4157,jkosecki,3,0.00088,71502,20.88296,342394
4158,jlatusek,3,0.00088,71505,20.88384,342394
4159,jlevertov,3,0.00088,71508,20.88471,342394
4160,jls-0,3,0.00088,71511,20.88559,342394
4161,jlunaq,3,0.00088,71514,20.88646,342394
4162,jmc-9304,3,0.00088,71517,20.88734,342394
4163,JMCFTW,3,0.00088,71520,20.88822,342394
4164,jmell-slg,3,0.00088,71523,20.88909,342394
4165,JoaoRicardoCardoso,3,0.00088,71526,20.88997,342394
4166,jobcespedes,3,0.00088,71529,20.89085,342394
4167,joberdick-rcd,3,0.00088,71532,20.89172,342394
4168,jochembroekhoff,3,0.00088,71535,20.89260,342394
4169,joe-legg,3,0.00088,71538,20.89347,342394
4170,JoeyValentine,3,0.00088,71541,20.89435,342394
4171,JohannesMaier,3,0.00088,71544,20.89523,342394
4172,johndiego,3,0.00088,71547,20.89610,342394
4173,johnliu26,3,0.00088,71550,20.89698,342394
4174,Johnny00520,3,0.00088,71553,20.89785,342394
4175,johnson-rj,3,0.00088,71556,20.89873,342394
4176,johnwchadwick,3,0.00088,71559,20.89961,342394
4177,joke,3,0.00088,71562,20.90048,342394
4178,JonasHiltl,3,0.00088,71565,20.90136,342394
4179,jon-depop,3,0.00088,71568,20.90224,342394
4180,Jongaebe,3,0.00088,71571,20.90311,342394
4181,jonwilliams84,3,0.00088,71574,20.90399,342394
4182,jordanbertasso,3,0.00088,71577,20.90486,342394
4183,jorgeolive,3,0.00088,71580,20.90574,342394
4184,joshianiket22,3,0.00088,71583,20.90662,342394
4185,joshrwolf,3,0.00088,71586,20.90749,342394
4186,jpaille,3,0.00088,71589,20.90837,342394
4187,jphelton,3,0.00088,71592,20.90924,342394
4188,jpmcb,3,0.00088,71595,20.91012,342394
4189,jpower432,3,0.00088,71598,20.91100,342394
4190,jprecuch,3,0.00088,71601,20.91187,342394
4191,jpuskar,3,0.00088,71604,20.91275,342394
4192,jsaelmackers,3,0.00088,71607,20.91363,342394
4193,jschintag,3,0.00088,71610,20.91450,342394
4194,jshen28,3,0.00088,71613,20.91538,342394
4195,junzebao,3,0.00088,71616,20.91625,342394
4196,jurschel,3,0.00088,71619,20.91713,342394
4197,JustinAvaLabs,3,0.00088,71622,20.91801,342394
4198,justmobilize,3,0.00088,71625,20.91888,342394
4199,jylin,3,0.00088,71628,20.91976,342394
4200,K1ngram4,3,0.00088,71631,20.92064,342394
4201,k1rk,3,0.00088,71634,20.92151,342394
4202,kalyanbhonagiri16,3,0.00088,71637,20.92239,342394
4203,kamlakant,3,0.00088,71640,20.92326,342394
4204,kanibs,3,0.00088,71643,20.92414,342394
4205,kate-osborn,3,0.00088,71646,20.92502,342394
4206,katepangLiu,3,0.00088,71649,20.92589,342394
4207,kbhaines,3,0.00088,71652,20.92677,342394
4208,kcirrr,3,0.00088,71655,20.92764,342394
4209,keeplowkey,3,0.00088,71658,20.92852,342394
4210,keepsimple1,3,0.00088,71661,20.92940,342394
4211,kekeliu-whu,3,0.00088,71664,20.93027,342394
4212,kellerkind84,3,0.00088,71667,20.93115,342394
4213,khaninejad,3,0.00088,71670,20.93203,342394
4214,kharf,3,0.00088,71673,20.93290,342394
4215,khetho,3,0.00088,71676,20.93378,342394
4216,kianmeng,3,0.00088,71679,20.93465,342394
4217,KimDoubleB,3,0.00088,71682,20.93553,342394
4218,kincjf,3,0.00088,71685,20.93641,342394
4219,KingKunn,3,0.00088,71688,20.93728,342394
4220,king-universe,3,0.00088,71691,20.93816,342394
4221,KipsasJaujoj,3,0.00088,71694,20.93904,342394
4222,kiranmeduri,3,0.00088,71697,20.93991,342394
4223,kiranpatel11,3,0.00088,71700,20.94079,342394
4224,kishore0709,3,0.00088,71703,20.94166,342394
4225,kivancguckiran,3,0.00088,71706,20.94254,342394
4226,kkujawa-sumo,3,0.00088,71709,20.94342,342394
4227,kmahyyg,3,0.00088,71712,20.94429,342394
4228,knfoo,3,0.00088,71715,20.94517,342394
4229,kolstae,3,0.00088,71718,20.94604,342394
4230,komalarg2010,3,0.00088,71721,20.94692,342394
4231,konstantin-921,3,0.00088,71724,20.94780,342394
4232,kpcyrd,3,0.00088,71727,20.94867,342394
4233,krishna2603,3,0.00088,71730,20.94955,342394
4234,krishnakc1,3,0.00088,71733,20.95043,342394
4235,KrisMacBP,3,0.00088,71736,20.95130,342394
4236,kseniyashaydurova,3,0.00088,71739,20.95218,342394
4237,kudos-dude,3,0.00088,71742,20.95305,342394
4238,kuja53,3,0.00088,71745,20.95393,342394
4239,kumaravanish,3,0.00088,71748,20.95481,342394
4240,kunalp-gohire,3,0.00088,71751,20.95568,342394
4241,kuro0920,3,0.00088,71754,20.95656,342394
4242,kvendingoldo,3,0.00088,71757,20.95744,342394
4243,kylebernhardy,3,0.00088,71760,20.95831,342394
4244,kylegallatin,3,0.00088,71763,20.95919,342394
4245,kyle-lt,3,0.00088,71766,20.96006,342394
4246,kz2318nkd,3,0.00088,71769,20.96094,342394
4247,lakalaka-chen,3,0.00088,71772,20.96182,342394
4248,lalloni,3,0.00088,71775,20.96269,342394
4249,Lantern-r,3,0.00088,71778,20.96357,342394
4250,lapillaga,3,0.00088,71781,20.96444,342394
4251,larmic,3,0.00088,71784,20.96532,342394
4252,lazydino,3,0.00088,71787,20.96620,342394
4253,lbernick,3,0.00088,71790,20.96707,342394
4254,lcbcFoo,3,0.00088,71793,20.96795,342394
4255,lcw2,3,0.00088,71796,20.96883,342394
4256,lddlww,3,0.00088,71799,20.96970,342394
4257,learn2phoenix,3,0.00088,71802,20.97058,342394
4258,LechG,3,0.00088,71805,20.97145,342394
4259,leeyiw,3,0.00088,71808,20.97233,342394
4260,LeonorLunatech,3,0.00088,71811,20.97321,342394
4261,leviwilson,3,0.00088,71814,20.97408,342394
4262,lewislbr,3,0.00088,71817,20.97496,342394
4263,liabio,3,0.00088,71820,20.97583,342394
4264,LianxinGao,3,0.00088,71823,20.97671,342394
4265,libsamek,3,0.00088,71826,20.97759,342394
4266,lichuan6,3,0.00088,71829,20.97846,342394
4267,lin1005q,3,0.00088,71832,20.97934,342394
4268,linastehle,3,0.00088,71835,20.98022,342394
4269,LindaYu17,3,0.00088,71838,20.98109,342394
4270,lin-lin123,3,0.00088,71841,20.98197,342394
4271,lisy09,3,0.00088,71844,20.98284,342394
4272,littleboy-j,3,0.00088,71847,20.98372,342394
4273,littlejawa,3,0.00088,71850,20.98460,342394
4274,lixiaopengxiya,3,0.00088,71853,20.98547,342394
4275,lixin9311,3,0.00088,71856,20.98635,342394
4276,LiYiPeng-1,3,0.00088,71859,20.98723,342394
4277,lizhanhui,3,0.00088,71862,20.98810,342394
4278,lizhifengones,3,0.00088,71865,20.98898,342394
4279,lklein53,3,0.00088,71868,20.98985,342394
4280,lklkxcxc,3,0.00088,71871,20.99073,342394
4281,llambiel,3,0.00088,71874,20.99161,342394
4282,lmroil,3,0.00088,71877,20.99248,342394
4283,lmx1989219,3,0.00088,71880,20.99336,342394
4284,logandavies181,3,0.00088,71883,20.99423,342394
4285,long-nguyen-ts,3,0.00088,71886,20.99511,342394
4286,LongZaiAiYueLiang,3,0.00088,71889,20.99599,342394
4287,LordNoteworthy,3,0.00088,71892,20.99686,342394
4288,lorenz,3,0.00088,71895,20.99774,342394
4289,lotheac,3,0.00088,71898,20.99862,342394
4290,lovelybowen,3,0.00088,71901,20.99949,342394
4291,lucasdu2,3,0.00088,71904,21.00037,342394
4292,lucianocarranza,3,0.00088,71907,21.00124,342394
4293,LucileDesfour,3,0.00088,71910,21.00212,342394
4294,luckerby,3,0.00088,71913,21.00300,342394
4295,luckydonald,3,0.00088,71916,21.00387,342394
4296,lujunlai,3,0.00088,71919,21.00475,342394
4297,lukareciprocity,3,0.00088,71922,21.00563,342394
4298,lukeschlather,3,0.00088,71925,21.00650,342394
4299,luozhiwenn,3,0.00088,71928,21.00738,342394
4300,luwang-vmware,3,0.00088,71931,21.00825,342394
4301,lwille,3,0.00088,71934,21.00913,342394
4302,lx1036,3,0.00088,71937,21.01001,342394
4303,lynshi,3,0.00088,71940,21.01088,342394
4304,lysilver,3,0.00088,71943,21.01176,342394
4305,lysyy,3,0.00088,71946,21.01263,342394
4306,m0nk3y-s3c,3,0.00088,71949,21.01351,342394
4307,m0sh1x2,3,0.00088,71952,21.01439,342394
4308,m44soroush,3,0.00088,71955,21.01526,342394
4309,mac133k,3,0.00088,71958,21.01614,342394
4310,magapp,3,0.00088,71961,21.01702,342394
4311,mahauke,3,0.00088,71964,21.01789,342394
4312,mahendrabishnoi2,3,0.00088,71967,21.01877,342394
4313,majst01,3,0.00088,71970,21.01964,342394
4314,ManaSugi,3,0.00088,71973,21.02052,342394
4315,manavsiddharthgupta,3,0.00088,71976,21.02140,342394
4316,Mane0007,3,0.00088,71979,21.02227,342394
4317,manedurphy,3,0.00088,71982,21.02315,342394
4318,mangulonr,3,0.00088,71985,21.02402,342394
4319,Manicben,3,0.00088,71988,21.02490,342394
4320,manixybion,3,0.00088,71991,21.02578,342394
4321,mantipin,3,0.00088,71994,21.02665,342394
4322,maorkuriel,3,0.00088,71997,21.02753,342394
4323,marcelamelara,3,0.00088,72000,21.02841,342394
4324,marcosmas28,3,0.00088,72003,21.02928,342394
4325,marctc,3,0.00088,72006,21.03016,342394
4326,marcusbgn,3,0.00088,72009,21.03103,342394
4327,mariadb-nickvenenga,3,0.00088,72012,21.03191,342394
4328,marianobilli,3,0.00088,72015,21.03279,342394
4329,markdascher,3,0.00088,72018,21.03366,342394
4330,markretallack,3,0.00088,72021,21.03454,342394
4331,MarkSRobinson,3,0.00088,72024,21.03542,342394
4332,martiinezz,3,0.00088,72027,21.03629,342394
4333,martinburchell,3,0.00088,72030,21.03717,342394
4334,martinkennelly,3,0.00088,72033,21.03804,342394
4335,martin-magakian,3,0.00088,72036,21.03892,342394
4336,martinounap,3,0.00088,72039,21.03980,342394
4337,martivo,3,0.00088,72042,21.04067,342394
4338,matanw,3,0.00088,72045,21.04155,342394
4339,matheushent,3,0.00088,72048,21.04242,342394
4340,MattDavis00,3,0.00088,72051,21.04330,342394
4341,matt-goldsmith-okcupid,3,0.00088,72054,21.04418,342394
4342,mattstam,3,0.00088,72057,21.04505,342394
4343,mattwelke,3,0.00088,72060,21.04593,342394
4344,max27149,3,0.00088,72063,21.04681,342394
4345,maxaudron,3,0.00088,72066,21.04768,342394
4346,MaxFedotov,3,0.00088,72069,21.04856,342394
4347,maxirus,3,0.00088,72072,21.04943,342394
4348,maxlein,3,0.00088,72075,21.05031,342394
4349,max-l-f,3,0.00088,72078,21.05119,342394
4350,MaxThom,3,0.00088,72081,21.05206,342394
4351,mazycool,3,0.00088,72084,21.05294,342394
4352,mbarecki,3,0.00088,72087,21.05382,342394
4353,mbu147,3,0.00088,72090,21.05469,342394
4354,McAndersDK,3,0.00088,72093,21.05557,342394
4355,mcmho,3,0.00088,72096,21.05644,342394
4356,mcripps9,3,0.00088,72099,21.05732,342394
4357,mcurran-us,3,0.00088,72102,21.05820,342394
4358,mdahamiwal,3,0.00088,72105,21.05907,342394
4359,meghanakhuntia,3,0.00088,72108,21.05995,342394
4360,memorypanic404,3,0.00088,72111,21.06082,342394
4361,menvol3,3,0.00088,72114,21.06170,342394
4362,meridiana73,3,0.00088,72117,21.06258,342394
4363,Merovius,3,0.00088,72120,21.06345,342394
4364,Meza1923,3,0.00088,72123,21.06433,342394
4365,mfbrj,3,0.00088,72126,21.06521,342394
4366,mf-lit,3,0.00088,72129,21.06608,342394
4367,mhallin2,3,0.00088,72132,21.06696,342394
4368,mhamzarazzaq97,3,0.00088,72135,21.06783,342394
4369,mi81ma,3,0.00088,72138,21.06871,342394
4370,mich181189,3,0.00088,72141,21.06959,342394
4371,MichaelLogutov,3,0.00088,72144,21.07046,342394
4372,MichaelShohat,3,0.00088,72147,21.07134,342394
4373,michielvoo,3,0.00088,72150,21.07222,342394
4374,MichZem,3,0.00088,72153,21.07309,342394
4375,MikeK184,3,0.00088,72156,21.07397,342394
4376,mikemonteith,3,0.00088,72159,21.07484,342394
4377,mikhailkoliada,3,0.00088,72162,21.07572,342394
4378,mikrammo,3,0.00088,72165,21.07660,342394
4379,mikulass,3,0.00088,72168,21.07747,342394
4380,millsp,3,0.00088,72171,21.07835,342394
4381,milonjames,3,0.00088,72174,21.07922,342394
4382,milsman2,3,0.00088,72177,21.08010,342394
4383,mimmus,3,0.00088,72180,21.08098,342394
4384,minamijoyo,3,0.00088,72183,21.08185,342394
4385,minopolous,3,0.00088,72186,21.08273,342394
4386,Minutis,3,0.00088,72189,21.08361,342394
4387,mishina2228,3,0.00088,72192,21.08448,342394
4388,MisterWS,3,0.00088,72195,21.08536,342394
4389,mitchellgordon95,3,0.00088,72198,21.08623,342394
4390,mixja,3,0.00088,72201,21.08711,342394
4391,miyoosan,3,0.00088,72204,21.08799,342394
4392,mjallday,3,0.00088,72207,21.08886,342394
4393,mjsmith1028,3,0.00088,72210,21.08974,342394
4394,mkjpryor,3,0.00088,72213,21.09061,342394
4395,mkkb473,3,0.00088,72216,21.09149,342394
4396,mknet3,3,0.00088,72219,21.09237,342394
4397,mkotsabiuk,3,0.00088,72222,21.09324,342394
4398,mkreidenweis-schulmngr,3,0.00088,72225,21.09412,342394
4399,MLHafizur,3,0.00088,72228,21.09500,342394
4400,m-linner-ericsson,3,0.00088,72231,21.09587,342394
4401,mlorenzo-stratio,3,0.00088,72234,21.09675,342394
4402,m-messiah,3,0.00088,72237,21.09762,342394
4403,mmillard0,3,0.00088,72240,21.09850,342394
4404,modabas,3,0.00088,72243,21.09938,342394
4405,mohamedamine93,3,0.00088,72246,21.10025,342394
4406,mohamed-cds,3,0.00088,72249,21.10113,342394
4407,morimoto-cybozu,3,0.00088,72252,21.10201,342394
4408,Morion-Self,3,0.00088,72255,21.10288,342394
4409,moritz89,3,0.00088,72258,21.10376,342394
4410,morlay,3,0.00088,72261,21.10463,342394
4411,mosanden,3,0.00088,72264,21.10551,342394
4412,moschlar,3,0.00088,72267,21.10639,342394
4413,MosenzonTal,3,0.00088,72270,21.10726,342394
4414,mottibec,3,0.00088,72273,21.10814,342394
4415,mouniraboud,3,0.00088,72276,21.10901,342394
4416,mozillazg,3,0.00088,72279,21.10989,342394
4417,Mpadhi2000,3,0.00088,72282,21.11077,342394
4418,mpdevul,3,0.00088,72285,21.11164,342394
4419,mrad-bilel,3,0.00088,72288,21.11252,342394
4420,mrclki,3,0.00088,72291,21.11340,342394
4421,mreck,3,0.00088,72294,21.11427,342394
4422,mrfaizal,3,0.00088,72297,21.11515,342394
4423,MrLightSpeed0,3,0.00088,72300,21.11602,342394
4424,mroderick,3,0.00088,72303,21.11690,342394
4425,MrSecure,3,0.00088,72306,21.11778,342394
4426,MrSsunlight,3,0.00088,72309,21.11865,342394
4427,mrsufgi,3,0.00088,72312,21.11953,342394
4428,msamad,3,0.00088,72315,21.12041,342394
4429,mscbg,3,0.00088,72318,21.12128,342394
4430,msiriwardena,3,0.00088,72321,21.12216,342394
4431,mtesseract,3,0.00088,72324,21.12303,342394
4432,mtojek,3,0.00088,72327,21.12391,342394
4433,mtrimolet,3,0.00088,72330,21.12479,342394
4434,Mtze,3,0.00088,72333,21.12566,342394
4435,Mutantt,3,0.00088,72336,21.12654,342394
4436,mvaalexp,3,0.00088,72339,21.12741,342394
4437,MvRemmerden,3,0.00088,72342,21.12829,342394
4438,mwtian,3,0.00088,72345,21.12917,342394
4439,mxdblcf,3,0.00088,72348,21.13004,342394
4440,mykhailoaksani,3,0.00088,72351,21.13092,342394
4441,mzmuer,3,0.00088,72354,21.13180,342394
4442,n1vgabay,3,0.00088,72357,21.13267,342394
4443,nadgowdas,3,0.00088,72360,21.13355,342394
4444,nafeabd,3,0.00088,72363,21.13442,342394
4445,namh0,3,0.00088,72366,21.13530,342394
4446,NamitaJaokar,3,0.00088,72369,21.13618,342394
4447,nanorobocop,3,0.00088,72372,21.13705,342394
4448,narenarjun,3,0.00088,72375,21.13793,342394
4449,NathanDotTo,3,0.00088,72378,21.13881,342394
4450,nature1995,3,0.00088,72381,21.13968,342394
4451,naveenb30,3,0.00088,72384,21.14056,342394
4452,ndhcoder,3,0.00088,72387,21.14143,342394
4453,ndimiduk,3,0.00088,72390,21.14231,342394
4454,nedy13,3,0.00088,72393,21.14319,342394
4455,nelsonspbr,3,0.00088,72396,21.14406,342394
4456,netanelsi,3,0.00088,72399,21.14494,342394
4457,nethershaw,3,0.00088,72402,21.14581,342394
4458,nevosial,3,0.00088,72405,21.14669,342394
4459,NextNiclas,3,0.00088,72408,21.14757,342394
4460,ngosang,3,0.00088,72411,21.14844,342394
4461,nhomble,3,0.00088,72414,21.14932,342394
4462,nichenqin-treelab,3,0.00088,72417,21.15020,342394
4463,nick-laqua-dragon,3,0.00088,72420,21.15107,342394
4464,nicolastakashi,3,0.00088,72423,21.15195,342394
4465,nigoroll,3,0.00088,72426,21.15282,342394
4466,nika-nii,3,0.00088,72429,21.15370,342394
4467,nikhilshrv,3,0.00088,72432,21.15458,342394
4468,nikosmeds,3,0.00088,72435,21.15545,342394
4469,NIKU-SINGH,3,0.00088,72438,21.15633,342394
4470,nileshbhadana,3,0.00088,72441,21.15720,342394
4471,nir-ridge,3,0.00088,72444,21.15808,342394
4472,NishkarshRaj,3,0.00088,72447,21.15896,342394
4473,niv8,3,0.00088,72450,21.15983,342394
4474,njuptlzf,3,0.00088,72453,21.16071,342394
4475,Noksa,3,0.00088,72456,21.16159,342394
4476,NosIreland,3,0.00088,72459,21.16246,342394
4477,nossrannug,3,0.00088,72462,21.16334,342394
4478,nrhodes91,3,0.00088,72465,21.16421,342394
4479,nsagark,3,0.00088,72468,21.16509,342394
4480,nsait-linaro,3,0.00088,72471,21.16597,342394
4481,nschambu,3,0.00088,72474,21.16684,342394
4482,nu007a,3,0.00088,72477,21.16772,342394
4483,nunojusto,3,0.00088,72480,21.16860,342394
4484,Nuru,3,0.00088,72483,21.16947,342394
4485,nWhitehill,3,0.00088,72486,21.17035,342394
4486,nwmcsween,3,0.00088,72489,21.17122,342394
4487,OctoHuman,3,0.00088,72492,21.17210,342394
4488,odorT,3,0.00088,72495,21.17298,342394
4489,ofekedri,3,0.00088,72498,21.17385,342394
4490,ogarcia,3,0.00088,72501,21.17473,342394
4491,oilers,3,0.00088,72504,21.17560,342394
4492,ojroques,3,0.00088,72507,21.17648,342394
4493,OlaAde,3,0.00088,72510,21.17736,342394
4494,Oleg26Dev,3,0.00088,72513,21.17823,342394
4495,Olesp,3,0.00088,72516,21.17911,342394
4496,om3171991,3,0.00088,72519,21.17999,342394
4497,omegazeng,3,0.00088,72522,21.18086,342394
4498,omer2500,3,0.00088,72525,21.18174,342394
4499,opatil-vibrent,3,0.00088,72528,21.18261,342394
4500,ophiryael,3,0.00088,72531,21.18349,342394
4501,OrKarstoft,3,0.00088,72534,21.18437,342394
4502,osaffer,3,0.00088,72537,21.18524,342394
4503,Oseenix,3,0.00088,72540,21.18612,342394
4504,ostgardh,3,0.00088,72543,21.18700,342394
4505,Outek,3,0.00088,72546,21.18787,342394
4506,pabloelisseo,3,0.00088,72549,21.18875,342394
4507,panjf2000,3,0.00088,72552,21.18962,342394
4508,pankaj-83incs,3,0.00088,72555,21.19050,342394
4509,pardeepbeniwal,3,0.00088,72558,21.19138,342394
4510,patrickdung,3,0.00088,72561,21.19225,342394
4511,patrik-upspot,3,0.00088,72564,21.19313,342394
4512,PatrykGala,3,0.00088,72567,21.19400,342394
4513,paul-civitas,3,0.00088,72570,21.19488,342394
4514,PavelPolyakov,3,0.00088,72573,21.19576,342394
4515,pawelmitka,3,0.00088,72576,21.19663,342394
4516,paxforce,3,0.00088,72579,21.19751,342394
4517,pbaderia01,3,0.00088,72582,21.19839,342394
4518,pdp10,3,0.00088,72585,21.19926,342394
4519,pebf,3,0.00088,72588,21.20014,342394
4520,pedrothome1,3,0.00088,72591,21.20101,342394
4521,Phantsure,3,0.00088,72594,21.20189,342394
4522,phho,3,0.00088,72597,21.20277,342394
4523,philipag,3,0.00088,72600,21.20364,342394
4524,PhilippeChepy,3,0.00088,72603,21.20452,342394
4525,phongvu0403,3,0.00088,72606,21.20539,342394
4526,phxgbl,3,0.00088,72609,21.20627,342394
4527,pigbrain,3,0.00088,72612,21.20715,342394
4528,pjastrzabek,3,0.00088,72615,21.20802,342394
4529,playerx,3,0.00088,72618,21.20890,342394
4530,pmv,3,0.00088,72621,21.20978,342394
4531,pocki,3,0.00088,72624,21.21065,342394
4532,poiskail23,3,0.00088,72627,21.21153,342394
4533,powellchristoph,3,0.00088,72630,21.21240,342394
4534,prakashkl88,3,0.00088,72633,21.21328,342394
4535,Pranjal-Gupta2,3,0.00088,72636,21.21416,342394
4536,prashant407,3,0.00088,72639,21.21503,342394
4537,pratikguela,3,0.00088,72642,21.21591,342394
4538,praveenghuge,3,0.00088,72645,21.21679,342394
4539,pravinpushkar,3,0.00088,72648,21.21766,342394
4540,Premfer,3,0.00088,72651,21.21854,342394
4541,projx,3,0.00088,72654,21.21941,342394
4542,pshickeydev,3,0.00088,72657,21.22029,342394
4543,PSHREYASHOLLA,3,0.00088,72660,21.22117,342394
4544,psi-4ward,3,0.00088,72663,21.22204,342394
4545,Pumba98,3,0.00088,72666,21.22292,342394
4546,punitcse,3,0.00088,72669,21.22379,342394
4547,purplegrape,3,0.00088,72672,21.22467,342394
4548,pwschuurman,3,0.00088,72675,21.22555,342394
4549,pxpnetworks,3,0.00088,72678,21.22642,342394
4550,pycgo,3,0.00088,72681,21.22730,342394
4551,pythonwood,3,0.00088,72684,21.22818,342394
4552,qalinn,3,0.00088,72687,21.22905,342394
4553,QiuToo,3,0.00088,72690,21.22993,342394
4554,qixiaoyang0,3,0.00088,72693,21.23080,342394
4555,qqbuby,3,0.00088,72696,21.23168,342394
4556,quaintclever,3,0.00088,72699,21.23256,342394
4557,quaintdev,3,0.00088,72702,21.23343,342394
4558,quartzmo,3,0.00088,72705,21.23431,342394
4559,rabbagliettiandrea,3,0.00088,72708,21.23519,342394
4560,radoslaw-wielonski-lego,3,0.00088,72711,21.23606,342394
4561,rafacouto,3,0.00088,72714,21.23694,342394
4562,raftx24,3,0.00088,72717,21.23781,342394
4563,ragashreeshekar,3,0.00088,72720,21.23869,342394
4564,rajatgupta24,3,0.00088,72723,21.23957,342394
4565,rajyan,3,0.00088,72726,21.24044,342394
4566,RandyLee16,3,0.00088,72729,21.24132,342394
4567,RangaSamudrala,3,0.00088,72732,21.24219,342394
4568,rany2,3,0.00088,72735,21.24307,342394
4569,raphaeljlps,3,0.00088,72738,21.24395,342394
4570,Raptus1,3,0.00088,72741,21.24482,342394
4571,raress96,3,0.00088,72744,21.24570,342394
4572,rayliu419,3,0.00088,72747,21.24658,342394
4573,raz08,3,0.00088,72750,21.24745,342394
4574,raz3k,3,0.00088,72753,21.24833,342394
4575,realAaronWu,3,0.00088,72756,21.24920,342394
4576,realwangyuxiang,3,0.00088,72759,21.25008,342394
4577,reddec,3,0.00088,72762,21.25096,342394
4578,reenakabra,3,0.00088,72765,21.25183,342394
4579,reitermarkus,3,0.00088,72768,21.25271,342394
4580,renatomjr,3,0.00088,72771,21.25359,342394
4581,rendiputra,3,0.00088,72774,21.25446,342394
4582,renhao-0518,3,0.00088,72777,21.25534,342394
4583,repudi8or,3,0.00088,72780,21.25621,342394
4584,restevez-chs,3,0.00088,72783,21.25709,342394
4585,resworld,3,0.00088,72786,21.25797,342394
4586,rfk,3,0.00088,72789,21.25884,342394
4587,richardchen-db,3,0.00088,72792,21.25972,342394
4588,RichardJJG,3,0.00088,72795,21.26059,342394
4589,rigogsilva,3,0.00088,72798,21.26147,342394
4590,riking,3,0.00088,72801,21.26235,342394
4591,riklopfer,3,0.00088,72804,21.26322,342394
4592,rishank69,3,0.00088,72807,21.26410,342394
4593,ritbl,3,0.00088,72810,21.26498,342394
4594,rkapka,3,0.00088,72813,21.26585,342394
4595,R-Lamberson,3,0.00088,72816,21.26673,342394
4596,Rob623,3,0.00088,72819,21.26760,342394
4597,robotica72,3,0.00088,72822,21.26848,342394
4598,robstradling,3,0.00088,72825,21.26936,342394
4599,roguh,3,0.00088,72828,21.27023,342394
4600,rohitsakala,3,0.00088,72831,21.27111,342394
4601,Rojikku,3,0.00088,72834,21.27198,342394
4602,Romain-Geissler-1A,3,0.00088,72837,21.27286,342394
4603,romuduck,3,0.00088,72840,21.27374,342394
4604,roofurmston,3,0.00088,72843,21.27461,342394
4605,rpthms,3,0.00088,72846,21.27549,342394
4606,rquinio1A,3,0.00088,72849,21.27637,342394
4607,rrey,3,0.00088,72852,21.27724,342394
4608,rspier,3,0.00088,72855,21.27812,342394
4609,ruanwenjun,3,0.00088,72858,21.27899,342394
4610,RushilMehra,3,0.00088,72861,21.27987,342394
4611,ryan4yin,3,0.00088,72864,21.28075,342394
4612,ryicoh,3,0.00088,72867,21.28162,342394
4613,ryudwig,3,0.00088,72870,21.28250,342394
4614,s304981561,3,0.00088,72873,21.28338,342394
4615,s4ke,3,0.00088,72876,21.28425,342394
4616,s7an-it,3,0.00088,72879,21.28513,342394
4617,saarbe,3,0.00088,72882,21.28600,342394
4618,SachithKasthuriarachchi,3,0.00088,72885,21.28688,342394
4619,saihide,3,0.00088,72888,21.28776,342394
4620,sajjadgol,3,0.00088,72891,21.28863,342394
4621,samanthawalter,3,0.00088,72894,21.28951,342394
4622,sameshai,3,0.00088,72897,21.29038,342394
4623,sam-jn,3,0.00088,72900,21.29126,342394
4624,Sam-Sundar-Apty,3,0.00088,72903,21.29214,342394
4625,samuelarogbonlo,3,0.00088,72906,21.29301,342394
4626,samuxita,3,0.00088,72909,21.29389,342394
4627,SamyakGangwal,3,0.00088,72912,21.29477,342394
4628,SandyXSD,3,0.00088,72915,21.29564,342394
4629,santschi,3,0.00088,72918,21.29652,342394
4630,sarmst22,3,0.00088,72921,21.29739,342394
4631,sasikala-ks,3,0.00088,72924,21.29827,342394
4632,sa-spag,3,0.00088,72927,21.29915,342394
4633,SatishChandraPalakoti,3,0.00088,72930,21.30002,342394
4634,Sayali1638,3,0.00088,72933,21.30090,342394
4635,saygenie,3,0.00088,72936,21.30178,342394
4636,sbasu123,3,0.00088,72939,21.30265,342394
4637,Schweinepriester,3,0.00088,72942,21.30353,342394
4638,scriptbiggie,3,0.00088,72945,21.30440,342394
4639,sdfordham,3,0.00088,72948,21.30528,342394
4640,sdkim81,3,0.00088,72951,21.30616,342394
4641,Sea-you,3,0.00088,72954,21.30703,342394
4642,SebDanielsson,3,0.00088,72957,21.30791,342394
4643,sefaphlvn,3,0.00088,72960,21.30878,342394
4644,seocam,3,0.00088,72963,21.30966,342394
4645,seonggwonyoon,3,0.00088,72966,21.31054,342394
4646,serewicz,3,0.00088,72969,21.31141,342394
4647,sergelogvinov,3,0.00088,72972,21.31229,342394
4648,serhiinikitenko,3,0.00088,72975,21.31317,342394
4649,servo1x,3,0.00088,72978,21.31404,342394
4650,seveas,3,0.00088,72981,21.31492,342394
4651,shahadc,3,0.00088,72984,21.31579,342394
4652,sharadpattanshetti,3,0.00088,72987,21.31667,342394
4653,sharath-sri-chellappa,3,0.00088,72990,21.31755,342394
4654,sharkztex,3,0.00088,72993,21.31842,342394
4655,shawncao,3,0.00088,72996,21.31930,342394
4656,shcherbak,3,0.00088,72999,21.32018,342394
4657,Shengkai2000,3,0.00088,73002,21.32105,342394
4658,sherwinwangs,3,0.00088,73005,21.32193,342394
4659,shidaying,3,0.00088,73008,21.32280,342394
4660,ShirleyDing,3,0.00088,73011,21.32368,342394
4661,shivakumargowda12,3,0.00088,73014,21.32456,342394
4662,shoekstra,3,0.00088,73017,21.32543,342394
4663,shortsn,3,0.00088,73020,21.32631,342394
4664,Shridhar-2205,3,0.00088,73023,21.32718,342394
4665,shubhindia,3,0.00088,73026,21.32806,342394
4666,shuxnhs,3,0.00088,73029,21.32894,342394
4667,sigix,3,0.00088,73032,21.32981,342394
4668,SilverChard,3,0.00088,73035,21.33069,342394
4669,SimonHarrisonSH,3,0.00088,73038,21.33157,342394
4670,simonpie,3,0.00088,73041,21.33244,342394
4671,sinicis,3,0.00088,73044,21.33332,342394
4672,sipmchimp,3,0.00088,73047,21.33419,342394
4673,sivaandyala765,3,0.00088,73050,21.33507,342394
4674,sjmach,3,0.00088,73053,21.33595,342394
4675,skhalash,3,0.00088,73056,21.33682,342394
4676,skpy,3,0.00088,73059,21.33770,342394
4677,skyduo,3,0.00088,73062,21.33857,342394
4678,skylenet,3,0.00088,73065,21.33945,342394
4679,slankdev,3,0.00088,73068,21.34033,342394
4680,slavitch,3,0.00088,73071,21.34120,342394
4681,sleepyGeek,3,0.00088,73074,21.34208,342394
4682,slott56,3,0.00088,73077,21.34296,342394
4683,SmileCaoJ,3,0.00088,73080,21.34383,342394
4684,smile-fifteen,3,0.00088,73083,21.34471,342394
4685,smsperitus,3,0.00088,73086,21.34558,342394
4686,snowball77,3,0.00088,73089,21.34646,342394
4687,sohailanjum97,3,0.00088,73092,21.34734,342394
4688,somayaj,3,0.00088,73095,21.34821,342394
4689,somera,3,0.00088,73098,21.34909,342394
4690,sonam2905,3,0.00088,73101,21.34997,342394
4691,songzhibin97,3,0.00088,73104,21.35084,342394
4692,sonthonaxrk,3,0.00088,73107,21.35172,342394
4693,soroshsabz,3,0.00088,73110,21.35259,342394
4694,souvikrajsingh,3,0.00088,73113,21.35347,342394
4695,sperahd,3,0.00088,73116,21.35435,342394
4696,splushii,3,0.00088,73119,21.35522,342394
4697,Spongman,3,0.00088,73122,21.35610,342394
4698,sposnjak-cpot,3,0.00088,73125,21.35697,342394
4699,spshuklaji,3,0.00088,73128,21.35785,342394
4700,sredhu37,3,0.00088,73131,21.35873,342394
4701,srteam2020,3,0.00088,73134,21.35960,342394
4702,ssang4,3,0.00088,73137,21.36048,342394
4703,St0rmRage,3,0.00088,73140,21.36136,342394
4704,StefanBratanov,3,0.00088,73143,21.36223,342394
4705,stefanDeveloper,3,0.00088,73146,21.36311,342394
4706,stefanfritsch,3,0.00088,73149,21.36398,342394
4707,steinarox,3,0.00088,73152,21.36486,342394
4708,stephen-dexda,3,0.00088,73155,21.36574,342394
4709,stevo-f3,3,0.00088,73158,21.36661,342394
4710,sttor,3,0.00088,73161,21.36749,342394
4711,subash89,3,0.00088,73164,21.36837,342394
4712,subuk,3,0.00088,73167,21.36924,342394
4713,sudhirkumar05,3,0.00088,73170,21.37012,342394
4714,SuheylZ,3,0.00088,73173,21.37099,342394
4715,su-houzhen,3,0.00088,73176,21.37187,342394
4716,suhyun-baek,3,0.00088,73179,21.37275,342394
4717,suikast42,3,0.00088,73182,21.37362,342394
4718,Sujimoshi,3,0.00088,73185,21.37450,342394
4719,sullerandras,3,0.00088,73188,21.37537,342394
4720,sun7927,3,0.00088,73191,21.37625,342394
4721,sunby,3,0.00088,73194,21.37713,342394
4722,sunpa93,3,0.00088,73197,21.37800,342394
4723,SunRunAway,3,0.00088,73200,21.37888,342394
4724,sunstonesecure-robert,3,0.00088,73203,21.37976,342394
4725,superadri,3,0.00088,73206,21.38063,342394
4726,superkjp,3,0.00088,73209,21.38151,342394
4727,sureshdsk,3,0.00088,73212,21.38238,342394
4728,sushant032,3,0.00088,73215,21.38326,342394
4729,svaranasi-traderev,3,0.00088,73218,21.38414,342394
4730,svonliebenstein,3,0.00088,73221,21.38501,342394
4731,swarnaswaminathan,3,0.00088,73224,21.38589,342394
4732,swartz-k,3,0.00088,73227,21.38676,342394
4733,swgriffith,3,0.00088,73230,21.38764,342394
4734,Syed-Esqimo,3,0.00088,73233,21.38852,342394
4735,SyngoPredevelopment,3,0.00088,73236,21.38939,342394
4736,systemfreund,3,0.00088,73239,21.39027,342394
4737,system-pclub,3,0.00088,73242,21.39115,342394
4738,t2y,3,0.00088,73245,21.39202,342394
4739,t3hmrman,3,0.00088,73248,21.39290,342394
4740,tah-mas,3,0.00088,73251,21.39377,342394
4741,Tahvok,3,0.00088,73254,21.39465,342394
4742,takyon77,3,0.00088,73257,21.39553,342394
4743,taliastocks,3,0.00088,73260,21.39640,342394
4744,tannevaled,3,0.00088,73263,21.39728,342394
4745,taotao365s,3,0.00088,73266,21.39816,342394
4746,Tasmana-banana,3,0.00088,73269,21.39903,342394
4747,tbarker25,3,0.00088,73272,21.39991,342394
4748,tbaumann-sf,3,0.00088,73275,21.40078,342394
4749,tbomberg,3,0.00088,73278,21.40166,342394
4750,tebaly,3,0.00088,73281,21.40254,342394
4751,techburner202,3,0.00088,73284,21.40341,342394
4752,TechnoChimp,3,0.00088,73287,21.40429,342394
4753,teddyballgame,3,0.00088,73290,21.40516,342394
4754,Tejuvmware,3,0.00088,73293,21.40604,342394
4755,tend2infinity,3,0.00088,73296,21.40692,342394
4756,tenglandct,3,0.00088,73299,21.40779,342394
4757,testn,3,0.00088,73302,21.40867,342394
4758,tgeci,3,0.00088,73305,21.40955,342394
4759,tgwizard,3,0.00088,73308,21.41042,342394
4760,Tha-Fox,3,0.00088,73311,21.41130,342394
4761,thanhlong9x,3,0.00088,73314,21.41217,342394
4762,thanhtoan1196,3,0.00088,73317,21.41305,342394
4763,theboyisno-1,3,0.00088,73320,21.41393,342394
4764,thegleb,3,0.00088,73323,21.41480,342394
4765,thehejik,3,0.00088,73326,21.41568,342394
4766,the-iron-pig,3,0.00088,73329,21.41656,342394
4767,thejosephstevens,3,0.00088,73332,21.41743,342394
4768,thepaulmacca,3,0.00088,73335,21.41831,342394
4769,therealak12,3,0.00088,73338,21.41918,342394
4770,thetizzo,3,0.00088,73341,21.42006,342394
4771,theunrepentantgeek,3,0.00088,73344,21.42094,342394
4772,thiagoluiznunes,3,0.00088,73347,21.42181,342394
4773,tholemu,3,0.00088,73350,21.42269,342394
4774,thomasdbaker,3,0.00088,73353,21.42356,342394
4775,thomas-reinhold-de,3,0.00088,73356,21.42444,342394
4776,thoralt,3,0.00088,73359,21.42532,342394
4777,Throckmortra,3,0.00088,73362,21.42619,342394
4778,thspinto,3,0.00088,73365,21.42707,342394
4779,thy00,3,0.00088,73368,21.42795,342394
4780,tianjiaolaozu,3,0.00088,73371,21.42882,342394
4781,tianxin8206,3,0.00088,73374,21.42970,342394
4782,tigerwhhl,3,0.00088,73377,21.43057,342394
4783,tim775,3,0.00088,73380,21.43145,342394
4784,timmc9104,3,0.00088,73383,21.43233,342394
4785,tinrab,3,0.00088,73386,21.43320,342394
4786,titanlien,3,0.00088,73389,21.43408,342394
4787,tiwood,3,0.00088,73392,21.43496,342394
4788,tkohn,3,0.00088,73395,21.43583,342394
4789,tmasciar,3,0.00088,73398,21.43671,342394
4790,tmcalves,3,0.00088,73401,21.43758,342394
4791,tmccombs,3,0.00088,73404,21.43846,342394
4792,tmehlinger,3,0.00088,73407,21.43934,342394
4793,tmm360,3,0.00088,73410,21.44021,342394
4794,tnaroska,3,0.00088,73413,21.44109,342394
4795,todpunk,3,0.00088,73416,21.44196,342394
4796,tohjustin,3,0.00088,73419,21.44284,342394
4797,TomasKohout,3,0.00088,73422,21.44372,342394
4798,tomas-mota,3,0.00088,73425,21.44459,342394
4799,tomas-stary,3,0.00088,73428,21.44547,342394
4800,TomaszPawelecGL,3,0.00088,73431,21.44635,342394
4801,tomereli,3,0.00088,73434,21.44722,342394
4802,tomfeigin,3,0.00088,73437,21.44810,342394
4803,tompsota,3,0.00088,73440,21.44897,342394
4804,torkelrogstad,3,0.00088,73443,21.44985,342394
4805,toshipp,3,0.00088,73446,21.45073,342394
4806,tpott,3,0.00088,73449,21.45160,342394
4807,tqtcloud,3,0.00088,73452,21.45248,342394
4808,travier,3,0.00088,73455,21.45335,342394
4809,TreverW,3,0.00088,73458,21.45423,342394
4810,T-REX-XP,3,0.00088,73461,21.45511,342394
4811,trhumphries,3,0.00088,73464,21.45598,342394
4812,triptesh1212,3,0.00088,73467,21.45686,342394
4813,TroyDota,3,0.00088,73470,21.45774,342394
4814,trust-freedom,3,0.00088,73473,21.45861,342394
4815,tslo-stripe,3,0.00088,73476,21.45949,342394
4816,tstraley,3,0.00088,73479,21.46036,342394
4817,tsybinAndrey,3,0.00088,73482,21.46124,342394
4818,tulsluper,3,0.00088,73485,21.46212,342394
4819,TungstenE2,3,0.00088,73488,21.46299,342394
4820,tvollstaedt,3,0.00088,73491,21.46387,342394
4821,twasyl,3,0.00088,73494,21.46475,342394
4822,tylerferrara,3,0.00088,73497,21.46562,342394
4823,Tyler-ytr,3,0.00088,73500,21.46650,342394
4824,tyzbit,3,0.00088,73503,21.46737,342394
4825,u0u0,3,0.00088,73506,21.46825,342394
4826,UDarya,3,0.00088,73509,21.46913,342394
4827,udhayd,3,0.00088,73512,21.47000,342394
4828,ulrichlisse-f3,3,0.00088,73515,21.47088,342394
4829,unixomg,3,0.00088,73518,21.47175,342394
4830,uripre,3,0.00088,73521,21.47263,342394
4831,urskog84,3,0.00088,73524,21.47351,342394
4832,ustiugov,3,0.00088,73527,21.47438,342394
4833,utamas,3,0.00088,73530,21.47526,342394
4834,v1nc3nt27,3,0.00088,73533,21.47614,342394
4835,vabinav,3,0.00088,73536,21.47701,342394
4836,VaibhavPaliwal0007,3,0.00088,73539,21.47789,342394
4837,valentijnscholten,3,0.00088,73542,21.47876,342394
4838,Varunvallabhan52,3,0.00088,73545,21.47964,342394
4839,vast0906,3,0.00088,73548,21.48052,342394
4840,vasyly71,3,0.00088,73551,21.48139,342394
4841,vbusch,3,0.00088,73554,21.48227,342394
4842,vdymna,3,0.00088,73557,21.48315,342394
4843,venkyvikram,3,0.00088,73560,21.48402,342394
4844,Veres72,3,0.00088,73563,21.48490,342394
4845,vescoc,3,0.00088,73566,21.48577,342394
4846,VF-mbrauer,3,0.00088,73569,21.48665,342394
4847,viceice,3,0.00088,73572,21.48753,342394
4848,vieenodp,3,0.00088,73575,21.48840,342394
4849,vietnguyen1254,3,0.00088,73578,21.48928,342394
4850,vigohe,3,0.00088,73581,21.49015,342394
4851,vimalkansal,3,0.00088,73584,21.49103,342394
4852,vinnyzhaowenyu,3,0.00088,73587,21.49191,342394
4853,virus2016,3,0.00088,73590,21.49278,342394
4854,visortelle,3,0.00088,73593,21.49366,342394
4855,vladmovchan,3,0.00088,73596,21.49454,342394
4856,vlev,3,0.00088,73599,21.49541,342394
4857,vnandha,3,0.00088,73602,21.49629,342394
4858,Volatus,3,0.00088,73605,21.49716,342394
4859,vongosling,3,0.00088,73608,21.49804,342394
4860,vpranckaitis,3,0.00088,73611,21.49892,342394
4861,vshinde727,3,0.00088,73614,21.49979,342394
4862,VSilantyev,3,0.00088,73617,21.50067,342394
4863,vvdaal,3,0.00088,73620,21.50155,342394
4864,wallrick,3,0.00088,73623,21.50242,342394
4865,wangscot092019,3,0.00088,73626,21.50330,342394
4866,warrenrees,3,0.00088,73629,21.50417,342394
4867,wbl,3,0.00088,73632,21.50505,342394
4868,webark,3,0.00088,73635,21.50593,342394
4869,webup,3,0.00088,73638,21.50680,342394
4870,Weidaicheng,3,0.00088,73641,21.50768,342394
4871,WeiTangLau,3,0.00088,73644,21.50855,342394
4872,wenfengwang,3,0.00088,73647,21.50943,342394
4873,weyert,3,0.00088,73650,21.51031,342394
4874,whalecoiner,3,0.00088,73653,21.51118,342394
4875,whitelion-github,3,0.00088,73656,21.51206,342394
4876,wilhelmi,3,0.00088,73659,21.51294,342394
4877,willat8,3,0.00088,73662,21.51381,342394
4878,wimvdc,3,0.00088,73665,21.51469,342394
4879,windowsrefund,3,0.00088,73668,21.51556,342394
4880,wjh791072385,3,0.00088,73671,21.51644,342394
4881,wjkhappy14,3,0.00088,73674,21.51732,342394
4882,wmgroot,3,0.00088,73677,21.51819,342394
4883,woniuzhang,3,0.00088,73680,21.51907,342394
4884,woshizhicainiaoluguo,3,0.00088,73683,21.51994,342394
4885,wshwsh12,3,0.00088,73686,21.52082,342394
4886,wuestkamp,3,0.00088,73689,21.52170,342394
4887,wwhai,3,0.00088,73692,21.52257,342394
4888,wxx213,3,0.00088,73695,21.52345,342394
4889,wymli,3,0.00088,73698,21.52433,342394
4890,wzy109871,3,0.00088,73701,21.52520,342394
4891,xchnshi,3,0.00088,73704,21.52608,342394
4892,xiangtianyu,3,0.00088,73707,21.52695,342394
4893,xiaofan-linux,3,0.00088,73710,21.52783,342394
4894,Xiaosha61,3,0.00088,73713,21.52871,342394
4895,xinfengliu,3,0.00088,73716,21.52958,342394
4896,XinYao1994,3,0.00088,73719,21.53046,342394
4897,xiongyunhua-star,3,0.00088,73722,21.53134,342394
4898,xliangdh,3,0.00088,73725,21.53221,342394
4899,XS170202106505,3,0.00088,73728,21.53309,342394
4900,xubofei1983,3,0.00088,73731,21.53396,342394
4901,xxiaocheng,3,0.00088,73734,21.53484,342394
4902,xyc2019,3,0.00088,73737,21.53572,342394
4903,xzxiaoshan,3,0.00088,73740,21.53659,342394
4904,xzycn,3,0.00088,73743,21.53747,342394
4905,yaakov-berkovitch,3,0.00088,73746,21.53834,342394
4906,YAMLcase,3,0.00088,73749,21.53922,342394
4907,yangfan-njupt,3,0.00088,73752,21.54010,342394
4908,yanggeorge,3,0.00088,73755,21.54097,342394
4909,yanghaojin,3,0.00088,73758,21.54185,342394
4910,yanghuinnn,3,0.00088,73761,21.54273,342394
4911,YanxinTang,3,0.00088,73764,21.54360,342394
4912,yaohui-wyh,3,0.00088,73767,21.54448,342394
4913,yasuraok,3,0.00088,73770,21.54535,342394
4914,yatinmaan,3,0.00088,73773,21.54623,342394
4915,ydFu,3,0.00088,73776,21.54711,342394
4916,yesmarket,3,0.00088,73779,21.54798,342394
4917,yhrn,3,0.00088,73782,21.54886,342394
4918,YibiaoWu,3,0.00088,73785,21.54974,342394
4919,yikyo,3,0.00088,73788,21.55061,342394
4920,yinmin2020,3,0.00088,73791,21.55149,342394
4921,yishuT,3,0.00088,73794,21.55236,342394
4922,ymping,3,0.00088,73797,21.55324,342394
4923,yndai,3,0.00088,73800,21.55412,342394
4924,yobiscus,3,0.00088,73803,21.55499,342394
4925,yogeshkk,3,0.00088,73806,21.55587,342394
4926,YongyuG,3,0.00088,73809,21.55674,342394
4927,yousukseung,3,0.00088,73812,21.55762,342394
4928,youwalther65,3,0.00088,73815,21.55850,342394
4929,yozel,3,0.00088,73818,21.55937,342394
4930,yuancjun,3,0.00088,73821,21.56025,342394
4931,Yuggupta27,3,0.00088,73824,21.56113,342394
4932,yulianedyalkova,3,0.00088,73827,21.56200,342394
4933,YunaBraska,3,0.00088,73830,21.56288,342394
4934,YuranFlow,3,0.00088,73833,21.56375,342394
4935,yuriydzobak,3,0.00088,73836,21.56463,342394
4936,yusank,3,0.00088,73839,21.56551,342394
4937,yusanshui,3,0.00088,73842,21.56638,342394
4938,yuxintong-github,3,0.00088,73845,21.56726,342394
4939,zakimaksyutov,3,0.00088,73848,21.56813,342394
4940,zamog,3,0.00088,73851,21.56901,342394
4941,Zane-XY,3,0.00088,73854,21.56989,342394
4942,zaro,3,0.00088,73857,21.57076,342394
4943,zengzezheng,3,0.00088,73860,21.57164,342394
4944,zeot,3,0.00088,73863,21.57252,342394
4945,Zephirin,3,0.00088,73866,21.57339,342394
4946,zeromake,3,0.00088,73869,21.57427,342394
4947,Zertsov,3,0.00088,73872,21.57514,342394
4948,ZeusPerez,3,0.00088,73875,21.57602,342394
4949,zhang-shengping,3,0.00088,73878,21.57690,342394
4950,zhangshuiyong,3,0.00088,73881,21.57777,342394
4951,zhenghongli,3,0.00088,73884,21.57865,342394
4952,zhenjunMa,3,0.00088,73887,21.57953,342394
4953,zhenyami,3,0.00088,73890,21.58040,342394
4954,zhijian-pro,3,0.00088,73893,21.58128,342394
4955,zhiyong-gayang,3,0.00088,73896,21.58215,342394
4956,zhlsunshine,3,0.00088,73899,21.58303,342394
4957,zhongyiio,3,0.00088,73902,21.58391,342394
4958,zhuxinkai,3,0.00088,73905,21.58478,342394
4959,ZiheLiu,3,0.00088,73908,21.58566,342394
4960,zkutasi,3,0.00088,73911,21.58653,342394
4961,zoeponta,3,0.00088,73914,21.58741,342394
4962,zoncoen,3,0.00088,73917,21.58829,342394
4963,zops,3,0.00088,73920,21.58916,342394
4964,zsq1576154634,3,0.00088,73923,21.59004,342394
4965,zswanson,3,0.00088,73926,21.59092,342394
4966,zwass,3,0.00088,73929,21.59179,342394
4967,zwForrest,3,0.00088,73932,21.59267,342394
4968,zxdvd,3,0.00088,73935,21.59354,342394
4969,zyitingftnt,3,0.00088,73938,21.59442,342394
4970,zzhutianyu,3,0.00088,73941,21.59530,342394
4971,00110110010000010011001101000110,2,0.00058,73943,21.59588,342394
4972,00imvj00,2,0.00058,73945,21.59646,342394
4973,0904-mansi,2,0.00058,73947,21.59705,342394
4974,0dragosh,2,0.00058,73949,21.59763,342394
4975,0x0badc0de,2,0.00058,73951,21.59822,342394
4976,1180300515,2,0.00058,73953,21.59880,342394
4977,12monkey12,2,0.00058,73955,21.59939,342394
4978,431500288,2,0.00058,73957,21.59997,342394
4979,4fd81048-Brian,2,0.00058,73959,21.60055,342394
4980,5279314,2,0.00058,73961,21.60114,342394
4981,5kr1p7,2,0.00058,73963,21.60172,342394
4982,5u9,2,0.00058,73965,21.60231,342394
4983,631068264,2,0.00058,73967,21.60289,342394
4984,6543,2,0.00058,73969,21.60347,342394
4985,654894017,2,0.00058,73971,21.60406,342394
4986,76creates,2,0.00058,73973,21.60464,342394
4987,7olstoy,2,0.00058,73975,21.60523,342394
4988,7yyo,2,0.00058,73977,21.60581,342394
4989,90lantran,2,0.00058,73979,21.60639,342394
4990,943692923,2,0.00058,73981,21.60698,342394
4991,9renpoto,2,0.00058,73983,21.60756,342394
4992,a116555,2,0.00058,73985,21.60815,342394
4993,aaabdallah,2,0.00058,73987,21.60873,342394
4994,aabri-g4m,2,0.00058,73989,21.60932,342394
4995,aakifshaikh,2,0.00058,73991,21.60990,342394
4996,aamirqs,2,0.00058,73993,21.61048,342394
4997,aangoulvant,2,0.00058,73995,21.61107,342394
4998,ab93,2,0.00058,73997,21.61165,342394
4999,abashmak2,2,0.00058,73999,21.61224,342394
5000,abhi1693,2,0.00058,74001,21.61282,342394
5001,abhibhaw,2,0.00058,74003,21.61340,342394
5002,abhinavmpandey08,2,0.00058,74005,21.61399,342394
5003,abhi-vaidya,2,0.00058,74007,21.61457,342394
5004,abhivaidya07,2,0.00058,74009,21.61516,342394
5005,abin-tiger,2,0.00058,74011,21.61574,342394
5006,able8,2,0.00058,74013,21.61633,342394
5007,ably77,2,0.00058,74015,21.61691,342394
5008,aboyum,2,0.00058,74017,21.61749,342394
5009,abraverm,2,0.00058,74019,21.61808,342394
5010,absmith82,2,0.00058,74021,21.61866,342394
5011,acechef,2,0.00058,74023,21.61925,342394
5012,Acepie,2,0.00058,74025,21.61983,342394
5013,achebel,2,0.00058,74027,21.62041,342394
5014,Acidic9,2,0.00058,74029,21.62100,342394
5015,ACK-lcn,2,0.00058,74031,21.62158,342394
5016,acoates-ms,2,0.00058,74033,21.62217,342394
5017,acruise,2,0.00058,74035,21.62275,342394
5018,adamatan,2,0.00058,74037,21.62333,342394
5019,adamcharnock,2,0.00058,74039,21.62392,342394
5020,adamkovalsky,2,0.00058,74041,21.62450,342394
5021,adamwithit,2,0.00058,74043,21.62509,342394
5022,adaoud-ims,2,0.00058,74045,21.62567,342394
5023,adawalli,2,0.00058,74047,21.62626,342394
5024,adoyle-h,2,0.00058,74049,21.62684,342394
5025,adrianbjordan,2,0.00058,74051,21.62742,342394
5026,adrianjgeorge,2,0.00058,74053,21.62801,342394
5027,adrianke77,2,0.00058,74055,21.62859,342394
5028,adriannieto-attechnest,2,0.00058,74057,21.62918,342394
5029,adyanth,2,0.00058,74059,21.62976,342394
5030,afzal442,2,0.00058,74061,21.63034,342394
5031,ahamez,2,0.00058,74063,21.63093,342394
5032,ahmedalnuaimi,2,0.00058,74065,21.63151,342394
5033,ahmetcetin,2,0.00058,74067,21.63210,342394
5034,aibarbetta,2,0.00058,74069,21.63268,342394
5035,aido123,2,0.00058,74071,21.63326,342394
5036,AIElemental,2,0.00058,74073,21.63385,342394
5037,aikin-vip,2,0.00058,74075,21.63443,342394
5038,ai-roboter-1,2,0.00058,74077,21.63502,342394
5039,ajinkya359,2,0.00058,74079,21.63560,342394
5040,akhilmukkara,2,0.00058,74081,21.63619,342394
5041,akiragg,2,0.00058,74083,21.63677,342394
5042,Akitata,2,0.00058,74085,21.63735,342394
5043,akomakom,2,0.00058,74087,21.63794,342394
5044,ak-secops,2,0.00058,74089,21.63852,342394
5045,akshayrdeodhar,2,0.00058,74091,21.63911,342394
5046,alamont,2,0.00058,74093,21.63969,342394
5047,alan994,2,0.00058,74095,21.64027,342394
5048,alanpyliu,2,0.00058,74097,21.64086,342394
5049,alanssitis,2,0.00058,74099,21.64144,342394
5050,Albelt,2,0.00058,74101,21.64203,342394
5051,albertforweb,2,0.00058,74103,21.64261,342394
5052,albertyfwu,2,0.00058,74105,21.64319,342394
5053,Ale0x78,2,0.00058,74107,21.64378,342394
5054,alecerf,2,0.00058,74109,21.64436,342394
5055,alegrey91,2,0.00058,74111,21.64495,342394
5056,alelerac,2,0.00058,74113,21.64553,342394
5057,alephpt,2,0.00058,74115,21.64612,342394
5058,alespour,2,0.00058,74117,21.64670,342394
5059,Alestrix,2,0.00058,74119,21.64728,342394
5060,alex60217101990,2,0.00058,74121,21.64787,342394
5061,alexanderdalloz,2,0.00058,74123,21.64845,342394
5062,alexandresgf,2,0.00058,74125,21.64904,342394
5063,alexfanat86,2,0.00058,74127,21.64962,342394
5064,alexfornuto,2,0.00058,74129,21.65020,342394
5065,alexforster,2,0.00058,74131,21.65079,342394
5066,AlexisDuf,2,0.00058,74133,21.65137,342394
5067,alex-raoul,2,0.00058,74135,21.65196,342394
5068,AlexSolorio,2,0.00058,74137,21.65254,342394
5069,alfredomagallon,2,0.00058,74139,21.65312,342394
5070,Alfusainey,2,0.00058,74141,21.65371,342394
5071,al-hujaylan,2,0.00058,74143,21.65429,342394
5072,alias-dev,2,0.00058,74145,21.65488,342394
5073,aligabres,2,0.00058,74147,21.65546,342394
5074,alinalex1392,2,0.00058,74149,21.65605,342394
5075,alldoami,2,0.00058,74151,21.65663,342394
5076,allen-mun,2,0.00058,74153,21.65721,342394
5077,allisonmacmillan,2,0.00058,74155,21.65780,342394
5078,allisono,2,0.00058,74157,21.65838,342394
5079,alloran,2,0.00058,74159,21.65897,342394
5080,Alok77pandey,2,0.00058,74161,21.65955,342394
5081,AloysAugustin,2,0.00058,74163,21.66013,342394
5082,alphabet5,2,0.00058,74165,21.66072,342394
5083,altitudems,2,0.00058,74167,21.66130,342394
5084,alvarovn,2,0.00058,74169,21.66189,342394
5085,alvinhom,2,0.00058,74171,21.66247,342394
5086,amantur,2,0.00058,74173,21.66305,342394
5087,amarkevich,2,0.00058,74175,21.66364,342394
5088,amazdeusz,2,0.00058,74177,21.66422,342394
5089,amengpp,2,0.00058,74179,21.66481,342394
5090,amh23,2,0.00058,74181,21.66539,342394
5091,amino19,2,0.00058,74183,21.66598,342394
5092,aminvakil,2,0.00058,74185,21.66656,342394
5093,amiramw,2,0.00058,74187,21.66714,342394
5094,AmiteshDTU,2,0.00058,74189,21.66773,342394
5095,amitnjha,2,0.00058,74191,21.66831,342394
5096,amniskin,2,0.00058,74193,21.66890,342394
5097,amtisyAts,2,0.00058,74195,21.66948,342394
5098,anaclaudiar,2,0.00058,74197,21.67006,342394
5099,AnavMahajan,2,0.00058,74199,21.67065,342394
5100,Anders-PlanetScale,2,0.00058,74201,21.67123,342394
5101,anders-swanson,2,0.00058,74203,21.67182,342394
5102,andiolsi,2,0.00058,74205,21.67240,342394
5103,andreabonanno,2,0.00058,74207,21.67298,342394
5104,andreasdj,2,0.00058,74209,21.67357,342394
5105,AndreasSko,2,0.00058,74211,21.67415,342394
5106,Andre-Atkinson,2,0.00058,74213,21.67474,342394
5107,andrein,2,0.00058,74215,21.67532,342394
5108,andrewipmtl,2,0.00058,74217,21.67591,342394
5109,andrewm-aero,2,0.00058,74219,21.67649,342394
5110,AndreyGeleta,2,0.00058,74221,21.67707,342394
5111,AndreyMaslovN,2,0.00058,74223,21.67766,342394
5112,andria21,2,0.00058,74225,21.67824,342394
5113,andyyumiao,2,0.00058,74227,21.67883,342394
5114,anfredette,2,0.00058,74229,21.67941,342394
5115,anisorigin,2,0.00058,74231,21.67999,342394
5116,ankitLiv,2,0.00058,74233,21.68058,342394
5117,anmoel,2,0.00058,74235,21.68116,342394
5118,annabokhan,2,0.00058,74237,21.68175,342394
5119,anniefu,2,0.00058,74239,21.68233,342394
5120,annkam,2,0.00058,74241,21.68292,342394
5121,anthonyrisinger,2,0.00058,74243,21.68350,342394
5122,antmordel,2,0.00058,74245,21.68408,342394
5123,antoinebourayne,2,0.00058,74247,21.68467,342394
5124,antoinep92,2,0.00058,74249,21.68525,342394
5125,antonmry,2,0.00058,74251,21.68584,342394
5126,anudeepsada23,2,0.00058,74253,21.68642,342394
5127,anupamdalmia10,2,0.00058,74255,21.68700,342394
5128,anupriya17,2,0.00058,74257,21.68759,342394
5129,aperepel,2,0.00058,74259,21.68817,342394
5130,apinter,2,0.00058,74261,21.68876,342394
5131,apollo13,2,0.00058,74263,21.68934,342394
5132,AppSentinel,2,0.00058,74265,21.68992,342394
5133,apricote,2,0.00058,74267,21.69051,342394
5134,Arashrohani,2,0.00058,74269,21.69109,342394
5135,areiter,2,0.00058,74271,21.69168,342394
5136,Arian-D,2,0.00058,74273,21.69226,342394
5137,ariary,2,0.00058,74275,21.69285,342394
5138,Arios-29,2,0.00058,74277,21.69343,342394
5139,arizanovj,2,0.00058,74279,21.69401,342394
5140,arkoste,2,0.00058,74281,21.69460,342394
5141,armanzor,2,0.00058,74283,21.69518,342394
5142,ArminShoeibi,2,0.00058,74285,21.69577,342394
5143,arnoldyahad,2,0.00058,74287,21.69635,342394
5144,aro5000,2,0.00058,74289,21.69693,342394
5145,arpantw,2,0.00058,74291,21.69752,342394
5146,arshbot,2,0.00058,74293,21.69810,342394
5147,arsheelsheikh,2,0.00058,74295,21.69869,342394
5148,artemix9,2,0.00058,74297,21.69927,342394
5149,artyom-p,2,0.00058,74299,21.69985,342394
5150,ArveSystad,2,0.00058,74301,21.70044,342394
5151,aryabchenko,2,0.00058,74303,21.70102,342394
5152,as42sl,2,0.00058,74305,21.70161,342394
5153,asafm,2,0.00058,74307,21.70219,342394
5154,asaha123,2,0.00058,74309,21.70278,342394
5155,ashinrot,2,0.00058,74311,21.70336,342394
5156,Ashley-wenyizha,2,0.00058,74313,21.70394,342394
5157,aslamkhan-dremio,2,0.00058,74315,21.70453,342394
5158,aszac,2,0.00058,74317,21.70511,342394
5159,atarax,2,0.00058,74319,21.70570,342394
5160,athomas,2,0.00058,74321,21.70628,342394
5161,atzawada,2,0.00058,74323,21.70686,342394
5162,austonpramodh,2,0.00058,74325,21.70745,342394
5163,Aut0R3V,2,0.00058,74327,21.70803,342394
5164,autiarii,2,0.00058,74329,21.70862,342394
5165,averni,2,0.00058,74331,21.70920,342394
5166,avinovarov,2,0.00058,74333,21.70978,342394
5167,avirekghatia,2,0.00058,74335,21.71037,342394
5168,avivgold098,2,0.00058,74337,21.71095,342394
5169,Awot83,2,0.00058,74339,21.71154,342394
5170,axelczk,2,0.00058,74341,21.71212,342394
5171,ayanmw,2,0.00058,74343,21.71271,342394
5172,ayetkin,2,0.00058,74345,21.71329,342394
5173,ayhaadam,2,0.00058,74347,21.71387,342394
5174,ayu-programer,2,0.00058,74349,21.71446,342394
5175,azasa,2,0.00058,74351,21.71504,342394
5176,azizzoaib786,2,0.00058,74353,21.71563,342394
5177,azman0101,2,0.00058,74355,21.71621,342394
5178,AzSiAz,2,0.00058,74357,21.71679,342394
5179,aztechian,2,0.00058,74359,21.71738,342394
5180,B8kingS0ga,2,0.00058,74361,21.71796,342394
5181,ba1ajinaidu,2,0.00058,74363,21.71855,342394
5182,backtrackshubham,2,0.00058,74365,21.71913,342394
5183,baechul-k,2,0.00058,74367,21.71971,342394
5184,bakaibalazs,2,0.00058,74369,21.72030,342394
5185,Baklap4,2,0.00058,74371,21.72088,342394
5186,balasu,2,0.00058,74373,21.72147,342394
5187,banicr,2,0.00058,74375,21.72205,342394
5188,barrricade,2,0.00058,74377,21.72264,342394
5189,basefas,2,0.00058,74379,21.72322,342394
5190,bastienbarthet,2,0.00058,74381,21.72380,342394
5191,batleforc,2,0.00058,74383,21.72439,342394
5192,bbecomp99,2,0.00058,74385,21.72497,342394
5193,bbhenry,2,0.00058,74387,21.72556,342394
5194,bboshiZ,2,0.00058,74389,21.72614,342394
5195,bbqrob,2,0.00058,74391,21.72672,342394
5196,bbugh,2,0.00058,74393,21.72731,342394
5197,bcastilho90,2,0.00058,74395,21.72789,342394
5198,bdarfler,2,0.00058,74397,21.72848,342394
5199,bdols,2,0.00058,74399,21.72906,342394
5200,beba85,2,0.00058,74401,21.72964,342394
5201,Belyenochi,2,0.00058,74403,21.73023,342394
5202,bender316,2,0.00058,74405,21.73081,342394
5203,benignbala,2,0.00058,74407,21.73140,342394
5204,benjamg,2,0.00058,74409,21.73198,342394
5205,benjyiw,2,0.00058,74411,21.73257,342394
5206,bennysp,2,0.00058,74413,21.73315,342394
5207,BenoitKnecht,2,0.00058,74415,21.73373,342394
5208,benregn,2,0.00058,74417,21.73432,342394
5209,benukhanov,2,0.00058,74419,21.73490,342394
5210,ben-wallis,2,0.00058,74421,21.73549,342394
5211,BenWolstencroft,2,0.00058,74423,21.73607,342394
5212,benzch,2,0.00058,74425,21.73665,342394
5213,bert-huang,2,0.00058,74427,21.73724,342394
5214,Berveglieri,2,0.00058,74429,21.73782,342394
5215,bestgaurav,2,0.00058,74431,21.73841,342394
5216,bestjane,2,0.00058,74433,21.73899,342394
5217,BetimBeja,2,0.00058,74435,21.73957,342394
5218,betoui,2,0.00058,74437,21.74016,342394
5219,beyondbill,2,0.00058,74439,21.74074,342394
5220,BeZamorano,2,0.00058,74441,21.74133,342394
5221,bguzman-3pillar,2,0.00058,74443,21.74191,342394
5222,bhumijgupta,2,0.00058,74445,21.74250,342394
5223,bhupenderS012,2,0.00058,74447,21.74308,342394
5224,BigFishLi,2,0.00058,74449,21.74366,342394
5225,BigYopy,2,0.00058,74451,21.74425,342394
5226,Bijayesh,2,0.00058,74453,21.74483,342394
5227,bilal-dandara,2,0.00058,74455,21.74542,342394
5228,Billa05,2,0.00058,74457,21.74600,342394
5229,binaryoak,2,0.00058,74459,21.74658,342394
5230,bishtsaurabh5,2,0.00058,74461,21.74717,342394
5231,bitfactory-sem-denbroeder,2,0.00058,74463,21.74775,342394
5232,bitnik,2,0.00058,74465,21.74834,342394
5233,bitti,2,0.00058,74467,21.74892,342394
5234,bitTobiasMeier,2,0.00058,74469,21.74950,342394
5235,bjthomas1,2,0.00058,74471,21.75009,342394
5236,BK-STAR77,2,0.00058,74473,21.75067,342394
5237,blackandred,2,0.00058,74475,21.75126,342394
5238,blastik,2,0.00058,74477,21.75184,342394
5239,blastshielddown,2,0.00058,74479,21.75243,342394
5240,b-long,2,0.00058,74481,21.75301,342394
5241,blueice123,2,0.00058,74483,21.75359,342394
5242,bluemiaomiao,2,0.00058,74485,21.75418,342394
5243,bLuka,2,0.00058,74487,21.75476,342394
5244,bmaguilar,2,0.00058,74489,21.75535,342394
5245,bmgdc,2,0.00058,74491,21.75593,342394
5246,bo0ts,2,0.00058,74493,21.75651,342394
5247,bocc,2,0.00058,74495,21.75710,342394
5248,boldandbusted,2,0.00058,74497,21.75768,342394
5249,bortek,2,0.00058,74499,21.75827,342394
5250,br95187,2,0.00058,74501,21.75885,342394
5251,bradbeck,2,0.00058,74503,21.75944,342394
5252,bradkwadsworth-mw,2,0.00058,74505,21.76002,342394
5253,bradtgmurray,2,0.00058,74507,21.76060,342394
5254,branchvincent,2,0.00058,74509,21.76119,342394
5255,BrandonWeng,2,0.00058,74511,21.76177,342394
5256,breaksilence,2,0.00058,74513,21.76236,342394
5257,breuerfelix,2,0.00058,74515,21.76294,342394
5258,brian-at-epic,2,0.00058,74517,21.76352,342394
5259,briandefiant,2,0.00058,74519,21.76411,342394
5260,brianehlert,2,0.00058,74521,21.76469,342394
5261,BrianHicks,2,0.00058,74523,21.76528,342394
5262,briano-addepar,2,0.00058,74525,21.76586,342394
5263,britoaldan,2,0.00058,74527,21.76644,342394
5264,brodock,2,0.00058,74529,21.76703,342394
5265,brross,2,0.00058,74531,21.76761,342394
5266,brucelwl,2,0.00058,74533,21.76820,342394
5267,brunobevilaqua,2,0.00058,74535,21.76878,342394
5268,bryanwux,2,0.00058,74537,21.76937,342394
5269,bryce-od,2,0.00058,74539,21.76995,342394
5270,bsinggh,2,0.00058,74541,21.77053,342394
5271,bstrdsmkr,2,0.00058,74543,21.77112,342394
5272,btsuhako,2,0.00058,74545,21.77170,342394
5273,bu3,2,0.00058,74547,21.77229,342394
5274,buptubuntu,2,0.00058,74549,21.77287,342394
5275,burakkalafat,2,0.00058,74551,21.77345,342394
5276,byhang,2,0.00058,74553,21.77404,342394
5277,byumov,2,0.00058,74555,21.77462,342394
5278,c3-danmerino,2,0.00058,74557,21.77521,342394
5279,caddac,2,0.00058,74559,21.77579,342394
5280,calebmchenry,2,0.00058,74561,21.77637,342394
5281,caleygoff-invitae,2,0.00058,74563,21.77696,342394
5282,callum-p,2,0.00058,74565,21.77754,342394
5283,camabeh,2,0.00058,74567,21.77813,342394
5284,camo-f,2,0.00058,74569,21.77871,342394
5285,Capable-Disk4147,2,0.00058,74571,21.77930,342394
5286,captain-wolf,2,0.00058,74573,21.77988,342394
5287,carlanton,2,0.00058,74575,21.78046,342394
5288,carlcauchi,2,0.00058,74577,21.78105,342394
5289,Carles-Figuerola,2,0.00058,74579,21.78163,342394
5290,carloscutover,2,0.00058,74581,21.78222,342394
5291,Carolynconroy76,2,0.00058,74583,21.78280,342394
5292,Castaglia,2,0.00058,74585,21.78338,342394
5293,cbrake,2,0.00058,74587,21.78397,342394
5294,ccfishk,2,0.00058,74589,21.78455,342394
5295,ccodreanu,2,0.00058,74591,21.78514,342394
5296,cd06b9,2,0.00058,74593,21.78572,342394
5297,cdalvaro,2,0.00058,74595,21.78630,342394
5298,cdivita,2,0.00058,74597,21.78689,342394
5299,Cenisar-Villanueva,2,0.00058,74599,21.78747,342394
5300,cesarmesones,2,0.00058,74601,21.78806,342394
5301,cguermi,2,0.00058,74603,21.78864,342394
5302,chacmool,2,0.00058,74605,21.78923,342394
5303,chamilzr,2,0.00058,74607,21.78981,342394
5304,changbaihe,2,0.00058,74609,21.79039,342394
5305,changwoo-nam,2,0.00058,74611,21.79098,342394
5306,channelbeta,2,0.00058,74613,21.79156,342394
5307,chaosbox,2,0.00058,74615,21.79215,342394
5308,chaospuppy,2,0.00058,74617,21.79273,342394
5309,charbonnierg,2,0.00058,74619,21.79331,342394
5310,charlesoconor,2,0.00058,74621,21.79390,342394
5311,Chathuru,2,0.00058,74623,21.79448,342394
5312,chelomontilla,2,0.00058,74625,21.79507,342394
5313,chendapeng1984,2,0.00058,74627,21.79565,342394
5314,chengkuangan,2,0.00058,74629,21.79623,342394
5315,chengtae,2,0.00058,74631,21.79682,342394
5316,chenhong0129,2,0.00058,74633,21.79740,342394
5317,chenjiazhix,2,0.00058,74635,21.79799,342394
5318,chesnovsky,2,0.00058,74637,21.79857,342394
5319,chibbert,2,0.00058,74639,21.79916,342394
5320,chickenbeef,2,0.00058,74641,21.79974,342394
5321,ching08,2,0.00058,74643,21.80032,342394
5322,chinmaygupta28,2,0.00058,74645,21.80091,342394
5323,chiselko6,2,0.00058,74647,21.80149,342394
5324,chitoku-k,2,0.00058,74649,21.80208,342394
5325,chris922,2,0.00058,74651,21.80266,342394
5326,chrispytoes,2,0.00058,74653,21.80324,342394
5327,chrisse74,2,0.00058,74655,21.80383,342394
5328,ChristianTrolleMikkelsen,2,0.00058,74657,21.80441,342394
5329,ChuchoCoder,2,0.00058,74659,21.80500,342394
5330,chuegel,2,0.00058,74661,21.80558,342394
5331,chuyuou,2,0.00058,74663,21.80616,342394
5332,ciencia,2,0.00058,74665,21.80675,342394
5333,ciiiii,2,0.00058,74667,21.80733,342394
5334,ckgmg,2,0.00058,74669,21.80792,342394
5335,ckittel,2,0.00058,74671,21.80850,342394
5336,claudex,2,0.00058,74673,21.80909,342394
5337,clayg,2,0.00058,74675,21.80967,342394
5338,cleverlzc,2,0.00058,74677,21.81025,342394
5339,clly,2,0.00058,74679,21.81084,342394
5340,CloudXiaobai,2,0.00058,74681,21.81142,342394
5341,clouedoc,2,0.00058,74683,21.81201,342394
5342,Cluas,2,0.00058,74685,21.81259,342394
5343,cnchef,2,0.00058,74687,21.81317,342394
5344,coderigo,2,0.00058,74689,21.81376,342394
5345,codesiddhant,2,0.00058,74691,21.81434,342394
5346,cojack,2,0.00058,74693,21.81493,342394
5347,Cole-GG,2,0.00058,74695,21.81551,342394
5348,Connlp,2,0.00058,74697,21.81609,342394
5349,conqerAtapple,2,0.00058,74699,21.81668,342394
5350,conradcreel,2,0.00058,74701,21.81726,342394
5351,CooperBills,2,0.00058,74703,21.81785,342394
5352,coopwilliams,2,0.00058,74705,21.81843,342394
5353,cornfeedhobo,2,0.00058,74707,21.81902,342394
5354,cosmin19,2,0.00058,74709,21.81960,342394
5355,Cougar,2,0.00058,74711,21.82018,342394
5356,cpiotr,2,0.00058,74713,21.82077,342394
5357,CQUPTYHM,2,0.00058,74715,21.82135,342394
5358,cramakan,2,0.00058,74717,21.82194,342394
5359,Crazybus,2,0.00058,74719,21.82252,342394
5360,crb-66,2,0.00058,74721,21.82310,342394
5361,crd1985,2,0.00058,74723,21.82369,342394
5362,crisp2u,2,0.00058,74725,21.82427,342394
5363,cristiboariu,2,0.00058,74727,21.82486,342394
5364,crocinsocks,2,0.00058,74729,21.82544,342394
5365,crybabykillzz,2,0.00058,74731,21.82602,342394
5366,cschmittiey,2,0.00058,74733,21.82661,342394
5367,cssp007,2,0.00058,74735,21.82719,342394
5368,cszixin,2,0.00058,74737,21.82778,342394
5369,ctalledo,2,0.00058,74739,21.82836,342394
5370,Cuball0,2,0.00058,74741,21.82895,342394
5371,cunnie,2,0.00058,74743,21.82953,342394
5372,curiousleo,2,0.00058,74745,21.83011,342394
5373,Cyb3r-Jak3,2,0.00058,74747,21.83070,342394
5374,czqrny,2,0.00058,74749,21.83128,342394
5375,dabo-ZON,2,0.00058,74751,21.83187,342394
5376,dadan2019,2,0.00058,74753,21.83245,342394
5377,daesma,2,0.00058,74755,21.83303,342394
5378,dagan,2,0.00058,74757,21.83362,342394
5379,daleiz,2,0.00058,74759,21.83420,342394
5380,damian-natzka,2,0.00058,74761,21.83479,342394
5381,damoon,2,0.00058,74763,21.83537,342394
5382,damyan,2,0.00058,74765,21.83596,342394
5383,DanailPenev,2,0.00058,74767,21.83654,342394
5384,dandotimujahid,2,0.00058,74769,21.83712,342394
5385,danielgblanco,2,0.00058,74771,21.83771,342394
5386,danielortizlira,2,0.00058,74773,21.83829,342394
5387,DanielRussell,2,0.00058,74775,21.83888,342394
5388,danielsamet,2,0.00058,74777,21.83946,342394
5389,daniel-southwardellis,2,0.00058,74779,21.84004,342394
5390,DanielTibbing,2,0.00058,74781,21.84063,342394
5391,danielzhanghl,2,0.00058,74783,21.84121,342394
5392,danilobatistaqueiroz,2,0.00058,74785,21.84180,342394
5393,danilsmirnov,2,0.00058,74787,21.84238,342394
5394,danoliver1,2,0.00058,74789,21.84296,342394
5395,danshapir,2,0.00058,74791,21.84355,342394
5396,danufr,2,0.00058,74793,21.84413,342394
5397,DanWard,2,0.00058,74795,21.84472,342394
5398,Danybzh,2,0.00058,74797,21.84530,342394
5399,darintay,2,0.00058,74799,21.84589,342394
5400,darkweaver87,2,0.00058,74801,21.84647,342394
5401,darrenparkinson,2,0.00058,74803,21.84705,342394
5402,Daryljocky,2,0.00058,74805,21.84764,342394
5403,dasu23,2,0.00058,74807,21.84822,342394
5404,datton94,2,0.00058,74809,21.84881,342394
5405,davehamer,2,0.00058,74811,21.84939,342394
5406,davemann-mgl,2,0.00058,74813,21.84997,342394
5407,DaveWelling,2,0.00058,74815,21.85056,342394
5408,davewongillies,2,0.00058,74817,21.85114,342394
5409,david-2000,2,0.00058,74819,21.85173,342394
5410,david-caro,2,0.00058,74821,21.85231,342394
5411,davidcarrera,2,0.00058,74823,21.85289,342394
5412,David-Collins,2,0.00058,74825,21.85348,342394
5413,daviderli614,2,0.00058,74827,21.85406,342394
5414,davideshay,2,0.00058,74829,21.85465,342394
5415,davidlm228,2,0.00058,74831,21.85523,342394
5416,davidmarne-wf,2,0.00058,74833,21.85582,342394
5417,David-Tamrazov,2,0.00058,74835,21.85640,342394
5418,david-woakes-n-able,2,0.00058,74837,21.85698,342394
5419,davisgomes,2,0.00058,74839,21.85757,342394
5420,davydog187,2,0.00058,74841,21.85815,342394
5421,DCjanus,2,0.00058,74843,21.85874,342394
5422,dd00f,2,0.00058,74845,21.85932,342394
5423,ddanijel,2,0.00058,74847,21.85990,342394
5424,ddurham2,2,0.00058,74849,21.86049,342394
5425,debarshibasak,2,0.00058,74851,21.86107,342394
5426,DeciderWill,2,0.00058,74853,21.86166,342394
5427,deeco,2,0.00058,74855,21.86224,342394
5428,deepanverma19,2,0.00058,74857,21.86282,342394
5429,defenestration,2,0.00058,74859,21.86341,342394
5430,defreng,2,0.00058,74861,21.86399,342394
5431,dejwsz,2,0.00058,74863,21.86458,342394
5432,denis111,2,0.00058,74865,21.86516,342394
5433,desek,2,0.00058,74867,21.86575,342394
5434,desolatorpk,2,0.00058,74869,21.86633,342394
5435,desy83,2,0.00058,74871,21.86691,342394
5436,devmattrick,2,0.00058,74873,21.86750,342394
5437,devopstoday11,2,0.00058,74875,21.86808,342394
5438,DevRockstarZ,2,0.00058,74877,21.86867,342394
5439,DeyunLuo,2,0.00058,74879,21.86925,342394
5440,DG-Wangtao,2,0.00058,74881,21.86983,342394
5441,dharma66,2,0.00058,74883,21.87042,342394
5442,dharmendrakariya,2,0.00058,74885,21.87100,342394
5443,dhineshbabuelango,2,0.00058,74887,21.87159,342394
5444,dhruvaldarji,2,0.00058,74889,21.87217,342394
5445,dianny123,2,0.00058,74891,21.87275,342394
5446,diazGT94,2,0.00058,74893,21.87334,342394
5447,diegoep,2,0.00058,74895,21.87392,342394
5448,digihunch,2,0.00058,74897,21.87451,342394
5449,dihmuzikien,2,0.00058,74899,21.87509,342394
5450,dinilimento,2,0.00058,74901,21.87568,342394
5451,dinvlad,2,0.00058,74903,21.87626,342394
5452,diumonds,2,0.00058,74905,21.87684,342394
5453,dkwdjq,2,0.00058,74907,21.87743,342394
5454,dlh,2,0.00058,74909,21.87801,342394
5455,dllegru,2,0.00058,74911,21.87860,342394
5456,dlouks,2,0.00058,74913,21.87918,342394
5457,dm0610,2,0.00058,74915,21.87976,342394
5458,dmitriyr333,2,0.00058,74917,21.88035,342394
5459,dmitry-makarenko-gelato,2,0.00058,74919,21.88093,342394
5460,Dmitry-Nikishov,2,0.00058,74921,21.88152,342394
5461,dmitrywi,2,0.00058,74923,21.88210,342394
5462,doc-olliday,2,0.00058,74925,21.88268,342394
5463,doddgu,2,0.00058,74927,21.88327,342394
5464,dodoao,2,0.00058,74929,21.88385,342394
5465,domainname,2,0.00058,74931,21.88444,342394
5466,domderen,2,0.00058,74933,21.88502,342394
5467,dominhhai,2,0.00058,74935,21.88561,342394
5468,dominikmeyersap,2,0.00058,74937,21.88619,342394
5469,domruf,2,0.00058,74939,21.88677,342394
5470,donalddewulf,2,0.00058,74941,21.88736,342394
5471,donaldoakes,2,0.00058,74943,21.88794,342394
5472,dongzl,2,0.00058,74945,21.88853,342394
5473,doreilly257,2,0.00058,74947,21.88911,342394
5474,doriandekoning,2,0.00058,74949,21.88969,342394
5475,Doron-Bargo,2,0.00058,74951,21.89028,342394
5476,dotiiiian,2,0.00058,74953,21.89086,342394
5477,DouglasLopez,2,0.00058,74955,21.89145,342394
5478,DougTrajano,2,0.00058,74957,21.89203,342394
5479,dpauls,2,0.00058,74959,21.89261,342394
5480,dpk83,2,0.00058,74961,21.89320,342394
5481,DPS0340,2,0.00058,74963,21.89378,342394
5482,dragonly,2,0.00058,74965,21.89437,342394
5483,DrCapt,2,0.00058,74967,21.89495,342394
5484,drduke1,2,0.00058,74969,21.89554,342394
5485,drisaro,2,0.00058,74971,21.89612,342394
5486,driverpt,2,0.00058,74973,21.89670,342394
5487,drrrMikado,2,0.00058,74975,21.89729,342394
5488,Drsuperman,2,0.00058,74977,21.89787,342394
5489,dschunack,2,0.00058,74979,21.89846,342394
5490,dseravalli,2,0.00058,74981,21.89904,342394
5491,dsidirop,2,0.00058,74983,21.89962,342394
5492,dsogari,2,0.00058,74985,21.90021,342394
5493,dtest11,2,0.00058,74987,21.90079,342394
5494,dtnyn,2,0.00058,74989,21.90138,342394
5495,duanhongyi,2,0.00058,74991,21.90196,342394
5496,dudarau,2,0.00058,74993,21.90255,342394
5497,dudutwizer,2,0.00058,74995,21.90313,342394
5498,duhow,2,0.00058,74997,21.90371,342394
5499,dukekautington3rd,2,0.00058,74999,21.90430,342394
5500,dulek,2,0.00058,75001,21.90488,342394
5501,Dup4,2,0.00058,75003,21.90547,342394
5502,durd07,2,0.00058,75005,21.90605,342394
5503,duyongtju,2,0.00058,75007,21.90663,342394
5504,dv42,2,0.00058,75009,21.90722,342394
5505,Dviejopomata,2,0.00058,75011,21.90780,342394
5506,dxlr8r,2,0.00058,75013,21.90839,342394
5507,Dzeri96,2,0.00058,75015,21.90897,342394
5508,eagleweb,2,0.00058,75017,21.90955,342394
5509,eanton86,2,0.00058,75019,21.91014,342394
5510,echupriyanov,2,0.00058,75021,21.91072,342394
5511,ecmonsen,2,0.00058,75023,21.91131,342394
5512,ediazm,2,0.00058,75025,21.91189,342394
5513,edouard-lopez,2,0.00058,75027,21.91248,342394
5514,educriado,2,0.00058,75029,21.91306,342394
5515,eee4017,2,0.00058,75031,21.91364,342394
5516,eelkonio,2,0.00058,75033,21.91423,342394
5517,eestolano,2,0.00058,75035,21.91481,342394
5518,efossvold,2,0.00058,75037,21.91540,342394
5519,Efrat19,2,0.00058,75039,21.91598,342394
5520,egodigitus,2,0.00058,75041,21.91656,342394
5521,egorchepiga,2,0.00058,75043,21.91715,342394
5522,EgorNsk,2,0.00058,75045,21.91773,342394
5523,EikeHens,2,0.00058,75047,21.91832,342394
5524,Eilyre,2,0.00058,75049,21.91890,342394
5525,Elbehery,2,0.00058,75051,21.91948,342394
5526,ElectricVampire,2,0.00058,75053,21.92007,342394
5527,ElenaForester,2,0.00058,75055,21.92065,342394
5528,eli-halych,2,0.00058,75057,21.92124,342394
5529,Elvander,2,0.00058,75059,21.92182,342394
5530,elwood218,2,0.00058,75061,21.92241,342394
5531,embesozzi,2,0.00058,75063,21.92299,342394
5532,EmilMunksoe,2,0.00058,75065,21.92357,342394
5533,EmixamZ,2,0.00058,75067,21.92416,342394
5534,endyrocket,2,0.00058,75069,21.92474,342394
5535,entombedvirus,2,0.00058,75071,21.92533,342394
5536,eocern,2,0.00058,75073,21.92591,342394
5537,epsteina16,2,0.00058,75075,21.92649,342394
5538,erdong,2,0.00058,75077,21.92708,342394
5539,ericmorand,2,0.00058,75079,21.92766,342394
5540,ericxliu1990,2,0.00058,75081,21.92825,342394
5541,ermalbaj,2,0.00058,75083,21.92883,342394
5542,ernelio,2,0.00058,75085,21.92941,342394
5543,ErwanDL,2,0.00058,75087,21.93000,342394
5544,esxi1979,2,0.00058,75089,21.93058,342394
5545,etcshad0vv,2,0.00058,75091,21.93117,342394
5546,Ethan-99,2,0.00058,75093,21.93175,342394
5547,ethomson,2,0.00058,75095,21.93234,342394
5548,etiennejournet,2,0.00058,75097,21.93292,342394
5549,eugeneromero,2,0.00058,75099,21.93350,342394
5550,euqen,2,0.00058,75101,21.93409,342394
5551,evoicefire,2,0.00058,75103,21.93467,342394
5552,EwdAger,2,0.00058,75105,21.93526,342394
5553,expandmyworld,2,0.00058,75107,21.93584,342394
5554,exxsebastian,2,0.00058,75109,21.93642,342394
5555,eyesopen,2,0.00058,75111,21.93701,342394
5556,ezeutno,2,0.00058,75113,21.93759,342394
5557,fabiendupont,2,0.00058,75115,21.93818,342394
5558,fabricesemti80,2,0.00058,75117,21.93876,342394
5559,fadam-csgroup,2,0.00058,75119,21.93934,342394
5560,FahimFBA,2,0.00058,75121,21.93993,342394
5561,faisalrazzak,2,0.00058,75123,21.94051,342394
5562,false-start,2,0.00058,75125,21.94110,342394
5563,fangyi-zhou,2,0.00058,75127,21.94168,342394
5564,fangzx-wang,2,0.00058,75129,21.94227,342394
5565,fantapsody,2,0.00058,75131,21.94285,342394
5566,farhan787,2,0.00058,75133,21.94343,342394
5567,farlop,2,0.00058,75135,21.94402,342394
5568,fastlorenzo,2,0.00058,75137,21.94460,342394
5569,faustodavid,2,0.00058,75139,21.94519,342394
5570,FBryczak,2,0.00058,75141,21.94577,342394
5571,fcami,2,0.00058,75143,21.94635,342394
5572,fedextm,2,0.00058,75145,21.94694,342394
5573,feihou,2,0.00058,75147,21.94752,342394
5574,feldentm,2,0.00058,75149,21.94811,342394
5575,FelipeLujan,2,0.00058,75151,21.94869,342394
5576,fengou1,2,0.00058,75153,21.94927,342394
5577,fentonfentonfenton,2,0.00058,75155,21.94986,342394
5578,fernandodevelon,2,0.00058,75157,21.95044,342394
5579,ffais,2,0.00058,75159,21.95103,342394
5580,fgschwan,2,0.00058,75161,21.95161,342394
5581,fherbert,2,0.00058,75163,21.95220,342394
5582,fhj939057500,2,0.00058,75165,21.95278,342394
5583,fhkong,2,0.00058,75167,21.95336,342394
5584,filex,2,0.00058,75169,21.95395,342394
5585,fire-ant,2,0.00058,75171,21.95453,342394
5586,firebook,2,0.00058,75173,21.95512,342394
5587,fkn-iteratec,2,0.00058,75175,21.95570,342394
5588,flavianmissi,2,0.00058,75177,21.95628,342394
5589,FloMaetschke,2,0.00058,75179,21.95687,342394
5590,florentortiz,2,0.00058,75181,21.95745,342394
5591,Flou21,2,0.00058,75183,21.95804,342394
5592,flyznex,2,0.00058,75185,21.95862,342394
5593,fossilet,2,0.00058,75187,21.95920,342394
5594,fotos,2,0.00058,75189,21.95979,342394
5595,FoxAmes,2,0.00058,75191,21.96037,342394
5596,franck102,2,0.00058,75193,21.96096,342394
5597,francoisauclair911,2,0.00058,75195,21.96154,342394
5598,frankli-dev,2,0.00058,75197,21.96213,342394
5599,FrankLi-nz,2,0.00058,75199,21.96271,342394
5600,franksinankaya,2,0.00058,75201,21.96329,342394
5601,frebn,2,0.00058,75203,21.96388,342394
5602,frederik-b,2,0.00058,75205,21.96446,342394
5603,Frederik-Baetens,2,0.00058,75207,21.96505,342394
5604,frederiksf,2,0.00058,75209,21.96563,342394
5605,friedrich,2,0.00058,75211,21.96621,342394
5606,frimuchkov,2,0.00058,75213,21.96680,342394
5607,Frizlab,2,0.00058,75215,21.96738,342394
5608,frostyplanet,2,0.00058,75217,21.96797,342394
5609,frvge,2,0.00058,75219,21.96855,342394
5610,fsrv-xyz,2,0.00058,75221,21.96913,342394
5611,fuxiuyin,2,0.00058,75223,21.96972,342394
5612,fynjah,2,0.00058,75225,21.97030,342394
5613,fynluk,2,0.00058,75227,21.97089,342394
5614,g1bl3t,2,0.00058,75229,21.97147,342394
5615,GAAOPS,2,0.00058,75231,21.97206,342394
5616,gabece,2,0.00058,75233,21.97264,342394
5617,gabhi,2,0.00058,75235,21.97322,342394
5618,gabipetrovay,2,0.00058,75237,21.97381,342394
5619,gabron,2,0.00058,75239,21.97439,342394
5620,gadiener,2,0.00058,75241,21.97498,342394
5621,gakio12,2,0.00058,75243,21.97556,342394
5622,gandeevan,2,0.00058,75245,21.97614,342394
5623,gaodb1210,2,0.00058,75247,21.97673,342394
5624,garyyang2002,2,0.00058,75249,21.97731,342394
5625,gburton1,2,0.00058,75251,21.97790,342394
5626,gcaban,2,0.00058,75253,21.97848,342394
5627,gcheron,2,0.00058,75255,21.97907,342394
5628,gcollins-incomm,2,0.00058,75257,21.97965,342394
5629,gdippolito,2,0.00058,75259,21.98023,342394
5630,gearnode,2,0.00058,75261,21.98082,342394
5631,geetasg,2,0.00058,75263,21.98140,342394
5632,gege-pro,2,0.00058,75265,21.98199,342394
5633,genarks,2,0.00058,75267,21.98257,342394
5634,GeneralFox,2,0.00058,75269,21.98315,342394
5635,genzyy,2,0.00058,75271,21.98374,342394
5636,geoff-maddock,2,0.00058,75273,21.98432,342394
5637,geowalrus4gh,2,0.00058,75275,21.98491,342394
5638,GerardoGR,2,0.00058,75277,21.98549,342394
5639,GernotBekk,2,0.00058,75279,21.98607,342394
5640,gespinoza1-chwy,2,0.00058,75281,21.98666,342394
5641,getong,2,0.00058,75283,21.98724,342394
5642,ggyule,2,0.00058,75285,21.98783,342394
5643,gibmir,2,0.00058,75287,21.98841,342394
5644,gijsdpg,2,0.00058,75289,21.98900,342394
5645,Gikkman,2,0.00058,75291,21.98958,342394
5646,giladneiger,2,0.00058,75293,21.99016,342394
5647,gingermusketeer,2,0.00058,75295,21.99075,342394
5648,gintrator,2,0.00058,75297,21.99133,342394
5649,GitMOJ,2,0.00058,75299,21.99192,342394
5650,gitolicious,2,0.00058,75301,21.99250,342394
5651,gitsrc,2,0.00058,75303,21.99308,342394
5652,glenn-wang,2,0.00058,75305,21.99367,342394
5653,gll963,2,0.00058,75307,21.99425,342394
5654,gmaiztegi,2,0.00058,75309,21.99484,342394
5655,gmartynov,2,0.00058,75311,21.99542,342394
5656,gmj06,2,0.00058,75313,21.99600,342394
5657,gmorse-gd,2,0.00058,75315,21.99659,342394
5658,GoldElysium,2,0.00058,75317,21.99717,342394
5659,gongyunbao,2,0.00058,75319,21.99776,342394
5660,goroi,2,0.00058,75321,21.99834,342394
5661,gpl,2,0.00058,75323,21.99893,342394
5662,gpoothia-stripe,2,0.00058,75325,21.99951,342394
5663,greaterthanmost,2,0.00058,75327,22.00009,342394
5664,greenbourne277,2,0.00058,75329,22.00068,342394
5665,greenkiwi,2,0.00058,75331,22.00126,342394
5666,GregoryVds,2,0.00058,75333,22.00185,342394
5667,gregth,2,0.00058,75335,22.00243,342394
5668,Grounz,2,0.00058,75337,22.00301,342394
5669,Grrui,2,0.00058,75339,22.00360,342394
5670,Gsonovb,2,0.00058,75341,22.00418,342394
5671,Guanyan1996,2,0.00058,75343,22.00477,342394
5672,Guneetconvent2002,2,0.00058,75345,22.00535,342394
5673,gustysap,2,0.00058,75347,22.00593,342394
5674,gvillafanetapia,2,0.00058,75349,22.00652,342394
5675,gw0,2,0.00058,75351,22.00710,342394
5676,gwladysfonkam,2,0.00058,75353,22.00769,342394
5677,hahamofu,2,0.00058,75355,22.00827,342394
5678,haichaoli01,2,0.00058,75357,22.00886,342394
5679,halleyshx,2,0.00058,75359,22.00944,342394
5680,hamiltont,2,0.00058,75361,22.01002,342394
5681,hamxabaig,2,0.00058,75363,22.01061,342394
5682,hanwavefront,2,0.00058,75365,22.01119,342394
5683,haoeeeee,2,0.00058,75367,22.01178,342394
5684,haojia716,2,0.00058,75369,22.01236,342394
5685,HappyFX,2,0.00058,75371,22.01294,342394
5686,HappyUncle,2,0.00058,75373,22.01353,342394
5687,harkeet,2,0.00058,75375,22.01411,342394
5688,Harmelodic,2,0.00058,75377,22.01470,342394
5689,hateeyan,2,0.00058,75379,22.01528,342394
5690,haxsaw,2,0.00058,75381,22.01586,342394
5691,hayhay27,2,0.00058,75383,22.01645,342394
5692,hayond,2,0.00058,75385,22.01703,342394
5693,hazcod,2,0.00058,75387,22.01762,342394
5694,HB116,2,0.00058,75389,22.01820,342394
5695,hbrewster-splunk,2,0.00058,75391,22.01879,342394
5696,hcelaloner,2,0.00058,75393,22.01937,342394
5697,hd-deman,2,0.00058,75395,22.01995,342394
5698,headius,2,0.00058,75397,22.02054,342394
5699,hefekranz,2,0.00058,75399,22.02112,342394
5700,hehuiyuan,2,0.00058,75401,22.02171,342394
5701,heidemn,2,0.00058,75403,22.02229,342394
5702,hellt,2,0.00058,75405,22.02287,342394
5703,helper-uttam,2,0.00058,75407,22.02346,342394
5704,hemslo,2,0.00058,75409,22.02404,342394
5705,heretic13,2,0.00058,75411,22.02463,342394
5706,herself,2,0.00058,75413,22.02521,342394
5707,herter4171,2,0.00058,75415,22.02579,342394
5708,hexchain,2,0.00058,75417,22.02638,342394
5709,hexer-gogogo,2,0.00058,75419,22.02696,342394
5710,hfutatzhanghb,2,0.00058,75421,22.02755,342394
5711,HHHsiang,2,0.00058,75423,22.02813,342394
5712,hichamuntitled,2,0.00058,75425,22.02872,342394
5713,HimanshuZinzuwadia,2,0.00058,75427,22.02930,342394
5714,hintofbasil,2,0.00058,75429,22.02988,342394
5715,hitzhangjie,2,0.00058,75431,22.03047,342394
5716,hizheng,2,0.00058,75433,22.03105,342394
5717,hleal18,2,0.00058,75435,22.03164,342394
5718,hmendesB2C2,2,0.00058,75437,22.03222,342394
5719,holyspectral,2,0.00058,75439,22.03280,342394
5720,hongxinweiqi,2,0.00058,75441,22.03339,342394
5721,houseme,2,0.00058,75443,22.03397,342394
5722,houwengang,2,0.00058,75445,22.03456,342394
5723,hovinen,2,0.00058,75447,22.03514,342394
5724,howyi,2,0.00058,75449,22.03572,342394
5725,Hrily,2,0.00058,75451,22.03631,342394
5726,hronro,2,0.00058,75453,22.03689,342394
5727,hrr888,2,0.00058,75455,22.03748,342394
5728,hrsikesa,2,0.00058,75457,22.03806,342394
5729,HRusby-Cheyne,2,0.00058,75459,22.03865,342394
5730,hseligson1,2,0.00058,75461,22.03923,342394
5731,hterik,2,0.00058,75463,22.03981,342394
5732,huangenlong,2,0.00058,75465,22.04040,342394
5733,huanghe1993,2,0.00058,75467,22.04098,342394
5734,huangjiasingle,2,0.00058,75469,22.04157,342394
5735,huangnauh,2,0.00058,75471,22.04215,342394
5736,huckley,2,0.00058,75473,22.04273,342394
5737,hudson741,2,0.00058,75475,22.04332,342394
5738,hugo-costa-tek,2,0.00058,75477,22.04390,342394
5739,hulucc,2,0.00058,75479,22.04449,342394
5740,Hungrylion2019,2,0.00058,75481,22.04507,342394
5741,hussainsaify,2,0.00058,75483,22.04566,342394
5742,huyifanstar,2,0.00058,75485,22.04624,342394
5743,huynhj93,2,0.00058,75487,22.04682,342394
5744,huytran1ibm,2,0.00058,75489,22.04741,342394
5745,hypnopotamus,2,0.00058,75491,22.04799,342394
5746,hypocrite30,2,0.00058,75493,22.04858,342394
5747,hzy199411,2,0.00058,75495,22.04916,342394
5748,iahuohz,2,0.00058,75497,22.04974,342394
5749,iamkarlson,2,0.00058,75499,22.05033,342394
5750,iamsdas,2,0.00058,75501,22.05091,342394
5751,iangard,2,0.00058,75503,22.05150,342394
5752,iceman91176,2,0.00058,75505,22.05208,342394
5753,Id2ndR,2,0.00058,75507,22.05266,342394
5754,identw,2,0.00058,75509,22.05325,342394
5755,IDerr,2,0.00058,75511,22.05383,342394
5756,ifutant,2,0.00058,75513,22.05442,342394
5757,igas,2,0.00058,75515,22.05500,342394
5758,igormishsky,2,0.00058,75517,22.05559,342394
5759,iguitton,2,0.00058,75519,22.05617,342394
5760,iguyking,2,0.00058,75521,22.05675,342394
5761,iiglesiasg,2,0.00058,75523,22.05734,342394
5762,ikingye,2,0.00058,75525,22.05792,342394
5763,ikogan,2,0.00058,75527,22.05851,342394
5764,ikonyeama,2,0.00058,75529,22.05909,342394
5765,ilanni2460,2,0.00058,75531,22.05967,342394
5766,ilia-dot-karelia,2,0.00058,75533,22.06026,342394
5767,ilmal,2,0.00058,75535,22.06084,342394
5768,ilmircod,2,0.00058,75537,22.06143,342394
5769,ilpianista,2,0.00058,75539,22.06201,342394
5770,ilyatovbin-pp,2,0.00058,75541,22.06259,342394
5771,imdbere,2,0.00058,75543,22.06318,342394
5772,imheresamir,2,0.00058,75545,22.06376,342394
5773,imlonghao,2,0.00058,75547,22.06435,342394
5774,indywidualny,2,0.00058,75549,22.06493,342394
5775,infinipalex,2,0.00058,75551,22.06552,342394
5776,inorton,2,0.00058,75553,22.06610,342394
5777,iomarmochtar,2,0.00058,75555,22.06668,342394
5778,ionroso,2,0.00058,75557,22.06727,342394
5779,irataxy,2,0.00058,75559,22.06785,342394
5780,irl-segfault,2,0.00058,75561,22.06844,342394
5781,Iryna-Slynko,2,0.00058,75563,22.06902,342394
5782,isaacsanders,2,0.00058,75565,22.06960,342394
5783,ishallbethat,2,0.00058,75567,22.07019,342394
5784,israelevi-code,2,0.00058,75569,22.07077,342394
5785,israelvaldez,2,0.00058,75571,22.07136,342394
5786,isutton,2,0.00058,75573,22.07194,342394
5787,itayronen,2,0.00058,75575,22.07252,342394
5788,Itiho,2,0.00058,75577,22.07311,342394
5789,iusetabs,2,0.00058,75579,22.07369,342394
5790,ivoanjo,2,0.00058,75581,22.07428,342394
5791,izenk,2,0.00058,75583,22.07486,342394
5792,j0h4nn3s,2,0.00058,75585,22.07545,342394
5793,j3r3my,2,0.00058,75587,22.07603,342394
5794,jackgill,2,0.00058,75589,22.07661,342394
5795,JackSinclairT,2,0.00058,75591,22.07720,342394
5796,jackwootton,2,0.00058,75593,22.07778,342394
5797,jaekook,2,0.00058,75595,22.07837,342394
5798,jaiakash,2,0.00058,75597,22.07895,342394
5799,JaLe29,2,0.00058,75599,22.07953,342394
5800,Jalr4ever,2,0.00058,75601,22.08012,342394
5801,jamesachn,2,0.00058,75603,22.08070,342394
5802,james-d-elliott,2,0.00058,75605,22.08129,342394
5803,jamesloosli,2,0.00058,75607,22.08187,342394
5804,jamesmmccarthy,2,0.00058,75609,22.08245,342394
5805,janakerman,2,0.00058,75611,22.08304,342394
5806,janbe-ts,2,0.00058,75613,22.08362,342394
5807,JanMkl,2,0.00058,75615,22.08421,342394
5808,janpio,2,0.00058,75617,22.08479,342394
5809,janquijano,2,0.00058,75619,22.08538,342394
5810,jantari,2,0.00058,75621,22.08596,342394
5811,JapuDCret,2,0.00058,75623,22.08654,342394
5812,Jarnen,2,0.00058,75625,22.08713,342394
5813,jaroslav-fedor-swi,2,0.00058,75627,22.08771,342394
5814,JavierPalaciosNexplore,2,0.00058,75629,22.08830,342394
5815,jayeshnazre,2,0.00058,75631,22.08888,342394
5816,JAYTEE219,2,0.00058,75633,22.08946,342394
5817,jbdamiano,2,0.00058,75635,22.09005,342394
5818,jbouchery,2,0.00058,75637,22.09063,342394
5819,jcidoni-ocp,2,0.00058,75639,22.09122,342394
5820,jclab-joseph,2,0.00058,75641,22.09180,342394
5821,jcogilvie,2,0.00058,75643,22.09238,342394
5822,JCOR11599,2,0.00058,75645,22.09297,342394
5823,jdfresser,2,0.00058,75647,22.09355,342394
5824,jdmaguire,2,0.00058,75649,22.09414,342394
5825,jdoylei,2,0.00058,75651,22.09472,342394
5826,JeepGuy,2,0.00058,75653,22.09531,342394
5827,JeffreyBool,2,0.00058,75655,22.09589,342394
5828,jensneuhaus,2,0.00058,75657,22.09647,342394
5829,jeremybusk,2,0.00058,75659,22.09706,342394
5830,jeremyruffell,2,0.00058,75661,22.09764,342394
5831,jeroenlandheer,2,0.00058,75663,22.09823,342394
5832,Jerry-Carter,2,0.00058,75665,22.09881,342394
5833,jesse1478,2,0.00058,75667,22.09939,342394
5834,jesseschalken,2,0.00058,75669,22.09998,342394
5835,JethroMV,2,0.00058,75671,22.10056,342394
5836,jetora,2,0.00058,75673,22.10115,342394
5837,Jeverett3000,2,0.00058,75675,22.10173,342394
5838,jfbai,2,0.00058,75677,22.10231,342394
5839,jflipts,2,0.00058,75679,22.10290,342394
5840,jgoeres,2,0.00058,75681,22.10348,342394
5841,jharley,2,0.00058,75683,22.10407,342394
5842,JhoLee,2,0.00058,75685,22.10465,342394
5843,jhpatel,2,0.00058,75687,22.10524,342394
5844,jibanes,2,0.00058,75689,22.10582,342394
5845,jicki,2,0.00058,75691,22.10640,342394
5846,JimFicarra,2,0.00058,75693,22.10699,342394
5847,jimmykarily,2,0.00058,75695,22.10757,342394
5848,Jimmyscene,2,0.00058,75697,22.10816,342394
5849,jimmyyyeh,2,0.00058,75699,22.10874,342394
5850,jinnypark9393,2,0.00058,75701,22.10932,342394
5851,jinstest1,2,0.00058,75703,22.10991,342394
5852,jinxin-fu,2,0.00058,75705,22.11049,342394
5853,jiribroulik,2,0.00058,75707,22.11108,342394
5854,jitendraky,2,0.00058,75709,22.11166,342394
5855,jitubhaiya,2,0.00058,75711,22.11224,342394
5856,jivco,2,0.00058,75713,22.11283,342394
5857,jizusun,2,0.00058,75715,22.11341,342394
5858,jjkiely,2,0.00058,75717,22.11400,342394
5859,j-koopman,2,0.00058,75719,22.11458,342394
5860,jkossak,2,0.00058,75721,22.11517,342394
5861,jlandowner,2,0.00058,75723,22.11575,342394
5862,j-landru,2,0.00058,75725,22.11633,342394
5863,jleni,2,0.00058,75727,22.11692,342394
5864,jlugao,2,0.00058,75729,22.11750,342394
5865,jlvallelonga,2,0.00058,75731,22.11809,342394
5866,jmclean-starburst,2,0.00058,75733,22.11867,342394
5867,JMoserCricut,2,0.00058,75735,22.11925,342394
5868,jnbhavya,2,0.00058,75737,22.11984,342394
5869,jneal-afs,2,0.00058,75739,22.12042,342394
5870,jniebuhr,2,0.00058,75741,22.12101,342394
5871,jobenvil,2,0.00058,75743,22.12159,342394
5872,jochen42,2,0.00058,75745,22.12218,342394
5873,joefreyk,2,0.00058,75747,22.12276,342394
5874,jogonba2,2,0.00058,75749,22.12334,342394
5875,johanngyger,2,0.00058,75751,22.12393,342394
5876,JohnBoyB,2,0.00058,75753,22.12451,342394
5877,johnbuluba,2,0.00058,75755,22.12510,342394
5878,johnmuth81,2,0.00058,75757,22.12568,342394
5879,johnpaulett,2,0.00058,75759,22.12626,342394
5880,johnrichardrinehart,2,0.00058,75761,22.12685,342394
5881,jonabrenman,2,0.00058,75763,22.12743,342394
5882,jonashackt,2,0.00058,75765,22.12802,342394
5883,jonaslagoni,2,0.00058,75767,22.12860,342394
5884,jonathonfletcher,2,0.00058,75769,22.12918,342394
5885,jonje,2,0.00058,75771,22.12977,342394
5886,jonmchan,2,0.00058,75773,22.13035,342394
5887,jonnys17,2,0.00058,75775,22.13094,342394
5888,JonZeolla,2,0.00058,75777,22.13152,342394
5889,Jooyoung-dable,2,0.00058,75779,22.13211,342394
5890,jord1e,2,0.00058,75781,22.13269,342394
5891,josecastillolema,2,0.00058,75783,22.13327,342394
5892,josepowera,2,0.00058,75785,22.13386,342394
5893,joshdk,2,0.00058,75787,22.13444,342394
5894,JoshuaWise,2,0.00058,75789,22.13503,342394
5895,jovan-absci,2,0.00058,75791,22.13561,342394
5896,joy717,2,0.00058,75793,22.13619,342394
5897,jplanza-gr,2,0.00058,75795,22.13678,342394
5898,jrauschenbusch,2,0.00058,75797,22.13736,342394
5899,jrivers96,2,0.00058,75799,22.13795,342394
5900,jsallay,2,0.00058,75801,22.13853,342394
5901,jschaf,2,0.00058,75803,22.13911,342394
5902,jschirrmacher,2,0.00058,75805,22.13970,342394
5903,juandesant,2,0.00058,75807,22.14028,342394
5904,JuanJTorres11,2,0.00058,75809,22.14087,342394
5905,JuanRamino,2,0.00058,75811,22.14145,342394
5906,julianarana,2,0.00058,75813,22.14204,342394
5907,juliankung-db,2,0.00058,75815,22.14262,342394
5908,julichan,2,0.00058,75817,22.14320,342394
5909,julius-welink,2,0.00058,75819,22.14379,342394
5910,JumpMaster,2,0.00058,75821,22.14437,342394
5911,junm-cloudnatix,2,0.00058,75823,22.14496,342394
5912,just1900,2,0.00058,75825,22.14554,342394
5913,jvassev,2,0.00058,75827,22.14612,342394
5914,jyee021,2,0.00058,75829,22.14671,342394
5915,Kakaboto,2,0.00058,75831,22.14729,342394
5916,Kakashiiiiy,2,0.00058,75833,22.14788,342394
5917,kakyoism,2,0.00058,75835,22.14846,342394
5918,kal4oz,2,0.00058,75837,22.14904,342394
5919,Kalaidar,2,0.00058,75839,22.14963,342394
5920,kalpchipsoft,2,0.00058,75841,22.15021,342394
5921,Kami,2,0.00058,75843,22.15080,342394
5922,Kanshiroron,2,0.00058,75845,22.15138,342394
5923,karanrn,2,0.00058,75847,22.15197,342394
5924,karanvasnani,2,0.00058,75849,22.15255,342394
5925,Karthik1610,2,0.00058,75851,22.15313,342394
5926,kaskol10,2,0.00058,75853,22.15372,342394
5927,KatekovAnton,2,0.00058,75855,22.15430,342394
5928,kaul-abhi,2,0.00058,75857,22.15489,342394
5929,kcrazy,2,0.00058,75859,22.15547,342394
5930,kdeyko,2,0.00058,75861,22.15605,342394
5931,kdopen,2,0.00058,75863,22.15664,342394
5932,kebyn,2,0.00058,75865,22.15722,342394
5933,kelthuzadx,2,0.00058,75867,22.15781,342394
5934,KelvinHongSea,2,0.00058,75869,22.15839,342394
5935,kelvinkchu,2,0.00058,75871,22.15897,342394
5936,kelvinn,2,0.00058,75873,22.15956,342394
5937,kempy007,2,0.00058,75875,22.16014,342394
5938,kenken-ishiken,2,0.00058,75877,22.16073,342394
5939,kennethkaane,2,0.00058,75879,22.16131,342394
5940,kennyblaze67,2,0.00058,75881,22.16190,342394
5941,kenoung,2,0.00058,75883,22.16248,342394
5942,kevindotglasson,2,0.00058,75885,22.16306,342394
5943,kevin-hanselman,2,0.00058,75887,22.16365,342394
5944,kevinlmadison,2,0.00058,75889,22.16423,342394
5945,KevinMGranger,2,0.00058,75891,22.16482,342394
5946,Keyhoh,2,0.00058,75893,22.16540,342394
5947,kfabryczny,2,0.00058,75895,22.16598,342394
5948,khushboo121,2,0.00058,75897,22.16657,342394
5949,Khushboo288,2,0.00058,75899,22.16715,342394
5950,kibertoad,2,0.00058,75901,22.16774,342394
5951,kigedooooooooooooooo,2,0.00058,75903,22.16832,342394
5952,kimsungkyum-acorn,2,0.00058,75905,22.16890,342394
5953,kinlab1,2,0.00058,75907,22.16949,342394
5954,kiranmaikalla1,2,0.00058,75909,22.17007,342394
5955,KiranOpenSource,2,0.00058,75911,22.17066,342394
5956,kitarp29,2,0.00058,75913,22.17124,342394
5957,kjellmoens,2,0.00058,75915,22.17183,342394
5958,kjpark,2,0.00058,75917,22.17241,342394
5959,kkwojc,2,0.00058,75919,22.17299,342394
5960,klayscool,2,0.00058,75921,22.17358,342394
5961,klenje,2,0.00058,75923,22.17416,342394
5962,klinakuf,2,0.00058,75925,22.17475,342394
5963,klogg,2,0.00058,75927,22.17533,342394
5964,kmrgirish,2,0.00058,75929,22.17591,342394
5965,knyttl,2,0.00058,75931,22.17650,342394
5966,kobi86,2,0.00058,75933,22.17708,342394
5967,komalsukhani,2,0.00058,75935,22.17767,342394
5968,kopytov,2,0.00058,75937,22.17825,342394
5969,korncola,2,0.00058,75939,22.17883,342394
5970,korsmakolnikov,2,0.00058,75941,22.17942,342394
5971,kpratyus,2,0.00058,75943,22.18000,342394
5972,kraft87,2,0.00058,75945,22.18059,342394
5973,kriomant,2,0.00058,75947,22.18117,342394
5974,krishguptadev,2,0.00058,75949,22.18176,342394
5975,KrisJohnstone,2,0.00058,75951,22.18234,342394
5976,KrisShannon,2,0.00058,75953,22.18292,342394
5977,Kristjanf-droid,2,0.00058,75955,22.18351,342394
5978,krknopp,2,0.00058,75957,22.18409,342394
5979,krystiannowak,2,0.00058,75959,22.18468,342394
5980,KrzysztofCzyz,2,0.00058,75961,22.18526,342394
5981,k-srkw,2,0.00058,75963,22.18584,342394
5982,ktalg,2,0.00058,75965,22.18643,342394
5983,ktsakos,2,0.00058,75967,22.18701,342394
5984,kub3let,2,0.00058,75969,22.18760,342394
5985,kuba001,2,0.00058,75971,22.18818,342394
5986,kumarpmd,2,0.00058,75973,22.18876,342394
5987,kumoroku,2,0.00058,75975,22.18935,342394
5988,Kvasscn,2,0.00058,75977,22.18993,342394
5989,kwoodson,2,0.00058,75979,22.19052,342394
5990,KXL05,2,0.00058,75981,22.19110,342394
5991,kye308,2,0.00058,75983,22.19169,342394
5992,KyleBS,2,0.00058,75985,22.19227,342394
5993,KyWa,2,0.00058,75987,22.19285,342394
5994,l1b0k,2,0.00058,75989,22.19344,342394
5995,lakamsani,2,0.00058,75991,22.19402,342394
5996,lakxtxue,2,0.00058,75993,22.19461,342394
5997,lalanikarim,2,0.00058,75995,22.19519,342394
5998,languitar,2,0.00058,75997,22.19577,342394
5999,lapwat,2,0.00058,75999,22.19636,342394
6000,larshp,2,0.00058,76001,22.19694,342394
6001,larvinloy,2,0.00058,76003,22.19753,342394
6002,laugmanuel,2,0.00058,76005,22.19811,342394
6003,laurigates,2,0.00058,76007,22.19870,342394
6004,laurovenancio,2,0.00058,76009,22.19928,342394
6005,lazarkrstic,2,0.00058,76011,22.19986,342394
6006,lc-1203,2,0.00058,76013,22.20045,342394
6007,lcaproni-pp,2,0.00058,76015,22.20103,342394
6008,lcwangchao,2,0.00058,76017,22.20162,342394
6009,ldanielw1,2,0.00058,76019,22.20220,342394
6010,leeadh,2,0.00058,76021,22.20278,342394
6011,Leisureroad,2,0.00058,76023,22.20337,342394
6012,lemonshir,2,0.00058,76025,22.20395,342394
6013,lena-larionova,2,0.00058,76027,22.20454,342394
6014,leo-lee-4231,2,0.00058,76029,22.20512,342394
6015,leonardBang,2,0.00058,76031,22.20570,342394
6016,LeoniePhiline,2,0.00058,76033,22.20629,342394
6017,leoryu,2,0.00058,76035,22.20687,342394
6018,LeoVS09,2,0.00058,76037,22.20746,342394
6019,leozmm,2,0.00058,76039,22.20804,342394
6020,lerrigatto,2,0.00058,76041,22.20863,342394
6021,lethargosapatheia,2,0.00058,76043,22.20921,342394
6022,lewiseason,2,0.00058,76045,22.20979,342394
6023,LFrobeen,2,0.00058,76047,22.21038,342394
6024,LH533,2,0.00058,76049,22.21096,342394
6025,lhaendler,2,0.00058,76051,22.21155,342394
6026,LiamStorkey,2,0.00058,76053,22.21213,342394
6027,liangyongzhenya,2,0.00058,76055,22.21271,342394
6028,licheng5625,2,0.00058,76057,22.21330,342394
6029,liejuntao001,2,0.00058,76059,22.21388,342394
6030,Lihongjie-123,2,0.00058,76061,22.21447,342394
6031,limedaniel,2,0.00058,76063,22.21505,342394
6032,LINDA4042,2,0.00058,76065,22.21563,342394
6033,lindenmj,2,0.00058,76067,22.21622,342394
6034,Lingx9,2,0.00058,76069,22.21680,342394
6035,linodejesusmonarrazliz,2,0.00058,76071,22.21739,342394
6036,linuxesabz,2,0.00058,76073,22.21797,342394
6037,liqd1,2,0.00058,76075,22.21856,342394
6038,liruishan,2,0.00058,76077,22.21914,342394
6039,lishaoshu1240,2,0.00058,76079,22.21972,342394
6040,LittleChimera,2,0.00058,76081,22.22031,342394
6041,liuchaowhu,2,0.00058,76083,22.22089,342394
6042,liudonghua123,2,0.00058,76085,22.22148,342394
6043,LiuGuBiGu,2,0.00058,76087,22.22206,342394
6044,liulp,2,0.00058,76089,22.22264,342394
6045,liumengkai,2,0.00058,76091,22.22323,342394
6046,liuxuliangcumt,2,0.00058,76093,22.22381,342394
6047,liweitianux,2,0.00058,76095,22.22440,342394
6048,LKI,2,0.00058,76097,22.22498,342394
6049,llovizno,2,0.00058,76099,22.22556,342394
6050,lmmarsano,2,0.00058,76101,22.22615,342394
6051,lmx-code,2,0.00058,76103,22.22673,342394
6052,ln3333,2,0.00058,76105,22.22732,342394
6053,Lngramos,2,0.00058,76107,22.22790,342394
6054,lobziik,2,0.00058,76109,22.22849,342394
6055,locopol,2,0.00058,76111,22.22907,342394
6056,logopk,2,0.00058,76113,22.22965,342394
6057,lokesh-wise,2,0.00058,76115,22.23024,342394
6058,lokichoggio,2,0.00058,76117,22.23082,342394
6059,lonnixOH,2,0.00058,76119,22.23141,342394
6060,LoonyRules,2,0.00058,76121,22.23199,342394
6061,lord22shark,2,0.00058,76123,22.23257,342394
6062,LorisFriedel,2,0.00058,76125,22.23316,342394
6063,louij2,2,0.00058,76127,22.23374,342394
6064,lowang-bh,2,0.00058,76129,22.23433,342394
6065,lsunsi,2,0.00058,76131,22.23491,342394
6066,lszChain,2,0.00058,76133,22.23549,342394
6067,ltqb,2,0.00058,76135,22.23608,342394
6068,luanjot,2,0.00058,76137,22.23666,342394
6069,lubumbax,2,0.00058,76139,22.23725,342394
6070,lucadirocco,2,0.00058,76141,22.23783,342394
6071,lucasbasquerotto,2,0.00058,76143,22.23842,342394
6072,lucemia,2,0.00058,76145,22.23900,342394
6073,luckyops,2,0.00058,76147,22.23958,342394
6074,luckyswede,2,0.00058,76149,22.24017,342394
6075,lugospod,2,0.00058,76151,22.24075,342394
6076,luharuka,2,0.00058,76153,22.24134,342394
6077,luizgribeiro,2,0.00058,76155,22.24192,342394
6078,LukasGentele,2,0.00058,76157,22.24250,342394
6079,lukedodd,2,0.00058,76159,22.24309,342394
6080,lukeplausin,2,0.00058,76161,22.24367,342394
6081,LukeRobbo,2,0.00058,76163,22.24426,342394
6082,luminoso,2,0.00058,76165,22.24484,342394
6083,Lumiond,2,0.00058,76167,22.24542,342394
6084,lunz1207,2,0.00058,76169,22.24601,342394
6085,lusid,2,0.00058,76171,22.24659,342394
6086,LvffY,2,0.00058,76173,22.24718,342394
6087,lwmxiaobei,2,0.00058,76175,22.24776,342394
6088,lxu4net,2,0.00058,76177,22.24835,342394
6089,LyleScott,2,0.00058,76179,22.24893,342394
6090,lyp256,2,0.00058,76181,22.24951,342394
6091,lz-nsc,2,0.00058,76183,22.25010,342394
6092,lzwaan,2,0.00058,76185,22.25068,342394
6093,m1o1,2,0.00058,76187,22.25127,342394
6094,m4dm4rtig4n,2,0.00058,76189,22.25185,342394
6095,maaltan,2,0.00058,76191,22.25243,342394
6096,maaoBit,2,0.00058,76193,22.25302,342394
6097,MacdonEm,2,0.00058,76195,22.25360,342394
6098,macedogm,2,0.00058,76197,22.25419,342394
6099,machinaexdeo,2,0.00058,76199,22.25477,342394
6100,mack1024,2,0.00058,76201,22.25535,342394
6101,macman31,2,0.00058,76203,22.25594,342394
6102,macripps,2,0.00058,76205,22.25652,342394
6103,Maddy007-maha,2,0.00058,76207,22.25711,342394
6104,madelson,2,0.00058,76209,22.25769,342394
6105,madhanreddy433,2,0.00058,76211,22.25828,342394
6106,madianas,2,0.00058,76213,22.25886,342394
6107,MagicJohnJang,2,0.00058,76215,22.25944,342394
6108,magictoken,2,0.00058,76217,22.26003,342394
6109,maheshd2,2,0.00058,76219,22.26061,342394
6110,mahima145,2,0.00058,76221,22.26120,342394
6111,mail2sandeepd,2,0.00058,76223,22.26178,342394
6112,makaronak,2,0.00058,76225,22.26236,342394
6113,makorne,2,0.00058,76227,22.26295,342394
6114,malaire,2,0.00058,76229,22.26353,342394
6115,MaMrEzO,2,0.00058,76231,22.26412,342394
6116,Mandeepsheoran,2,0.00058,76233,22.26470,342394
6117,maneeshbhunwal123,2,0.00058,76235,22.26529,342394
6118,manelpb,2,0.00058,76237,22.26587,342394
6119,manivannan-g,2,0.00058,76239,22.26645,342394
6120,mann2108,2,0.00058,76241,22.26704,342394
6121,Manoj-07,2,0.00058,76243,22.26762,342394
6122,mans0954,2,0.00058,76245,22.26821,342394
6123,manushawijekoon,2,0.00058,76247,22.26879,342394
6124,Manzanit0,2,0.00058,76249,22.26937,342394
6125,manzsolutions-lpreis,2,0.00058,76251,22.26996,342394
6126,marchlhw,2,0.00058,76253,22.27054,342394
6127,marcin-je,2,0.00058,76255,22.27113,342394
6128,marcocaberletti,2,0.00058,76257,22.27171,342394
6129,marcportabellaclotet-mt,2,0.00058,76259,22.27229,342394
6130,marga-kinvolk,2,0.00058,76261,22.27288,342394
6131,maricart,2,0.00058,76263,22.27346,342394
6132,mariobris,2,0.00058,76265,22.27405,342394
6133,mariolenz,2,0.00058,76267,22.27463,342394
6134,markgarrigan,2,0.00058,76269,22.27522,342394
6135,markkrj,2,0.00058,76271,22.27580,342394
6136,MarkMckessock,2,0.00058,76273,22.27638,342394
6137,markmsmith,2,0.00058,76275,22.27697,342394
6138,markoposavec,2,0.00058,76277,22.27755,342394
6139,maroshmka,2,0.00058,76279,22.27814,342394
6140,marquezika,2,0.00058,76281,22.27872,342394
6141,maschwenk,2,0.00058,76283,22.27930,342394
6142,mateodelnorte,2,0.00058,76285,22.27989,342394
6143,mateuszpruchniak,2,0.00058,76287,22.28047,342394
6144,matpen,2,0.00058,76289,22.28106,342394
6145,matrixersp,2,0.00058,76291,22.28164,342394
6146,mattdurham,2,0.00058,76293,22.28222,342394
6147,matthijsqd,2,0.00058,76295,22.28281,342394
6148,mattmahn,2,0.00058,76297,22.28339,342394
6149,matt-psaltis,2,0.00058,76299,22.28398,342394
6150,matt-simons,2,0.00058,76301,22.28456,342394
6151,matyasfodor,2,0.00058,76303,22.28515,342394
6152,mavenraven,2,0.00058,76305,22.28573,342394
6153,Max0978678407,2,0.00058,76307,22.28631,342394
6154,MaxCaresYww,2,0.00058,76309,22.28690,342394
6155,max-ieremenko,2,0.00058,76311,22.28748,342394
6156,maxisam,2,0.00058,76313,22.28807,342394
6157,maxlegault,2,0.00058,76315,22.28865,342394
6158,mayaaravotwm,2,0.00058,76317,22.28923,342394
6159,MayankGandhe,2,0.00058,76319,22.28982,342394
6160,mayankkthr,2,0.00058,76321,22.29040,342394
6161,MBDev2k,2,0.00058,76323,22.29099,342394
6162,mbutkereit,2,0.00058,76325,22.29157,342394
6163,mcekovic,2,0.00058,76327,22.29215,342394
6164,mckornfield,2,0.00058,76329,22.29274,342394
6165,mcrisafu-hxgn,2,0.00058,76331,22.29332,342394
6166,mddamato,2,0.00058,76333,22.29391,342394
6167,mebays,2,0.00058,76335,22.29449,342394
6168,mehmanoglu,2,0.00058,76337,22.29508,342394
6169,mehrdad-goudarzi,2,0.00058,76339,22.29566,342394
6170,MelvinTo,2,0.00058,76341,22.29624,342394
6171,memogarcia,2,0.00058,76343,22.29683,342394
6172,mengmann,2,0.00058,76345,22.29741,342394
6173,mengwangict,2,0.00058,76347,22.29800,342394
6174,mengxifl,2,0.00058,76349,22.29858,342394
6175,MeranaTona,2,0.00058,76351,22.29916,342394
6176,merlante,2,0.00058,76353,22.29975,342394
6177,metalice,2,0.00058,76355,22.30033,342394
6178,meysam81,2,0.00058,76357,22.30092,342394
6179,mhahl,2,0.00058,76359,22.30150,342394
6180,micahbeeman-wf,2,0.00058,76361,22.30208,342394
6181,micahmo,2,0.00058,76363,22.30267,342394
6182,MichaelPeter,2,0.00058,76365,22.30325,342394
6183,michaelschmitz,2,0.00058,76367,22.30384,342394
6184,michelefa1988,2,0.00058,76369,22.30442,342394
6185,micron1390,2,0.00058,76371,22.30501,342394
6186,MihailsKuzmins,2,0.00058,76373,22.30559,342394
6187,Mihir-Bhasin,2,0.00058,76375,22.30617,342394
6188,mikementzmaersk,2,0.00058,76377,22.30676,342394
6189,mike-serchenia,2,0.00058,76379,22.30734,342394
6190,mikklee,2,0.00058,76381,22.30793,342394
6191,mindbergh,2,0.00058,76383,22.30851,342394
6192,mineshp100,2,0.00058,76385,22.30909,342394
6193,mingtdlb,2,0.00058,76387,22.30968,342394
6194,minnsoe,2,0.00058,76389,22.31026,342394
6195,miro-grapeup,2,0.00058,76391,22.31085,342394
6196,miroswan,2,0.00058,76393,22.31143,342394
6197,mirusky,2,0.00058,76395,22.31201,342394
6198,misalcedo,2,0.00058,76397,22.31260,342394
6199,MissakaI,2,0.00058,76399,22.31318,342394
6200,missinglink,2,0.00058,76401,22.31377,342394
6201,mitchldtn,2,0.00058,76403,22.31435,342394
6202,mitul3737,2,0.00058,76405,22.31494,342394
6203,mj3c,2,0.00058,76407,22.31552,342394
6204,mjindalmotiv8,2,0.00058,76409,22.31610,342394
6205,mjmcconnell,2,0.00058,76411,22.31669,342394
6206,mjonss,2,0.00058,76413,22.31727,342394
6207,mkenne11,2,0.00058,76415,22.31786,342394
6208,mkrutik,2,0.00058,76417,22.31844,342394
6209,mmelyp,2,0.00058,76419,22.31902,342394
6210,mmorel-35,2,0.00058,76421,22.31961,342394
6211,mnahinkhan,2,0.00058,76423,22.32019,342394
6212,mnasruul,2,0.00058,76425,22.32078,342394
6213,mnito,2,0.00058,76427,22.32136,342394
6214,mnpenner,2,0.00058,76429,22.32194,342394
6215,MoeHamdan,2,0.00058,76431,22.32253,342394
6216,mogensen,2,0.00058,76433,22.32311,342394
6217,montgomerybc,2,0.00058,76435,22.32370,342394
6218,MontyGvMC,2,0.00058,76437,22.32428,342394
6219,moonsphere,2,0.00058,76439,22.32487,342394
6220,moss2k13,2,0.00058,76441,22.32545,342394
6221,moswil,2,0.00058,76443,22.32603,342394
6222,Moulick,2,0.00058,76445,22.32662,342394
6223,mparamas-zz,2,0.00058,76447,22.32720,342394
6224,mper0003,2,0.00058,76449,22.32779,342394
6225,mperrien,2,0.00058,76451,22.32837,342394
6226,mpontillo,2,0.00058,76453,22.32895,342394
6227,MPParsley,2,0.00058,76455,22.32954,342394
6228,mremreozan,2,0.00058,76457,22.33012,342394
6229,MrGreenRUS,2,0.00058,76459,22.33071,342394
6230,MrLPager,2,0.00058,76461,22.33129,342394
6231,MRoci,2,0.00058,76463,22.33187,342394
6232,mroumpa,2,0.00058,76465,22.33246,342394
6233,MrSimonEmms,2,0.00058,76467,22.33304,342394
6234,mrWinston,2,0.00058,76469,22.33363,342394
6235,MrYHM,2,0.00058,76471,22.33421,342394
6236,mrytower05,2,0.00058,76473,22.33480,342394
6237,msaini0r,2,0.00058,76475,22.33538,342394
6238,msrumon,2,0.00058,76477,22.33596,342394
6239,msyhu,2,0.00058,76479,22.33655,342394
6240,MTRNord,2,0.00058,76481,22.33713,342394
6241,MuhammetDilmac,2,0.00058,76483,22.33772,342394
6242,muler415,2,0.00058,76485,22.33830,342394
6243,muthali,2,0.00058,76487,22.33888,342394
6244,muzaffersenkal,2,0.00058,76489,22.33947,342394
6245,muzuke,2,0.00058,76491,22.34005,342394
6246,mvalarh,2,0.00058,76493,22.34064,342394
6247,mvollrath,2,0.00058,76495,22.34122,342394
6248,mx-foxtel,2,0.00058,76497,22.34181,342394
6249,MyIgel,2,0.00058,76499,22.34239,342394
6250,mytototo,2,0.00058,76501,22.34297,342394
6251,mytting,2,0.00058,76503,22.34356,342394
6252,n0trace,2,0.00058,76505,22.34414,342394
6253,nabbas-ca,2,0.00058,76507,22.34473,342394
6254,nakamasato,2,0.00058,76509,22.34531,342394
6255,nandor-magyar,2,0.00058,76511,22.34589,342394
6256,napathome,2,0.00058,76513,22.34648,342394
6257,narayaar,2,0.00058,76515,22.34706,342394
6258,narg95,2,0.00058,76517,22.34765,342394
6259,Narsilion,2,0.00058,76519,22.34823,342394
6260,nav9,2,0.00058,76521,22.34881,342394
6261,navrenga,2,0.00058,76523,22.34940,342394
6262,nbaztec,2,0.00058,76525,22.34998,342394
6263,ncipollina,2,0.00058,76527,22.35057,342394
6264,Ne4to,2,0.00058,76529,22.35115,342394
6265,neeleshtiwari,2,0.00058,76531,22.35174,342394
6266,nehap4,2,0.00058,76533,22.35232,342394
6267,nehatomar12,2,0.00058,76535,22.35290,342394
6268,neilgoodman,2,0.00058,76537,22.35349,342394
6269,nekketsuuu,2,0.00058,76539,22.35407,342394
6270,nerddtvg,2,0.00058,76541,22.35466,342394
6271,newb1e,2,0.00058,76543,22.35524,342394
6272,nfickas,2,0.00058,76545,22.35582,342394
6273,nfoonf,2,0.00058,76547,22.35641,342394
6274,ngau66,2,0.00058,76549,22.35699,342394
6275,nhatfield,2,0.00058,76551,22.35758,342394
6276,nibatandukar,2,0.00058,76553,22.35816,342394
6277,nicgrayson,2,0.00058,76555,22.35874,342394
6278,nicholasgribanov,2,0.00058,76557,22.35933,342394
6279,nickgooding,2,0.00058,76559,22.35991,342394
6280,nicknotfun,2,0.00058,76561,22.36050,342394
6281,nigels-com,2,0.00058,76563,22.36108,342394
6282,NikNikM,2,0.00058,76565,22.36167,342394
6283,nikolaishields,2,0.00058,76567,22.36225,342394
6284,NikolauUB,2,0.00058,76569,22.36283,342394
6285,nikolaylagutko,2,0.00058,76571,22.36342,342394
6286,nikstur,2,0.00058,76573,22.36400,342394
6287,nilesh-telang,2,0.00058,76575,22.36459,342394
6288,NilsGriebner,2,0.00058,76577,22.36517,342394
6289,niltor,2,0.00058,76579,22.36575,342394
6290,nishankgu,2,0.00058,76581,22.36634,342394
6291,nithyashree675,2,0.00058,76583,22.36692,342394
6292,nmiyake,2,0.00058,76585,22.36751,342394
6293,nml11c,2,0.00058,76587,22.36809,342394
6294,nneram,2,0.00058,76589,22.36867,342394
6295,nnthuanegany,2,0.00058,76591,22.36926,342394
6296,nohant,2,0.00058,76593,22.36984,342394
6297,nonamef,2,0.00058,76595,22.37043,342394
6298,nosmo,2,0.00058,76597,22.37101,342394
6299,NotAFile,2,0.00058,76599,22.37160,342394
6300,Nothing4You,2,0.00058,76601,22.37218,342394
6301,npinaeva,2,0.00058,76603,22.37276,342394
6302,nsoubelet,2,0.00058,76605,22.37335,342394
6303,nunofilipecosta,2,0.00058,76607,22.37393,342394
6304,nutrienrob,2,0.00058,76609,22.37452,342394
6305,nvervelle,2,0.00058,76611,22.37510,342394
6306,Nyefan,2,0.00058,76613,22.37568,342394
6307,obabativavmware,2,0.00058,76615,22.37627,342394
6308,occase,2,0.00058,76617,22.37685,342394
6309,ocsw,2,0.00058,76619,22.37744,342394
6310,odivlad,2,0.00058,76621,22.37802,342394
6311,ogm256,2,0.00058,76623,22.37860,342394
6312,oguzdag,2,0.00058,76625,22.37919,342394
6313,ohauer,2,0.00058,76627,22.37977,342394
6314,OHeimlich,2,0.00058,76629,22.38036,342394
6315,ohlol,2,0.00058,76631,22.38094,342394
6316,ohreally,2,0.00058,76633,22.38153,342394
6317,oleg-glushak,2,0.00058,76635,22.38211,342394
6318,Olegt0rr,2,0.00058,76637,22.38269,342394
6319,oleg-yudovich,2,0.00058,76639,22.38328,342394
6320,olivierbouchomsfreshheads,2,0.00058,76641,22.38386,342394
6321,OlleLarsson,2,0.00058,76643,22.38445,342394
6322,omarshibli,2,0.00058,76645,22.38503,342394
6323,omron93,2,0.00058,76647,22.38561,342394
6324,onemanbucket,2,0.00058,76649,22.38620,342394
6325,onerandomdude,2,0.00058,76651,22.38678,342394
6326,ontor79,2,0.00058,76653,22.38737,342394
6327,Opulski,2,0.00058,76655,22.38795,342394
6328,orsinium,2,0.00058,76657,22.38853,342394
6329,OscarDHdz,2,0.00058,76659,22.38912,342394
6330,osheratias,2,0.00058,76661,22.38970,342394
6331,otaqatqa,2,0.00058,76663,22.39029,342394
6332,overmeulen,2,0.00058,76665,22.39087,342394
6333,ovidiubuligan,2,0.00058,76667,22.39146,342394
6334,ownnaruto,2,0.00058,76669,22.39204,342394
6335,ozkansari37,2,0.00058,76671,22.39262,342394
6336,ozzy-ext,2,0.00058,76673,22.39321,342394
6337,p3lim,2,0.00058,76675,22.39379,342394
6338,pa4h1u3-BRONGA,2,0.00058,76677,22.39438,342394
6339,pabloaguilar,2,0.00058,76679,22.39496,342394
6340,pabloopez,2,0.00058,76681,22.39554,342394
6341,pacoguzman,2,0.00058,76683,22.39613,342394
6342,padupe,2,0.00058,76685,22.39671,342394
6343,paihu,2,0.00058,76687,22.39730,342394
6344,paleozogt,2,0.00058,76689,22.39788,342394
6345,panaji,2,0.00058,76691,22.39846,342394
6346,panesofglass,2,0.00058,76693,22.39905,342394
6347,panol,2,0.00058,76695,22.39963,342394
6348,Panxu1219,2,0.00058,76697,22.40022,342394
6349,panzhongxian,2,0.00058,76699,22.40080,342394
6350,paoloambrosio-skyuk,2,0.00058,76701,22.40139,342394
6351,paprickar,2,0.00058,76703,22.40197,342394
6352,parberge,2,0.00058,76705,22.40255,342394
6353,parkwart,2,0.00058,76707,22.40314,342394
6354,patchon,2,0.00058,76709,22.40372,342394
6355,paterson-deshommes,2,0.00058,76711,22.40431,342394
6356,patrickdappollonio,2,0.00058,76713,22.40489,342394
6357,patrickhuber,2,0.00058,76715,22.40547,342394
6358,PatrikSteuer,2,0.00058,76717,22.40606,342394
6359,patrungel,2,0.00058,76719,22.40664,342394
6360,patst,2,0.00058,76721,22.40723,342394
6361,paulparkinson,2,0.00058,76723,22.40781,342394
6362,Pavan976,2,0.00058,76725,22.40840,342394
6363,pavlospt,2,0.00058,76727,22.40898,342394
6364,paxnil,2,0.00058,76729,22.40956,342394
6365,pbloed,2,0.00058,76731,22.41015,342394
6366,pclata,2,0.00058,76733,22.41073,342394
6367,pdefreitas,2,0.00058,76735,22.41132,342394
6368,pealtrufo,2,0.00058,76737,22.41190,342394
6369,pedro-correia-tech,2,0.00058,76739,22.41248,342394
6370,peedrr,2,0.00058,76741,22.41307,342394
6371,pengweiqhca,2,0.00058,76743,22.41365,342394
6372,petef19,2,0.00058,76745,22.41424,342394
6373,pete-gillin-privitar,2,0.00058,76747,22.41482,342394
6374,peteole,2,0.00058,76749,22.41540,342394
6375,peter-alegeus,2,0.00058,76751,22.41599,342394
6376,petermant,2,0.00058,76753,22.41657,342394
6377,petermicuch,2,0.00058,76755,22.41716,342394
6378,petershaw,2,0.00058,76757,22.41774,342394
6379,peterska,2,0.00058,76759,22.41833,342394
6380,peterzhu2118,2,0.00058,76761,22.41891,342394
6381,PeteX,2,0.00058,76763,22.41949,342394
6382,petreski,2,0.00058,76765,22.42008,342394
6383,petrkr,2,0.00058,76767,22.42066,342394
6384,pevers,2,0.00058,76769,22.42125,342394
6385,pgeler,2,0.00058,76771,22.42183,342394
6386,phial3,2,0.00058,76773,22.42241,342394
6387,philwc,2,0.00058,76775,22.42300,342394
6388,phpboyscout,2,0.00058,76777,22.42358,342394
6389,phuongleeo,2,0.00058,76779,22.42417,342394
6390,piermotte,2,0.00058,76781,22.42475,342394
6391,pikhovkin,2,0.00058,76783,22.42533,342394
6392,pillamk,2,0.00058,76785,22.42592,342394
6393,pinghe,2,0.00058,76787,22.42650,342394
6394,pipijiev12,2,0.00058,76789,22.42709,342394
6395,piyushgupta1551,2,0.00058,76791,22.42767,342394
6396,pjaton,2,0.00058,76793,22.42826,342394
6397,placydo,2,0.00058,76795,22.42884,342394
6398,player-two,2,0.00058,76797,22.42942,342394
6399,PlayMTL,2,0.00058,76799,22.43001,342394
6400,plektra,2,0.00058,76801,22.43059,342394
6401,plko345,2,0.00058,76803,22.43118,342394
6402,PlugFox,2,0.00058,76805,22.43176,342394
6403,Pluggi,2,0.00058,76807,22.43234,342394
6404,pnemtsev,2,0.00058,76809,22.43293,342394
6405,po45ke95,2,0.00058,76811,22.43351,342394
6406,poblin-orange,2,0.00058,76813,22.43410,342394
6407,Pockerman20,2,0.00058,76815,22.43468,342394
6408,PODU,2,0.00058,76817,22.43526,342394
6409,polskomleko,2,0.00058,76819,22.43585,342394
6410,poonampawar28,2,0.00058,76821,22.43643,342394
6411,possani,2,0.00058,76823,22.43702,342394
6412,powerpistn,2,0.00058,76825,22.43760,342394
6413,PPadi,2,0.00058,76827,22.43819,342394
6414,ppedrozzi,2,0.00058,76829,22.43877,342394
6415,ppenzo,2,0.00058,76831,22.43935,342394
6416,pqchi,2,0.00058,76833,22.43994,342394
6417,pquadri,2,0.00058,76835,22.44052,342394
6418,pr7prashant,2,0.00058,76837,22.44111,342394
6419,prabhakarreddy1234,2,0.00058,76839,22.44169,342394
6420,prabhsimransingh,2,0.00058,76841,22.44227,342394
6421,prabin-acharya,2,0.00058,76843,22.44286,342394
6422,pranab-bajpai,2,0.00058,76845,22.44344,342394
6423,pranshu256,2,0.00058,76847,22.44403,342394
6424,prasanna2692,2,0.00058,76849,22.44461,342394
6425,Prashanth-M,2,0.00058,76851,22.44519,342394
6426,prasus,2,0.00058,76853,22.44578,342394
6427,PratikBorhade302,2,0.00058,76855,22.44636,342394
6428,praveenpds,2,0.00058,76857,22.44695,342394
6429,prazumovsky,2,0.00058,76859,22.44753,342394
6430,prbakhsh,2,0.00058,76861,22.44812,342394
6431,Preeti214,2,0.00058,76863,22.44870,342394
6432,PrestonTaylor,2,0.00058,76865,22.44928,342394
6433,primeroz,2,0.00058,76867,22.44987,342394
6434,PriyaTenneti,2,0.00058,76869,22.45045,342394
6435,prnvkv,2,0.00058,76871,22.45104,342394
6436,ProbStub,2,0.00058,76873,22.45162,342394
6437,prokher,2,0.00058,76875,22.45220,342394
6438,propertyabc,2,0.00058,76877,22.45279,342394
6439,prprasad2020,2,0.00058,76879,22.45337,342394
6440,prtk-fyndna,2,0.00058,76881,22.45396,342394
6441,prymitive,2,0.00058,76883,22.45454,342394
6442,psandhu79,2,0.00058,76885,22.45512,342394
6443,psingarakannan,2,0.00058,76887,22.45571,342394
6444,pspgit,2,0.00058,76889,22.45629,342394
6445,pturanyi,2,0.00058,76891,22.45688,342394
6446,PualCN,2,0.00058,76893,22.45746,342394
6447,PuKoren,2,0.00058,76895,22.45805,342394
6448,Purushotham233,2,0.00058,76897,22.45863,342394
6449,PxDave,2,0.00058,76899,22.45921,342394
6450,q0w,2,0.00058,76901,22.45980,342394
6451,qaas,2,0.00058,76903,22.46038,342394
6452,Qasim-Aziz,2,0.00058,76905,22.46097,342394
6453,qazaqstan2025,2,0.00058,76907,22.46155,342394
6454,QH2333,2,0.00058,76909,22.46213,342394
6455,qiaohao9,2,0.00058,76911,22.46272,342394
6456,qingtianlanyue,2,0.00058,76913,22.46330,342394
6457,Q-jy,2,0.00058,76915,22.46389,342394
6458,qnxrahul,2,0.00058,76917,22.46447,342394
6459,qoddiapps,2,0.00058,76919,22.46505,342394
6460,Quantum-Sicarius,2,0.00058,76921,22.46564,342394
6461,quijones,2,0.00058,76923,22.46622,342394
6462,quulah,2,0.00058,76925,22.46681,342394
6463,QWERTY92009,2,0.00058,76927,22.46739,342394
6464,qzdl,2,0.00058,76929,22.46798,342394
6465,r10r,2,0.00058,76931,22.46856,342394
6466,r32rtb,2,0.00058,76933,22.46914,342394
6467,raarts,2,0.00058,76935,22.46973,342394
6468,raefezzeldin,2,0.00058,76937,22.47031,342394
6469,RafaelMoreira1180778,2,0.00058,76939,22.47090,342394
6470,rafaelreinert,2,0.00058,76941,22.47148,342394
6471,rafernandez,2,0.00058,76943,22.47206,342394
6472,raghanag,2,0.00058,76945,22.47265,342394
6473,raghvenders,2,0.00058,76947,22.47323,342394
6474,rahulkumarsingh73690,2,0.00058,76949,22.47382,342394
6475,raidancampbell,2,0.00058,76951,22.47440,342394
6476,raildo,2,0.00058,76953,22.47498,342394
6477,rainwolf01,2,0.00058,76955,22.47557,342394
6478,RaiqaRasool,2,0.00058,76957,22.47615,342394
6479,RajAdittan,2,0.00058,76959,22.47674,342394
6480,rajeshdeshpande02,2,0.00058,76961,22.47732,342394
6481,rajeshpanara,2,0.00058,76963,22.47791,342394
6482,raklev20,2,0.00058,76965,22.47849,342394
6483,ralgozino,2,0.00058,76967,22.47907,342394
6484,ralucas,2,0.00058,76969,22.47966,342394
6485,ranger-huang,2,0.00058,76971,22.48024,342394
6486,ranjith-vatakkeel,2,0.00058,76973,22.48083,342394
6487,ranyuanyuan,2,0.00058,76975,22.48141,342394
6488,raonelakurti,2,0.00058,76977,22.48199,342394
6489,raphaklaus,2,0.00058,76979,22.48258,342394
6490,ratheeshtv,2,0.00058,76981,22.48316,342394
6491,raviepgithub,2,0.00058,76983,22.48375,342394
6492,ravi-kp,2,0.00058,76985,22.48433,342394
6493,raviprasanthgit,2,0.00058,76987,22.48492,342394
6494,raymyers,2,0.00058,76989,22.48550,342394
6495,rcomanne,2,0.00058,76991,22.48608,342394
6496,rcruz63,2,0.00058,76993,22.48667,342394
6497,rdiez,2,0.00058,76995,22.48725,342394
6498,rdpsin,2,0.00058,76997,22.48784,342394
6499,realksj,2,0.00058,76999,22.48842,342394
6500,real-zony,2,0.00058,77001,22.48900,342394
6501,recobe182,2,0.00058,77003,22.48959,342394
6502,RedBoneZhang,2,0.00058,77005,22.49017,342394
6503,regmarmcem,2,0.00058,77007,22.49076,342394
6504,renedapra,2,0.00058,77009,22.49134,342394
6505,rene-dekker,2,0.00058,77011,22.49192,342394
6506,renehernandez,2,0.00058,77013,22.49251,342394
6507,RevRebel,2,0.00058,77015,22.49309,342394
6508,rexagod,2,0.00058,77017,22.49368,342394
6509,rgueldem,2,0.00058,77019,22.49426,342394
6510,Ri0n,2,0.00058,77021,22.49485,342394
6511,riazarbi,2,0.00058,77023,22.49543,342394
6512,richardscarrott,2,0.00058,77025,22.49601,342394
6513,RichieMcG,2,0.00058,77027,22.49660,342394
6514,rickyes,2,0.00058,77029,22.49718,342394
6515,ricosega,2,0.00058,77031,22.49777,342394
6516,ridwanmsharif,2,0.00058,77033,22.49835,342394
6517,rishabhindoria,2,0.00058,77035,22.49893,342394
6518,riveryc,2,0.00058,77037,22.49952,342394
6519,RixTmobilender,2,0.00058,77039,22.50010,342394
6520,riyad,2,0.00058,77041,22.50069,342394
6521,RiyaGaniga-avi,2,0.00058,77043,22.50127,342394
6522,rjacks161,2,0.00058,77045,22.50185,342394
6523,rkazak,2,0.00058,77047,22.50244,342394
6524,rkolesnev,2,0.00058,77049,22.50302,342394
6525,rkress3,2,0.00058,77051,22.50361,342394
6526,rkudryashov,2,0.00058,77053,22.50419,342394
6527,rmartinsjr,2,0.00058,77055,22.50478,342394
6528,Robert-Christensen-visa,2,0.00058,77057,22.50536,342394
6529,RobertDWhite,2,0.00058,77059,22.50594,342394
6530,robinshine,2,0.00058,77061,22.50653,342394
6531,robjuz,2,0.00058,77063,22.50711,342394
6532,rochaudhari,2,0.00058,77065,22.50770,342394
6533,rockwyc992,2,0.00058,77067,22.50828,342394
6534,rodiongork-genestack,2,0.00058,77069,22.50886,342394
6535,rodrigoreis,2,0.00058,77071,22.50945,342394
6536,roee88,2,0.00058,77073,22.51003,342394
6537,rogalv,2,0.00058,77075,22.51062,342394
6538,rohithv1997,2,0.00058,77077,22.51120,342394
6539,rohityadavcloud,2,0.00058,77079,22.51178,342394
6540,rojamajor,2,0.00058,77081,22.51237,342394
6541,rolaca11,2,0.00058,77083,22.51295,342394
6542,roland-haeusler,2,0.00058,77085,22.51354,342394
6543,roman-76,2,0.00058,77087,22.51412,342394
6544,RomeroGaliza,2,0.00058,77089,22.51471,342394
6545,romuald,2,0.00058,77091,22.51529,342394
6546,RookiesBoy,2,0.00058,77093,22.51587,342394
6547,rootdeep,2,0.00058,77095,22.51646,342394
6548,roshanirathi,2,0.00058,77097,22.51704,342394
6549,Roshick,2,0.00058,77099,22.51763,342394
6550,Rossalli,2,0.00058,77101,22.51821,342394
6551,roy-ht,2,0.00058,77103,22.51879,342394
6552,royi-frontegg,2,0.00058,77105,22.51938,342394
6553,roylkng,2,0.00058,77107,22.51996,342394
6554,rozingmichael,2,0.00058,77109,22.52055,342394
6555,ROZKOV,2,0.00058,77111,22.52113,342394
6556,rpark4,2,0.00058,77113,22.52171,342394
6557,rpenugonda,2,0.00058,77115,22.52230,342394
6558,rrraditya,2,0.00058,77117,22.52288,342394
6559,rsafonseca,2,0.00058,77119,22.52347,342394
6560,rscottwatson,2,0.00058,77121,22.52405,342394
6561,rsong0606,2,0.00058,77123,22.52464,342394
6562,rss04,2,0.00058,77125,22.52522,342394
6563,rstoermer,2,0.00058,77127,22.52580,342394
6564,rtmrtmrtmrtm,2,0.00058,77129,22.52639,342394
6565,ruanben,2,0.00058,77131,22.52697,342394
6566,ruatag,2,0.00058,77133,22.52756,342394
6567,rudian,2,0.00058,77135,22.52814,342394
6568,Rudy167,2,0.00058,77137,22.52872,342394
6569,rufreakde,2,0.00058,77139,22.52931,342394
6570,runakash,2,0.00058,77141,22.52989,342394
6571,runner-mei,2,0.00058,77143,22.53048,342394
6572,rupinder10,2,0.00058,77145,22.53106,342394
6573,rurus9,2,0.00058,77147,22.53164,342394
6574,rushikeshadhav,2,0.00058,77149,22.53223,342394
6575,RyanCallahan312,2,0.00058,77151,22.53281,342394
6576,ryou90,2,0.00058,77153,22.53340,342394
6577,s0ar,2,0.00058,77155,22.53398,342394
6578,s12v,2,0.00058,77157,22.53457,342394
6579,s1apped,2,0.00058,77159,22.53515,342394
6580,sablumiah,2,0.00058,77161,22.53573,342394
6581,sacrex,2,0.00058,77163,22.53632,342394
6582,sadahiroyoshi,2,0.00058,77165,22.53690,342394
6583,SahilMutha,2,0.00058,77167,22.53749,342394
6584,saifali40,2,0.00058,77169,22.53807,342394
6585,saintdle,2,0.00058,77171,22.53865,342394
6586,salineselin,2,0.00058,77173,22.53924,342394
6587,samfullman,2,0.00058,77175,22.53982,342394
6588,sana-jawad,2,0.00058,77177,22.54041,342394
6589,sandipb,2,0.00058,77179,22.54099,342394
6590,santhoshs123,2,0.00058,77181,22.54157,342394
6591,saparaj,2,0.00058,77183,22.54216,342394
6592,saphoooo,2,0.00058,77185,22.54274,342394
6593,sarath-pillai,2,0.00058,77187,22.54333,342394
6594,sarvajit-sankar-comprinno,2,0.00058,77189,22.54391,342394
6595,sayantanu-dey,2,0.00058,77191,22.54450,342394
6596,sayap,2,0.00058,77193,22.54508,342394
6597,sb-ev,2,0.00058,77195,22.54566,342394
6598,sbkurahatti,2,0.00058,77197,22.54625,342394
6599,sblausten,2,0.00058,77199,22.54683,342394
6600,sbrass,2,0.00058,77201,22.54742,342394
6601,scabana,2,0.00058,77203,22.54800,342394
6602,scah2021,2,0.00058,77205,22.54858,342394
6603,scarlet25151,2,0.00058,77207,22.54917,342394
6604,scevallos,2,0.00058,77209,22.54975,342394
6605,schneems,2,0.00058,77211,22.55034,342394
6606,schneesu,2,0.00058,77213,22.55092,342394
6607,SCIF,2,0.00058,77215,22.55150,342394
6608,SCLogo,2,0.00058,77217,22.55209,342394
6609,scoof,2,0.00058,77219,22.55267,342394
6610,scottasmith,2,0.00058,77221,22.55326,342394
6611,ScottShingler,2,0.00058,77223,22.55384,342394
6612,sdettmer,2,0.00058,77225,22.55443,342394
6613,sdudley,2,0.00058,77227,22.55501,342394
6614,sdwerwed,2,0.00058,77229,22.55559,342394
6615,seanocca,2,0.00058,77231,22.55618,342394
6616,sean-scott-lr,2,0.00058,77233,22.55676,342394
6617,SebastianBakala-TomTom,2,0.00058,77235,22.55735,342394
6618,sebastien-coavoux,2,0.00058,77237,22.55793,342394
6619,sebirdman,2,0.00058,77239,22.55851,342394
6620,sedat-eyuboglu,2,0.00058,77241,22.55910,342394
6621,sed-i,2,0.00058,77243,22.55968,342394
6622,seedsunrise1,2,0.00058,77245,22.56027,342394
6623,seiya-annie,2,0.00058,77247,22.56085,342394
6624,senthil13,2,0.00058,77249,22.56144,342394
6625,sepich,2,0.00058,77251,22.56202,342394
6626,SerenaTiede-Zen,2,0.00058,77253,22.56260,342394
6627,serge-r,2,0.00058,77255,22.56319,342394
6628,sergeyberezansky,2,0.00058,77257,22.56377,342394
6629,Sergiodcm00,2,0.00058,77259,22.56436,342394
6630,serhatYilmazz,2,0.00058,77261,22.56494,342394
6631,sh777,2,0.00058,77263,22.56552,342394
6632,shaaaarpy,2,0.00058,77265,22.56611,342394
6633,Shaked,2,0.00058,77267,22.56669,342394
6634,shakeerahamed,2,0.00058,77269,22.56728,342394
6635,shakuzen,2,0.00058,77271,22.56786,342394
6636,shangjin92,2,0.00058,77273,22.56844,342394
6637,shanisma,2,0.00058,77275,22.56903,342394
6638,shanthini385,2,0.00058,77277,22.56961,342394
6639,Shanti-G,2,0.00058,77279,22.57020,342394
6640,shaohq,2,0.00058,77281,22.57078,342394
6641,sharpevo,2,0.00058,77283,22.57137,342394
6642,Shashankft9,2,0.00058,77285,22.57195,342394
6643,shashank-omre-cldcvr,2,0.00058,77287,22.57253,342394
6644,shashankpai,2,0.00058,77289,22.57312,342394
6645,shatilov-diman,2,0.00058,77291,22.57370,342394
6646,shatoboar,2,0.00058,77293,22.57429,342394
6647,shayneofficer,2,0.00058,77295,22.57487,342394
6648,sheabot,2,0.00058,77297,22.57545,342394
6649,Sheldonwl,2,0.00058,77299,22.57604,342394
6650,shenningz,2,0.00058,77301,22.57662,342394
6651,shevelevs,2,0.00058,77303,22.57721,342394
6652,shifeichen,2,0.00058,77305,22.57779,342394
6653,shijieqin,2,0.00058,77307,22.57837,342394
6654,shimont,2,0.00058,77309,22.57896,342394
6655,shirleyleu,2,0.00058,77311,22.57954,342394
6656,shishirkh,2,0.00058,77313,22.58013,342394
6657,shitian-ni,2,0.00058,77315,22.58071,342394
6658,ShivankPro,2,0.00058,77317,22.58130,342394
6659,ShiwenSun,2,0.00058,77319,22.58188,342394
6660,shixinghong,2,0.00058,77321,22.58246,342394
6661,shkerh,2,0.00058,77323,22.58305,342394
6662,shomeprasanjit,2,0.00058,77325,22.58363,342394
6663,shou1dwe,2,0.00058,77327,22.58422,342394
6664,shreevatsa,2,0.00058,77329,22.58480,342394
6665,shrikanta8,2,0.00058,77331,22.58538,342394
6666,shriroopjoshi,2,0.00058,77333,22.58597,342394
6667,shubhamxshup,2,0.00058,77335,22.58655,342394
6668,shuebner,2,0.00058,77337,22.58714,342394
6669,shulianwang,2,0.00058,77339,22.58772,342394
6670,siddhantprateek,2,0.00058,77341,22.58830,342394
6671,sidverma32,2,0.00058,77343,22.58889,342394
6672,siepkes,2,0.00058,77345,22.58947,342394
6673,signaleleven,2,0.00058,77347,22.59006,342394
6674,SijmenHuizenga,2,0.00058,77349,22.59064,342394
6675,SilvaMatteus,2,0.00058,77351,22.59123,342394
6676,silverwind,2,0.00058,77353,22.59181,342394
6677,simha5009,2,0.00058,77355,22.59239,342394
6678,simon-anz,2,0.00058,77357,22.59298,342394
6679,simon-geard,2,0.00058,77359,22.59356,342394
6680,SinghCoder,2,0.00058,77361,22.59415,342394
6681,sinsay,2,0.00058,77363,22.59473,342394
6682,sipirsipirmin,2,0.00058,77365,22.59531,342394
6683,siqjonathan,2,0.00058,77367,22.59590,342394
6684,siris,2,0.00058,77369,22.59648,342394
6685,Sir-Jacques,2,0.00058,77371,22.59707,342394
6686,sirredbeard,2,0.00058,77373,22.59765,342394
6687,sixeIa,2,0.00058,77375,22.59823,342394
6688,sjdweb,2,0.00058,77377,22.59882,342394
6689,sjkummer,2,0.00058,77379,22.59940,342394
6690,sjnester,2,0.00058,77381,22.59999,342394
6691,sj-porter-knime,2,0.00058,77383,22.60057,342394
6692,sk8forether,2,0.00058,77385,22.60116,342394
6693,skinnyxpuppy,2,0.00058,77387,22.60174,342394
6694,skolodyazhnyy,2,0.00058,77389,22.60232,342394
6695,Skunnyk,2,0.00058,77391,22.60291,342394
6696,slrom,2,0.00058,77393,22.60349,342394
6697,Slyracoon23,2,0.00058,77395,22.60408,342394
6698,smanjunath3,2,0.00058,77397,22.60466,342394
6699,smartbit,2,0.00058,77399,22.60524,342394
6700,Smitholi67,2,0.00058,77401,22.60583,342394
6701,SmokeDawg92967,2,0.00058,77403,22.60641,342394
6702,SmruthiManjunath,2,0.00058,77405,22.60700,342394
6703,Sn-Kinos,2,0.00058,77407,22.60758,342394
6704,sobrinho,2,0.00058,77409,22.60816,342394
6705,sohailhaider,2,0.00058,77411,22.60875,342394
6706,sopalsuemae,2,0.00058,77413,22.60933,342394
6707,sosoftmandruszak,2,0.00058,77415,22.60992,342394
6708,sotowang,2,0.00058,77417,22.61050,342394
6709,sourav-anand1,2,0.00058,77419,22.61109,342394
6710,SouravEegrab,2,0.00058,77421,22.61167,342394
6711,speedyguy17,2,0.00058,77423,22.61225,342394
6712,spencerrung,2,0.00058,77425,22.61284,342394
6713,splitice,2,0.00058,77427,22.61342,342394
6714,Sprakhar97,2,0.00058,77429,22.61401,342394
6715,spr-mweber3,2,0.00058,77431,22.61459,342394
6716,sree-warrier,2,0.00058,77433,22.61517,342394
6717,srikanthsava,2,0.00058,77435,22.61576,342394
6718,srinidhis94,2,0.00058,77437,22.61634,342394
6719,srinivasr-accuknox,2,0.00058,77439,22.61693,342394
6720,srouil,2,0.00058,77441,22.61751,342394
6721,sspreitzer,2,0.00058,77443,22.61809,342394
6722,SSSCeph,2,0.00058,77445,22.61868,342394
6723,sstone1,2,0.00058,77447,22.61926,342394
6724,ssurovich,2,0.00058,77449,22.61985,342394
6725,stanosamek,2,0.00058,77451,22.62043,342394
6726,stasyanich,2,0.00058,77453,22.62102,342394
6727,std4453,2,0.00058,77455,22.62160,342394
6728,steevi,2,0.00058,77457,22.62218,342394
6729,stephpalis,2,0.00058,77459,22.62277,342394
6730,stevefan1999-personal,2,0.00058,77461,22.62335,342394
6731,steveh,2,0.00058,77463,22.62394,342394
6732,stevejr,2,0.00058,77465,22.62452,342394
6733,stevek-pro,2,0.00058,77467,22.62510,342394
6734,SteveL1,2,0.00058,77469,22.62569,342394
6735,stevenarvar,2,0.00058,77471,22.62627,342394
6736,stevenhorsman,2,0.00058,77473,22.62686,342394
6737,stg-0,2,0.00058,77475,22.62744,342394
6738,sthartmannsopra,2,0.00058,77477,22.62803,342394
6739,stieglma,2,0.00058,77479,22.62861,342394
6740,stokito,2,0.00058,77481,22.62919,342394
6741,stolsvik,2,0.00058,77483,22.62978,342394
6742,storehubdeploy,2,0.00058,77485,22.63036,342394
6743,stuartdrennan,2,0.00058,77487,22.63095,342394
6744,stuartpreston,2,0.00058,77489,22.63153,342394
6745,suazithustra,2,0.00058,77491,22.63211,342394
6746,subbusquareshift,2,0.00058,77493,22.63270,342394
6747,subodhkumar95340,2,0.00058,77495,22.63328,342394
6748,SubtextRyan,2,0.00058,77497,22.63387,342394
6749,sudhabindu1,2,0.00058,77499,22.63445,342394
6750,sujithktkm,2,0.00058,77501,22.63503,342394
6751,sumitbaurai,2,0.00058,77503,22.63562,342394
6752,sumitdhameja,2,0.00058,77505,22.63620,342394
6753,sumitkumarm,2,0.00058,77507,22.63679,342394
6754,sunng87,2,0.00058,77509,22.63737,342394
6755,Sunyelw,2,0.00058,77511,22.63796,342394
6756,Suozz,2,0.00058,77513,22.63854,342394
6757,sverrehu,2,0.00058,77515,22.63912,342394
6758,svoruga,2,0.00058,77517,22.63971,342394
6759,svpace,2,0.00058,77519,22.64029,342394
6760,Svuibes6,2,0.00058,77521,22.64088,342394
6761,SWarnberg,2,0.00058,77523,22.64146,342394
6762,swathi-1227,2,0.00058,77525,22.64204,342394
6763,SxunS,2,0.00058,77527,22.64263,342394
6764,sydorovdmytro,2,0.00058,77529,22.64321,342394
6765,Syfaro,2,0.00058,77531,22.64380,342394
6766,systems1,2,0.00058,77533,22.64438,342394
6767,t1murl,2,0.00058,77535,22.64496,342394
6768,Tailzip,2,0.00058,77537,22.64555,342394
6769,tallaxes,2,0.00058,77539,22.64613,342394
6770,tamarareblaze,2,0.00058,77541,22.64672,342394
6771,tamis-laan,2,0.00058,77543,22.64730,342394
6772,Tammyxia,2,0.00058,77545,22.64789,342394
6773,tangmengqiu,2,0.00058,77547,22.64847,342394
6774,tangyfruits,2,0.00058,77549,22.64905,342394
6775,taotieren,2,0.00058,77551,22.64964,342394
6776,tap52384,2,0.00058,77553,22.65022,342394
6777,tarasmatsyk,2,0.00058,77555,22.65081,342394
6778,tardyp,2,0.00058,77557,22.65139,342394
6779,tarungulati1988,2,0.00058,77559,22.65197,342394
6780,tatsu-yam,2,0.00058,77561,22.65256,342394
6781,taylorchu,2,0.00058,77563,22.65314,342394
6782,tbrodbeck,2,0.00058,77565,22.65373,342394
6783,tclayton-newr,2,0.00058,77567,22.65431,342394
6784,tcoupin,2,0.00058,77569,22.65489,342394
6785,tculp,2,0.00058,77571,22.65548,342394
6786,TechDawg270,2,0.00058,77573,22.65606,342394
6787,telukir,2,0.00058,77575,22.65665,342394
6788,tensor5,2,0.00058,77577,22.65723,342394
6789,tenstad,2,0.00058,77579,22.65782,342394
6790,teqwve,2,0.00058,77581,22.65840,342394
6791,testov2001,2,0.00058,77583,22.65898,342394
6792,TFTomSun,2,0.00058,77585,22.65957,342394
6793,thatguyfig,2,0.00058,77587,22.66015,342394
6794,TheApeMachine,2,0.00058,77589,22.66074,342394
6795,TheKangaroo,2,0.00058,77591,22.66132,342394
6796,the-maldridge,2,0.00058,77593,22.66190,342394
6797,theoamonteiro,2,0.00058,77595,22.66249,342394
6798,theperm,2,0.00058,77597,22.66307,342394
6799,TheRealMoP,2,0.00058,77599,22.66366,342394
6800,theXodus,2,0.00058,77601,22.66424,342394
6801,ThibaultLengagne,2,0.00058,77603,22.66482,342394
6802,thibautmery,2,0.00058,77605,22.66541,342394
6803,Thiritin,2,0.00058,77607,22.66599,342394
6804,Thirumalai-Shaktivel,2,0.00058,77609,22.66658,342394
6805,ThomasBarach,2,0.00058,77611,22.66716,342394
6806,thomassa,2,0.00058,77613,22.66775,342394
6807,ThorstenReichert,2,0.00058,77615,22.66833,342394
6808,thpham,2,0.00058,77617,22.66891,342394
6809,throwawayaccount0153,2,0.00058,77619,22.66950,342394
6810,thyarles,2,0.00058,77621,22.67008,342394
6811,TiagoGoddard,2,0.00058,77623,22.67067,342394
6812,tibcoplord,2,0.00058,77625,22.67125,342394
6813,timbuchwaldt,2,0.00058,77627,22.67183,342394
6814,timburnet-systematica,2,0.00058,77629,22.67242,342394
6815,timchenxiaoyu,2,0.00058,77631,22.67300,342394
6816,timeshift92,2,0.00058,77633,22.67359,342394
6817,timgates42,2,0.00058,77635,22.67417,342394
6818,timharsch,2,0.00058,77637,22.67475,342394
6819,TimisRobert,2,0.00058,77639,22.67534,342394
6820,timjnh,2,0.00058,77641,22.67592,342394
6821,Timoses,2,0.00058,77643,22.67651,342394
6822,TimothyMothra,2,0.00058,77645,22.67709,342394
6823,timurb,2,0.00058,77647,22.67768,342394
6824,timwaizenegger,2,0.00058,77649,22.67826,342394
6825,tina9253,2,0.00058,77651,22.67884,342394
6826,Tinche,2,0.00058,77653,22.67943,342394
6827,tinyc-z,2,0.00058,77655,22.68001,342394
6828,tirelibirefe,2,0.00058,77657,22.68060,342394
6829,tkennedy1-godaddy,2,0.00058,77659,22.68118,342394
6830,tl-maisie-sadler,2,0.00058,77661,22.68176,342394
6831,tmalinakis-vng,2,0.00058,77663,22.68235,342394
6832,tmaxanc-cloudofficial,2,0.00058,77665,22.68293,342394
6833,tmitchell10,2,0.00058,77667,22.68352,342394
6834,tnisan,2,0.00058,77669,22.68410,342394
6835,tnorlin,2,0.00058,77671,22.68468,342394
6836,todd-dsm,2,0.00058,77673,22.68527,342394
6837,toffentoffen,2,0.00058,77675,22.68585,342394
6838,tom0010,2,0.00058,77677,22.68644,342394
6839,tom1299,2,0.00058,77679,22.68702,342394
6840,TomaszKlosinski,2,0.00058,77681,22.68761,342394
6841,TomerG2,2,0.00058,77683,22.68819,342394
6842,tomerv,2,0.00058,77685,22.68877,342394
6843,tomferreira,2,0.00058,77687,22.68936,342394
6844,tomnowak,2,0.00058,77689,22.68994,342394
6845,tonybase,2,0.00058,77691,22.69053,342394
6846,tonyskapunk,2,0.00058,77693,22.69111,342394
6847,TonySma,2,0.00058,77695,22.69169,342394
6848,tooboredtocode,2,0.00058,77697,22.69228,342394
6849,topikettunen,2,0.00058,77699,22.69286,342394
6850,torgerss,2,0.00058,77701,22.69345,342394
6851,tormoder,2,0.00058,77703,22.69403,342394
6852,tpaimparay,2,0.00058,77705,22.69461,342394
6853,tpang-ameame,2,0.00058,77707,22.69520,342394
6854,tpraveen-boomplus,2,0.00058,77709,22.69578,342394
6855,TracyRagan,2,0.00058,77711,22.69637,342394
6856,travs,2,0.00058,77713,22.69695,342394
6857,TreeKat71,2,0.00058,77715,22.69754,342394
6858,treethought,2,0.00058,77717,22.69812,342394
6859,tricky42,2,0.00058,77719,22.69870,342394
6860,Tridy,2,0.00058,77721,22.69929,342394
6861,triThirty,2,0.00058,77723,22.69987,342394
6862,trv-jsmith10,2,0.00058,77725,22.70046,342394
6863,ts3ng,2,0.00058,77727,22.70104,342394
6864,tsmithv11,2,0.00058,77729,22.70162,342394
6865,tstapler,2,0.00058,77731,22.70221,342394
6866,tszngai,2,0.00058,77733,22.70279,342394
6867,tun0,2,0.00058,77735,22.70338,342394
6868,tusharbhasme,2,0.00058,77737,22.70396,342394
6869,tverlaan,2,0.00058,77739,22.70455,342394
6870,twendt,2,0.00058,77741,22.70513,342394
6871,twittyc,2,0.00058,77743,22.70571,342394
6872,TyR3x123,2,0.00058,77745,22.70630,342394
6873,tzachiabo,2,0.00058,77747,22.70688,342394
6874,uhlhosting,2,0.00058,77749,22.70747,342394
6875,ukazap,2,0.00058,77751,22.70805,342394
6876,umeshkumhar,2,0.00058,77753,22.70863,342394
6877,unckleg,2,0.00058,77755,22.70922,342394
6878,unglaublicherdude,2,0.00058,77757,22.70980,342394
6879,universam1,2,0.00058,77759,22.71039,342394
6880,Unknow0,2,0.00058,77761,22.71097,342394
6881,upils,2,0.00058,77763,22.71155,342394
6882,Uriende,2,0.00058,77765,22.71214,342394
6883,ustccy,2,0.00058,77767,22.71272,342394
6884,utk231,2,0.00058,77769,22.71331,342394
6885,utkmishr,2,0.00058,77771,22.71389,342394
6886,uynap,2,0.00058,77773,22.71448,342394
6887,v4nTh3M4n,2,0.00058,77775,22.71506,342394
6888,vaibhavvsharma,2,0.00058,77777,22.71564,342394
6889,valencetech,2,0.00058,77779,22.71623,342394
6890,vanand-conga,2,0.00058,77781,22.71681,342394
6891,Vanguard90,2,0.00058,77783,22.71740,342394
6892,VA-PLE,2,0.00058,77785,22.71798,342394
6893,varas,2,0.00058,77787,22.71856,342394
6894,varkey,2,0.00058,77789,22.71915,342394
6895,varun-lb,2,0.00058,77791,22.71973,342394
6896,vchorny,2,0.00058,77793,22.72032,342394
6897,VCuzmin,2,0.00058,77795,22.72090,342394
6898,vedant-kakde,2,0.00058,77797,22.72148,342394
6899,vediatoni,2,0.00058,77799,22.72207,342394
6900,venicetear,2,0.00058,77801,22.72265,342394
6901,vennemp,2,0.00058,77803,22.72324,342394
6902,verdie-g,2,0.00058,77805,22.72382,342394
6903,vibgy,2,0.00058,77807,22.72441,342394
6904,vicalixto,2,0.00058,77809,22.72499,342394
6905,vickiyan,2,0.00058,77811,22.72557,342394
6906,vickywane,2,0.00058,77813,22.72616,342394
6907,victorp13,2,0.00058,77815,22.72674,342394
6908,Vijayalakshmi-Yolbhavi,2,0.00058,77817,22.72733,342394
6909,vikaskumar11,2,0.00058,77819,22.72791,342394
6910,vimalagrawal,2,0.00058,77821,22.72849,342394
6911,vinu1421,2,0.00058,77823,22.72908,342394
6912,vireshas,2,0.00058,77825,22.72966,342394
6913,virzak,2,0.00058,77827,22.73025,342394
6914,vishumindtree,2,0.00058,77829,22.73083,342394
6915,visit1985,2,0.00058,77831,22.73141,342394
6916,vkatopod,2,0.00058,77833,22.73200,342394
6917,Vlad1mir-D,2,0.00058,77835,22.73258,342394
6918,vladst3f,2,0.00058,77837,22.73317,342394
6919,vnmnm,2,0.00058,77839,22.73375,342394
6920,vnshanmukh,2,0.00058,77841,22.73434,342394
6921,Volkmire,2,0.00058,77843,22.73492,342394
6922,voriol,2,0.00058,77845,22.73550,342394
6923,voyvodov,2,0.00058,77847,22.73609,342394
6924,vrangana,2,0.00058,77849,22.73667,342394
6925,Vuonganh1402,2,0.00058,77851,22.73726,342394
6926,vzuevsky,2,0.00058,77853,22.73784,342394
6927,wadexu007,2,0.00058,77855,22.73842,342394
6928,waidinsamkeit,2,0.00058,77857,22.73901,342394
6929,wang1219,2,0.00058,77859,22.73959,342394
6930,wanghe-fit2cloud,2,0.00058,77861,22.74018,342394
6931,wanghui17,2,0.00058,77863,22.74076,342394
6932,wangliguokaka,2,0.00058,77865,22.74134,342394
6933,wangpu666,2,0.00058,77867,22.74193,342394
6934,wanlerong,2,0.00058,77869,22.74251,342394
6935,wayne-thomson-iag,2,0.00058,77871,22.74310,342394
6936,wazzamatazz,2,0.00058,77873,22.74368,342394
6937,wbaker85,2,0.00058,77875,22.74427,342394
6938,wcurry,2,0.00058,77877,22.74485,342394
6939,weberc2,2,0.00058,77879,22.74543,342394
6940,weberc2-tempus,2,0.00058,77881,22.74602,342394
6941,weh,2,0.00058,77883,22.74660,342394
6942,weihao,2,0.00058,77885,22.74719,342394
6943,weiqingy,2,0.00058,77887,22.74777,342394
6944,weisdd,2,0.00058,77889,22.74835,342394
6945,wenjieguo,2,0.00058,77891,22.74894,342394
6946,wentao-zh,2,0.00058,77893,22.74952,342394
6947,wenyg,2,0.00058,77895,22.75011,342394
6948,werwolfby,2,0.00058,77897,22.75069,342394
6949,westford14,2,0.00058,77899,22.75127,342394
6950,wgchaoer,2,0.00058,77901,22.75186,342394
6951,WGH-,2,0.00058,77903,22.75244,342394
6952,whwlsfb,2,0.00058,77905,22.75303,342394
6953,wiegell,2,0.00058,77907,22.75361,342394
6954,WilliamCassanova,2,0.00058,77909,22.75420,342394
6955,williamMillington,2,0.00058,77911,22.75478,342394
6956,williamwilson,2,0.00058,77913,22.75536,342394
6957,willianpc,2,0.00058,77915,22.75595,342394
6958,WillNilges,2,0.00058,77917,22.75653,342394
6959,wilstoff,2,0.00058,77919,22.75712,342394
6960,wimvc1,2,0.00058,77921,22.75770,342394
6961,winstonww,2,0.00058,77923,22.75828,342394
6962,wl4g,2,0.00058,77925,22.75887,342394
6963,WLBF,2,0.00058,77927,22.75945,342394
6964,wmesard,2,0.00058,77929,22.76004,342394
6965,wolverian,2,0.00058,77931,22.76062,342394
6966,woodliu,2,0.00058,77933,22.76120,342394
6967,worldspawn,2,0.00058,77935,22.76179,342394
6968,WorldVirus,2,0.00058,77937,22.76237,342394
6969,worldwalk,2,0.00058,77939,22.76296,342394
6970,wpbeckwith,2,0.00058,77941,22.76354,342394
6971,wrigby,2,0.00058,77943,22.76413,342394
6972,wu105,2,0.00058,77945,22.76471,342394
6973,wxl374,2,0.00058,77947,22.76529,342394
6974,wxqchimei,2,0.00058,77949,22.76588,342394
6975,wyike,2,0.00058,77951,22.76646,342394
6976,Wykiki,2,0.00058,77953,22.76705,342394
6977,xanmanning,2,0.00058,77955,22.76763,342394
6978,Xartos,2,0.00058,77957,22.76821,342394
6979,Xaving,2,0.00058,77959,22.76880,342394
6980,xbestwiz,2,0.00058,77961,22.76938,342394
6981,xbsummer,2,0.00058,77963,22.76997,342394
6982,xbx,2,0.00058,77965,22.77055,342394
6983,xeathen,2,0.00058,77967,22.77114,342394
6984,xee5ch,2,0.00058,77969,22.77172,342394
6985,xenophonf,2,0.00058,77971,22.77230,342394
6986,xiangcai1215,2,0.00058,77973,22.77289,342394
6987,xiaobinggan-zmh,2,0.00058,77975,22.77347,342394
6988,xiaopingrubyist,2,0.00058,77977,22.77406,342394
6989,xiaoxiyouran,2,0.00058,77979,22.77464,342394
6990,xiatiandegaga,2,0.00058,77981,22.77522,342394
6991,xrbear,2,0.00058,77983,22.77581,342394
6992,xrom888,2,0.00058,77985,22.77639,342394
6993,XtremeAI,2,0.00058,77987,22.77698,342394
6994,xueqzhan,2,0.00058,77989,22.77756,342394
6995,xuhuajie,2,0.00058,77991,22.77814,342394
6996,Yadumathur,2,0.00058,77993,22.77873,342394
6997,yalctay93,2,0.00058,77995,22.77931,342394
6998,Yamaha32088,2,0.00058,77997,22.77990,342394
6999,yang1626,2,0.00058,77999,22.78048,342394
7000,yardenshoham,2,0.00058,78001,22.78107,342394
7001,yasiboni-max,2,0.00058,78003,22.78165,342394
7002,yasim21c,2,0.00058,78005,22.78223,342394
7003,yati1998,2,0.00058,78007,22.78282,342394
7004,yayaha,2,0.00058,78009,22.78340,342394
7005,ycai-aspen,2,0.00058,78011,22.78399,342394
7006,YC-git,2,0.00058,78013,22.78457,342394
7007,ycwdaaaa,2,0.00058,78015,22.78515,342394
7008,ye0321,2,0.00058,78017,22.78574,342394
7009,yehoshuadimarsky,2,0.00058,78019,22.78632,342394
7010,yenhsunli,2,0.00058,78021,22.78691,342394
7011,yfuhai,2,0.00058,78023,22.78749,342394
7012,yimiaoxiehou,2,0.00058,78025,22.78807,342394
7013,yimtcode,2,0.00058,78027,22.78866,342394
7014,yingding,2,0.00058,78029,22.78924,342394
7015,yinyanlu,2,0.00058,78031,22.78983,342394
7016,ykfq,2,0.00058,78033,22.79041,342394
7017,ylmcr7,2,0.00058,78035,22.79100,342394
7018,yoandl,2,0.00058,78037,22.79158,342394
7019,yok789456,2,0.00058,78039,22.79216,342394
7020,yoseihouyn,2,0.00058,78041,22.79275,342394
7021,yoshi314,2,0.00058,78043,22.79333,342394
7022,yo-taiji87,2,0.00058,78045,22.79392,342394
7023,yotamofek,2,0.00058,78047,22.79450,342394
7024,yps,2,0.00058,78049,22.79508,342394
7025,ypzhuang,2,0.00058,78051,22.79567,342394
7026,yuanfangdewo,2,0.00058,78053,22.79625,342394
7027,yuanhh,2,0.00058,78055,22.79684,342394
7028,YuhanZhang1998,2,0.00058,78057,22.79742,342394
7029,yunkunrao,2,0.00058,78059,22.79800,342394
7030,yuqitao,2,0.00058,78061,22.79859,342394
7031,yu-shiba,2,0.00058,78063,22.79917,342394
7032,yusufscott,2,0.00058,78065,22.79976,342394
7033,yutinghua,2,0.00058,78067,22.80034,342394
7034,yuuu11,2,0.00058,78069,22.80093,342394
7035,zahirtezcan-bugs,2,0.00058,78071,22.80151,342394
7036,zakthan,2,0.00058,78073,22.80209,342394
7037,zcola,2,0.00058,78075,22.80268,342394
7038,zczc0128,2,0.00058,78077,22.80326,342394
7039,zeaone,2,0.00058,78079,22.80385,342394
7040,zeenix,2,0.00058,78081,22.80443,342394
7041,zekenie,2,0.00058,78083,22.80501,342394
7042,zerols,2,0.00058,78085,22.80560,342394
7043,zeshan321,2,0.00058,78087,22.80618,342394
7044,zevweiss,2,0.00058,78089,22.80677,342394
7045,zfalen-deloitte,2,0.00058,78091,22.80735,342394
7046,zhaojinxin409,2,0.00058,78093,22.80793,342394
7047,zhaoyuepj,2,0.00058,78095,22.80852,342394
7048,zhengyansheng,2,0.00058,78097,22.80910,342394
7049,zhenyu-lan,2,0.00058,78099,22.80969,342394
7050,zhenyuxie,2,0.00058,78101,22.81027,342394
7051,zhiyuone,2,0.00058,78103,22.81086,342394
7052,zhj-hx,2,0.00058,78105,22.81144,342394
7053,zhming0,2,0.00058,78107,22.81202,342394
7054,Zhouhao12345,2,0.00058,78109,22.81261,342394
7055,ZhouZhongzhi,2,0.00058,78111,22.81319,342394
7056,zikhan,2,0.00058,78113,22.81378,342394
7057,ziyi-xie,2,0.00058,78115,22.81436,342394
7058,zkking,2,0.00058,78117,22.81494,342394
7059,zm1990s,2,0.00058,78119,22.81553,342394
7060,zoetrope,2,0.00058,78121,22.81611,342394
7061,zolbarna,2,0.00058,78123,22.81670,342394
7062,zolug,2,0.00058,78125,22.81728,342394
7063,zoomoid,2,0.00058,78127,22.81786,342394
7064,zopanix,2,0.00058,78129,22.81845,342394
7065,zoulux,2,0.00058,78131,22.81903,342394
7066,zout,2,0.00058,78133,22.81962,342394
7067,zoux86,2,0.00058,78135,22.82020,342394
7068,zouyonghao,2,0.00058,78137,22.82079,342394
7069,zsmav,2,0.00058,78139,22.82137,342394
7070,ztzxt,2,0.00058,78141,22.82195,342394
7071,ZxYuan,2,0.00058,78143,22.82254,342394
7072,zzhzero,2,0.00058,78145,22.82312,342394
7073,0l1v3r5,1,0.00029,78146,22.82341,342394
7074,0mp,1,0.00029,78147,22.82371,342394
7075,0x2C6,1,0.00029,78148,22.82400,342394
7076,0x53A,1,0.00029,78149,22.82429,342394
7077,0x6a77,1,0.00029,78150,22.82458,342394
7078,0x91,1,0.00029,78151,22.82487,342394
7079,0xAP,1,0.00029,78152,22.82517,342394
7080,0xD3,1,0.00029,78153,22.82546,342394
7081,0xdreadnaught,1,0.00029,78154,22.82575,342394
7082,0xpr03,1,0.00029,78155,22.82604,342394
7083,0xStarcat,1,0.00029,78156,22.82633,342394
7084,100daysofdevops,1,0.00029,78157,22.82663,342394
7085,10hin,1,0.00029,78158,22.82692,342394
7086,121jfc,1,0.00029,78159,22.82721,342394
7087,13164815445,1,0.00029,78160,22.82750,342394
7088,13667285528,1,0.00029,78161,22.82779,342394
7089,172prateek,1,0.00029,78162,22.82809,342394
7090,17billion,1,0.00029,78163,22.82838,342394
7091,18300618319,1,0.00029,78164,22.82867,342394
7092,1iza,1,0.00029,78165,22.82896,342394
7093,1tft,1,0.00029,78166,22.82926,342394
7094,21sahilsethi,1,0.00029,78167,22.82955,342394
7095,24601,1,0.00029,78168,22.82984,342394
7096,2Bor2C,1,0.00029,78169,22.83013,342394
7097,2kindsofcs,1,0.00029,78170,22.83042,342394
7098,2nd-half,1,0.00029,78171,22.83072,342394
7099,3deep5me,1,0.00029,78172,22.83101,342394
7100,42wim,1,0.00029,78173,22.83130,342394
7101,4fath,1,0.00029,78174,22.83159,342394
7102,616b2f,1,0.00029,78175,22.83188,342394
7103,651016236,1,0.00029,78176,22.83218,342394
7104,662,1,0.00029,78177,22.83247,342394
7105,66545shiwo,1,0.00029,78178,22.83276,342394
7106,670205427,1,0.00029,78179,22.83305,342394
7107,78188869,1,0.00029,78180,22.83334,342394
7108,78Star,1,0.00029,78181,22.83364,342394
7109,844067874,1,0.00029,78182,22.83393,342394
7110,906798724,1,0.00029,78183,22.83422,342394
7111,914268308,1,0.00029,78184,22.83451,342394
7112,93425129,1,0.00029,78185,22.83480,342394
7113,94LuXing,1,0.00029,78186,22.83510,342394
7114,97sriram,1,0.00029,78187,22.83539,342394
7115,9lion,1,0.00029,78188,22.83568,342394
7116,9strands,1,0.00029,78189,22.83597,342394
7117,a630140621,1,0.00029,78190,22.83626,342394
7118,a732264856,1,0.00029,78191,22.83656,342394
7119,AAATechGuy,1,0.00029,78192,22.83685,342394
7120,aaazhixiang,1,0.00029,78193,22.83714,342394
7121,aacecandev,1,0.00029,78194,22.83743,342394
7122,aaftab,1,0.00029,78195,22.83772,342394
7123,aagu,1,0.00029,78196,22.83802,342394
7124,Aankhen,1,0.00029,78197,22.83831,342394
7125,aaqaishtyaq,1,0.00029,78198,22.83860,342394
7126,aarajbhattarai,1,0.00029,78199,22.83889,342394
7127,aaron-ai,1,0.00029,78200,22.83919,342394
7128,aaronbuchwald,1,0.00029,78201,22.83948,342394
7129,aaronhadoop,1,0.00029,78202,22.83977,342394
7130,aaronslin,1,0.00029,78203,22.84006,342394
7131,aaronthebaron,1,0.00029,78204,22.84035,342394
7132,aatarasoff,1,0.00029,78205,22.84065,342394
7133,abachman,1,0.00029,78206,22.84094,342394
7134,abdelhalim,1,0.00029,78207,22.84123,342394
7135,AbdelouahabKhelifati,1,0.00029,78208,22.84152,342394
7136,AbdelouahabMbarki,1,0.00029,78209,22.84181,342394
7137,AbdoDabbas,1,0.00029,78210,22.84211,342394
7138,abdollahpour,1,0.00029,78211,22.84240,342394
7139,abebars,1,0.00029,78212,22.84269,342394
7140,abebef77,1,0.00029,78213,22.84298,342394
7141,AbelTaylor,1,0.00029,78214,22.84327,342394
7142,abentley,1,0.00029,78215,22.84357,342394
7143,aberenshtein,1,0.00029,78216,22.84386,342394
7144,Abhi347,1,0.00029,78217,22.84415,342394
7145,AbhijitPatil1992,1,0.00029,78218,22.84444,342394
7146,abhi-kapoor,1,0.00029,78219,22.84473,342394
7147,Abhinav-26,1,0.00029,78220,22.84503,342394
7148,abhinavbhagat,1,0.00029,78221,22.84532,342394
7149,abhinav-TB,1,0.00029,78222,22.84561,342394
7150,AbhinayGupta741,1,0.00029,78223,22.84590,342394
7151,abhipth,1,0.00029,78224,22.84619,342394
7152,Abhishek-90,1,0.00029,78225,22.84649,342394
7153,abhishekbhutra,1,0.00029,78226,22.84678,342394
7154,abhishekghiya,1,0.00029,78227,22.84707,342394
7155,abhishek-prog7,1,0.00029,78228,22.84736,342394
7156,Abijeet123,1,0.00029,78229,22.84766,342394
7157,abimr,1,0.00029,78230,22.84795,342394
7158,abjinugu,1,0.00029,78231,22.84824,342394
7159,absynth76,1,0.00029,78232,22.84853,342394
7160,abubakarm94,1,0.00029,78233,22.84882,342394
7161,abzenenet,1,0.00029,78234,22.84912,342394
7162,acabrele,1,0.00029,78235,22.84941,342394
7163,achandras,1,0.00029,78236,22.84970,342394
7164,Achyuth-India,1,0.00029,78237,22.84999,342394
7165,ackjewtn,1,0.00029,78238,22.85028,342394
7166,acmilannesta,1,0.00029,78239,22.85058,342394
7167,acohen4,1,0.00029,78240,22.85087,342394
7168,adaam,1,0.00029,78241,22.85116,342394
7169,AdamBrousseau,1,0.00029,78242,22.85145,342394
7170,adamf,1,0.00029,78243,22.85174,342394
7171,adamko147,1,0.00029,78244,22.85204,342394
7172,adammontville,1,0.00029,78245,22.85233,342394
7173,adamrozaqs,1,0.00029,78246,22.85262,342394
7174,Adarsh357,1,0.00029,78247,22.85291,342394
7175,addreas,1,0.00029,78248,22.85320,342394
7176,adduarte,1,0.00029,78249,22.85350,342394
7177,adengdai,1,0.00029,78250,22.85379,342394
7178,aderiyenko,1,0.00029,78251,22.85408,342394
7179,adil-bouchaara,1,0.00029,78252,22.85437,342394
7180,adilfulara,1,0.00029,78253,22.85466,342394
7181,adirmatzkin,1,0.00029,78254,22.85496,342394
7182,aditya4k,1,0.00029,78255,22.85525,342394
7183,Aditya-Narayan-Nayak,1,0.00029,78256,22.85554,342394
7184,adityask2,1,0.00029,78257,22.85583,342394
7185,adjain131995,1,0.00029,78258,22.85612,342394
7186,adnan360,1,0.00029,78259,22.85642,342394
7187,adnanhb,1,0.00029,78260,22.85671,342394
7188,AdolfVonKleist,1,0.00029,78261,22.85700,342394
7189,adriangb,1,0.00029,78262,22.85729,342394
7190,adrian-gierakowski,1,0.00029,78263,22.85759,342394
7191,aduhovnik,1,0.00029,78264,22.85788,342394
7192,advance512,1,0.00029,78265,22.85817,342394
7193,aemaem,1,0.00029,78266,22.85846,342394
7194,aevenot,1,0.00029,78267,22.85875,342394
7195,afanasevps,1,0.00029,78268,22.85905,342394
7196,afpd,1,0.00029,78269,22.85934,342394
7197,Afsoning,1,0.00029,78270,22.85963,342394
7198,afzalbin64,1,0.00029,78271,22.85992,342394
7199,agaurav,1,0.00029,78272,22.86021,342394
7200,Agin-DropDisco,1,0.00029,78273,22.86051,342394
7201,agorovoy94,1,0.00029,78274,22.86080,342394
7202,agracey,1,0.00029,78275,22.86109,342394
7203,agre1981,1,0.00029,78276,22.86138,342394
7204,Agronis,1,0.00029,78277,22.86167,342394
7205,agusgonzaleznic,1,0.00029,78278,22.86197,342394
7206,agy-why,1,0.00029,78279,22.86226,342394
7207,ahalam,1,0.00029,78280,22.86255,342394
7208,ahalay,1,0.00029,78281,22.86284,342394
7209,Aharic,1,0.00029,78282,22.86313,342394
7210,ahmed-adly-khalil,1,0.00029,78283,22.86343,342394
7211,ahmethlv,1,0.00029,78284,22.86372,342394
7212,ahmetkaftan,1,0.00029,78285,22.86401,342394
7213,ahoehma,1,0.00029,78286,22.86430,342394
7214,ahollist,1,0.00029,78287,22.86459,342394
7215,Airblader,1,0.00029,78288,22.86489,342394
7216,aitskovi,1,0.00029,78289,22.86518,342394
7217,aivanou,1,0.00029,78290,22.86547,342394
7218,aivong2,1,0.00029,78291,22.86576,342394
7219,Ajake,1,0.00029,78292,22.86605,342394
7220,Ajayimpec,1,0.00029,78293,22.86635,342394
7221,Ajay-MS,1,0.00029,78294,22.86664,342394
7222,AjayShekar01,1,0.00029,78295,22.86693,342394
7223,ajaysingh77,1,0.00029,78296,22.86722,342394
7224,ajesk,1,0.00029,78297,22.86752,342394
7225,ajith29,1,0.00029,78298,22.86781,342394
7226,ajpatterson7,1,0.00029,78299,22.86810,342394
7227,ajrpayne,1,0.00029,78300,22.86839,342394
7228,ajshock,1,0.00029,78301,22.86868,342394
7229,ajyounge,1,0.00029,78302,22.86898,342394
7230,Akaame,1,0.00029,78303,22.86927,342394
7231,akamac,1,0.00029,78304,22.86956,342394
7232,akamensky,1,0.00029,78305,22.86985,342394
7233,akankshapanse,1,0.00029,78306,22.87014,342394
7234,akantek-wr,1,0.00029,78307,22.87044,342394
7235,akash-gautam,1,0.00029,78308,22.87073,342394
7236,akashkaveti,1,0.00029,78309,22.87102,342394
7237,akashpatel2,1,0.00029,78310,22.87131,342394
7238,akashsethiya,1,0.00029,78311,22.87160,342394
7239,AkashSivakumar,1,0.00029,78312,22.87190,342394
7240,a-kataev,1,0.00029,78313,22.87219,342394
7241,AkbarZafar,1,0.00029,78314,22.87248,342394
7242,akharlamov,1,0.00029,78315,22.87277,342394
7243,akhilles,1,0.00029,78316,22.87306,342394
7244,Akhisar,1,0.00029,78317,22.87336,342394
7245,akhon,1,0.00029,78318,22.87365,342394
7246,akhramov,1,0.00029,78319,22.87394,342394
7247,akira-imamura-k8s,1,0.00029,78320,22.87423,342394
7248,akourbat,1,0.00029,78321,22.87452,342394
7249,akpsan,1,0.00029,78322,22.87482,342394
7250,akselleirv,1,0.00029,78323,22.87511,342394
7251,akshat-crypto,1,0.00029,78324,22.87540,342394
7252,akshatki,1,0.00029,78325,22.87569,342394
7253,akshay-bharatdwaj,1,0.00029,78326,22.87598,342394
7254,akshaygupta2208,1,0.00029,78327,22.87628,342394
7255,akshayhiremath,1,0.00029,78328,22.87657,342394
7256,akshaysngupta,1,0.00029,78329,22.87686,342394
7257,akshits96,1,0.00029,78330,22.87715,342394
7258,Akshyanshalenka,1,0.00029,78331,22.87745,342394
7259,akuzni2,1,0.00029,78332,22.87774,342394
7260,Alan-pad,1,0.00029,78333,22.87803,342394
7261,Alastair-Pandelus,1,0.00029,78334,22.87832,342394
7262,albertkohl-monotek,1,0.00029,78335,22.87861,342394
7263,AlbertMarashi,1,0.00029,78336,22.87891,342394
7264,albertoal,1,0.00029,78337,22.87920,342394
7265,AlbertoGODev,1,0.00029,78338,22.87949,342394
7266,albertux,1,0.00029,78339,22.87978,342394
7267,alchem0x2A,1,0.00029,78340,22.88007,342394
7268,aldiserg,1,0.00029,78341,22.88037,342394
7269,aldorperez1,1,0.00029,78342,22.88066,342394
7270,Ale0x78ButInBinary,1,0.00029,78343,22.88095,342394
7271,alee-nyt,1,0.00029,78344,22.88124,342394
7272,alejandrogr,1,0.00029,78345,22.88153,342394
7273,alekonko,1,0.00029,78346,22.88183,342394
7274,aleksei-budiak,1,0.00029,78347,22.88212,342394
7275,aleksey-novikov,1,0.00029,78348,22.88241,342394
7276,aleksrosz,1,0.00029,78349,22.88270,342394
7277,alen-z,1,0.00029,78350,22.88299,342394
7278,AlexanderEllis,1,0.00029,78351,22.88329,342394
7279,alexandery,1,0.00029,78352,22.88358,342394
7280,AlexanderYastrebov,1,0.00029,78353,22.88387,342394
7281,AlexandreBrown,1,0.00029,78354,22.88416,342394
7282,alexandrejuma,1,0.00029,78355,22.88445,342394
7283,alexandru-crossover,1,0.00029,78356,22.88475,342394
7284,alexandruluca,1,0.00029,78357,22.88504,342394
7285,AlexChenSkyBlue,1,0.00029,78358,22.88533,342394
7286,alexdrans,1,0.00029,78359,22.88562,342394
7287,alex-hunt-materialize,1,0.00029,78360,22.88592,342394
7288,Alexis01,1,0.00029,78361,22.88621,342394
7289,alexk1028,1,0.00029,78362,22.88650,342394
7290,alexkashintsev-tomtom,1,0.00029,78363,22.88679,342394
7291,alexksg,1,0.00029,78364,22.88708,342394
7292,alexku7,1,0.00029,78365,22.88738,342394
7293,alex-petrov-vt,1,0.00029,78366,22.88767,342394
7294,Alexr03,1,0.00029,78367,22.88796,342394
7295,alexsapps,1,0.00029,78368,22.88825,342394
7296,alexsuraykin,1,0.00029,78369,22.88854,342394
7297,alex-treebeard,1,0.00029,78370,22.88884,342394
7298,alexviktorov,1,0.00029,78371,22.88913,342394
7299,alfclement,1,0.00029,78372,22.88942,342394
7300,alfrye,1,0.00029,78373,22.88971,342394
7301,alfsch,1,0.00029,78374,22.89000,342394
7302,algs,1,0.00029,78375,22.89030,342394
7303,alicejli,1,0.00029,78376,22.89059,342394
7304,ali-ghasempor,1,0.00029,78377,22.89088,342394
7305,alimoosavi,1,0.00029,78378,22.89117,342394
7306,alinehzat,1,0.00029,78379,22.89146,342394
7307,alinjie,1,0.00029,78380,22.89176,342394
7308,alippai,1,0.00029,78381,22.89205,342394
7309,Alireza-R,1,0.00029,78382,22.89234,342394
7310,AlisonOSouza,1,0.00029,78383,22.89263,342394
7311,alissa-tung,1,0.00029,78384,22.89292,342394
7312,AlistairB,1,0.00029,78385,22.89322,342394
7313,alitta-german,1,0.00029,78386,22.89351,342394
7314,AlKapkone,1,0.00029,78387,22.89380,342394
7315,allanger,1,0.00029,78388,22.89409,342394
7316,Allen-Webb,1,0.00029,78389,22.89438,342394
7317,AllexVeldman,1,0.00029,78390,22.89468,342394
7318,almiroshnich,1,0.00029,78391,22.89497,342394
7319,alonikomax,1,0.00029,78392,22.89526,342394
7320,alotkros,1,0.00029,78393,22.89555,342394
7321,al-pa,1,0.00029,78394,22.89585,342394
7322,alparslanozturk,1,0.00029,78395,22.89614,342394
7323,alphashaw,1,0.00029,78396,22.89643,342394
7324,alwinmark,1,0.00029,78397,22.89672,342394
7325,amaloun,1,0.00029,78398,22.89701,342394
7326,aman-deep739,1,0.00029,78399,22.89731,342394
7327,amanjn98,1,0.00029,78400,22.89760,342394
7328,amanracker0013,1,0.00029,78401,22.89789,342394
7329,amarandon,1,0.00029,78402,22.89818,342394
7330,amartinunowhy,1,0.00029,78403,22.89847,342394
7331,amccool,1,0.00029,78404,22.89877,342394
7332,ameir,1,0.00029,78405,22.89906,342394
7333,amewayne,1,0.00029,78406,22.89935,342394
7334,amilanoski,1,0.00029,78407,22.89964,342394
7335,aminayev,1,0.00029,78408,22.89993,342394
7336,amingst,1,0.00029,78409,22.90023,342394
7337,AminSojoudi,1,0.00029,78410,22.90052,342394
7338,Amir-Abushanab,1,0.00029,78411,22.90081,342394
7339,amirkCA,1,0.00029,78412,22.90110,342394
7340,amirkhonov,1,0.00029,78413,22.90139,342394
7341,amirsalaar,1,0.00029,78414,22.90169,342394
7342,amitamit281,1,0.00029,78415,22.90198,342394
7343,amitay-strattic,1,0.00029,78416,22.90227,342394
7344,amitjoseph,1,0.00029,78417,22.90256,342394
7345,amitoj,1,0.00029,78418,22.90285,342394
7346,amit-va,1,0.00029,78419,22.90315,342394
7347,amitwaisel,1,0.00029,78420,22.90344,342394
7348,amleshk66,1,0.00029,78421,22.90373,342394
7349,AmoebaProtozoa,1,0.00029,78422,22.90402,342394
7350,amopportunities,1,0.00029,78423,22.90431,342394
7351,Amr-Aly,1,0.00029,78424,22.90461,342394
7352,AmrElsehemy,1,0.00029,78425,22.90490,342394
7353,amsoedal,1,0.00029,78426,22.90519,342394
7354,amyangfei,1,0.00029,78427,22.90548,342394
7355,amykul,1,0.00029,78428,22.90578,342394
7356,ananthmeka,1,0.00029,78429,22.90607,342394
7357,anbraten,1,0.00029,78430,22.90636,342394
7358,anchan828,1,0.00029,78431,22.90665,342394
7359,and-1,1,0.00029,78432,22.90694,342394
7360,andead,1,0.00029,78433,22.90724,342394
7361,anderspetersson,1,0.00029,78434,22.90753,342394
7362,ando47,1,0.00029,78435,22.90782,342394
7363,andreasschramm,1,0.00029,78436,22.90811,342394
7364,andrefedev,1,0.00029,78437,22.90840,342394
7365,AndreiPaulau,1,0.00029,78438,22.90870,342394
7366,andreisaikouski,1,0.00029,78439,22.90899,342394
7367,andrejcremoznik,1,0.00029,78440,22.90928,342394
7368,andresrsanchez,1,0.00029,78441,22.90957,342394
7369,Andrewangeta,1,0.00029,78442,22.90986,342394
7370,andrewhood125,1,0.00029,78443,22.91016,342394
7371,andrewhu0209,1,0.00029,78444,22.91045,342394
7372,andrewjstone,1,0.00029,78445,22.91074,342394
7373,andrewparmet,1,0.00029,78446,22.91103,342394
7374,andrew-phi,1,0.00029,78447,22.91132,342394
7375,andrewpmartinez,1,0.00029,78448,22.91162,342394
7376,andrewstucki,1,0.00029,78449,22.91191,342394
7377,andrew-unaffiliated,1,0.00029,78450,22.91220,342394
7378,andrewzah,1,0.00029,78451,22.91249,342394
7379,AndreyBar,1,0.00029,78452,22.91278,342394
7380,andrey-bondar,1,0.00029,78453,22.91308,342394
7381,AndreySerebrov,1,0.00029,78454,22.91337,342394
7382,andrianti,1,0.00029,78455,22.91366,342394
7383,andruwik777,1,0.00029,78456,22.91395,342394
7384,andrvin,1,0.00029,78457,22.91424,342394
7385,Andy1616,1,0.00029,78458,22.91454,342394
7386,andybrook,1,0.00029,78459,22.91483,342394
7387,Andycharalambous,1,0.00029,78460,22.91512,342394
7388,andycockerill-cpi,1,0.00029,78461,22.91541,342394
7389,andyfurniss4,1,0.00029,78462,22.91571,342394
7390,Andy-Gong,1,0.00029,78463,22.91600,342394
7391,andygr,1,0.00029,78464,22.91629,342394
7392,andy-ruc,1,0.00029,78465,22.91658,342394
7393,anetschka,1,0.00029,78466,22.91687,342394
7394,angadisachin,1,0.00029,78467,22.91717,342394
7395,angelluismula,1,0.00029,78468,22.91746,342394
7396,AngelMsger,1,0.00029,78469,22.91775,342394
7397,angeloudy,1,0.00029,78470,22.91804,342394
7398,AngerM-DD,1,0.00029,78471,22.91833,342394
7399,ANGkeith,1,0.00029,78472,22.91863,342394
7400,angsdey2,1,0.00029,78473,22.91892,342394
7401,anhtranbk,1,0.00029,78474,22.91921,342394
7402,anik12p,1,0.00029,78475,22.91950,342394
7403,anilnabin25,1,0.00029,78476,22.91979,342394
7404,anil-venkata,1,0.00029,78477,22.92009,342394
7405,anispider,1,0.00029,78478,22.92038,342394
7406,anjuls,1,0.00029,78479,22.92067,342394
7407,ankane,1,0.00029,78480,22.92096,342394
7408,ankitpatel96,1,0.00029,78481,22.92125,342394
7409,ankit-rsystem,1,0.00029,78482,22.92155,342394
7410,anmaxvl,1,0.00029,78483,22.92184,342394
7411,annalisag-spark,1,0.00029,78484,22.92213,342394
7412,anne-eli,1,0.00029,78485,22.92242,342394
7413,anneum,1,0.00029,78486,22.92271,342394
7414,anonymousr007,1,0.00029,78487,22.92301,342394
7415,anoopjb,1,0.00029,78488,22.92330,342394
7416,anothermh,1,0.00029,78489,22.92359,342394
7417,anshuld27,1,0.00029,78490,22.92388,342394
7418,Antanukas,1,0.00029,78491,22.92418,342394
7419,anteAdamovic,1,0.00029,78492,22.92447,342394
7420,anthonycorletti,1,0.00029,78493,22.92476,342394
7421,antimatter96,1,0.00029,78494,22.92505,342394
7422,AntoCanza,1,0.00029,78495,22.92534,342394
7423,an-toine,1,0.00029,78496,22.92564,342394
7424,AntoineNGUYEN31,1,0.00029,78497,22.92593,342394
7425,antoinetielbeke,1,0.00029,78498,22.92622,342394
7426,antonandreev123,1,0.00029,78499,22.92651,342394
7427,AntonioAlfrz,1,0.00029,78500,22.92680,342394
7428,antoniordz96,1,0.00029,78501,22.92710,342394
7429,AntonOfTheWoods,1,0.00029,78502,22.92739,342394
7430,antzjm,1,0.00029,78503,22.92768,342394
7431,anuar45,1,0.00029,78504,22.92797,342394
7432,anubhav201241,1,0.00029,78505,22.92826,342394
7433,anuj0701,1,0.00029,78506,22.92856,342394
7434,AnujAroshA,1,0.00029,78507,22.92885,342394
7435,anurag4516,1,0.00029,78508,22.92914,342394
7436,anvddriesch,1,0.00029,78509,22.92943,342394
7437,aojdong,1,0.00029,78510,22.92972,342394
7438,aommm,1,0.00029,78511,22.93002,342394
7439,Apache9,1,0.00029,78512,22.93031,342394
7440,aparna-kan,1,0.00029,78513,22.93060,342394
7441,apgapg,1,0.00029,78514,22.93089,342394
7442,apjoseph,1,0.00029,78515,22.93118,342394
7443,apmmahesh25,1,0.00029,78516,22.93148,342394
7444,apodoplelov,1,0.00029,78517,22.93177,342394
7445,APoniatowski,1,0.00029,78518,22.93206,342394
7446,apoorvajn,1,0.00029,78519,22.93235,342394
7447,April-Q,1,0.00029,78520,22.93264,342394
7448,apshoemaker,1,0.00029,78521,22.93294,342394
7449,apt-itude,1,0.00029,78522,22.93323,342394
7450,apurv15,1,0.00029,78523,22.93352,342394
7451,aqHi,1,0.00029,78524,22.93381,342394
7452,AqlaSolutions,1,0.00029,78525,22.93411,342394
7453,ar2pi,1,0.00029,78526,22.93440,342394
7454,arashnorouzi,1,0.00029,78527,22.93469,342394
7455,Aravee,1,0.00029,78528,22.93498,342394
7456,aravindavk,1,0.00029,78529,22.93527,342394
7457,arayu05,1,0.00029,78530,22.93557,342394
7458,arbesulo,1,0.00029,78531,22.93586,342394
7459,arbfay,1,0.00029,78532,22.93615,342394
7460,arbll,1,0.00029,78533,22.93644,342394
7461,archever,1,0.00029,78534,22.93673,342394
7462,ArchLayperson,1,0.00029,78535,22.93703,342394
7463,archlinux-github,1,0.00029,78536,22.93732,342394
7464,archoversight,1,0.00029,78537,22.93761,342394
7465,arcuaki,1,0.00029,78538,22.93790,342394
7466,areese,1,0.00029,78539,22.93819,342394
7467,areshytko,1,0.00029,78540,22.93849,342394
7468,arielouziel,1,0.00029,78541,22.93878,342394
7469,arjunsalyan,1,0.00029,78542,22.93907,342394
7470,arkdevuk,1,0.00029,78543,22.93936,342394
7471,Arkessler,1,0.00029,78544,22.93965,342394
7472,arkhipovds,1,0.00029,78545,22.93995,342394
7473,ark-xs,1,0.00029,78546,22.94024,342394
7474,arman-tur,1,0.00029,78547,22.94053,342394
7475,armisael,1,0.00029,78548,22.94082,342394
7476,armsargis,1,0.00029,78549,22.94111,342394
7477,arnabchow,1,0.00029,78550,22.94141,342394
7478,arnitkun,1,0.00029,78551,22.94170,342394
7479,arnonki,1,0.00029,78552,22.94199,342394
7480,arnottcr,1,0.00029,78553,22.94228,342394
7481,AronT-TLV,1,0.00029,78554,22.94257,342394
7482,arosequist,1,0.00029,78555,22.94287,342394
7483,arrow2012,1,0.00029,78556,22.94316,342394
7484,ArsenyBelorukov,1,0.00029,78557,22.94345,342394
7485,arshad-akra,1,0.00029,78558,22.94374,342394
7486,arslan-sherazi,1,0.00029,78559,22.94404,342394
7487,artem-kosenko,1,0.00029,78560,22.94433,342394
7488,artemptushkin,1,0.00029,78561,22.94462,342394
7489,artemvovk,1,0.00029,78562,22.94491,342394
7490,artem-zinnatullin,1,0.00029,78563,22.94520,342394
7491,artherd42,1,0.00029,78564,22.94550,342394
7492,ArthurCieslik,1,0.00029,78565,22.94579,342394
7493,ArthurEnglebert,1,0.00029,78566,22.94608,342394
7494,artisticcheese,1,0.00029,78567,22.94637,342394
7495,arttobe,1,0.00029,78568,22.94666,342394
7496,arun1587,1,0.00029,78569,22.94696,342394
7497,arunix,1,0.00029,78570,22.94725,342394
7498,arunnair555,1,0.00029,78571,22.94754,342394
7499,ArunRamakani,1,0.00029,78572,22.94783,342394
7500,arunshivaram,1,0.00029,78573,22.94812,342394
7501,as5764,1,0.00029,78574,22.94842,342394
7502,asaaki,1,0.00029,78575,22.94871,342394
7503,asaf1602,1,0.00029,78576,22.94900,342394
7504,asafwat,1,0.00029,78577,22.94929,342394
7505,asayah,1,0.00029,78578,22.94958,342394
7506,asbiin,1,0.00029,78579,22.94988,342394
7507,aseev-xx,1,0.00029,78580,22.95017,342394
7508,aseovic,1,0.00029,78581,22.95046,342394
7509,asettouf,1,0.00029,78582,22.95075,342394
7510,AshinWu,1,0.00029,78583,22.95104,342394
7511,ashish1099,1,0.00029,78584,22.95134,342394
7512,ashish211985,1,0.00029,78585,22.95163,342394
7513,ashissharma97,1,0.00029,78586,22.95192,342394
7514,ash-man,1,0.00029,78587,22.95221,342394
7515,ashwiniramesha,1,0.00029,78588,22.95251,342394
7516,asibece,1,0.00029,78589,22.95280,342394
7517,asilverman,1,0.00029,78590,22.95309,342394
7518,AsjadLFC,1,0.00029,78591,22.95338,342394
7519,asjg-study,1,0.00029,78592,22.95367,342394
7520,askblaker,1,0.00029,78593,22.95397,342394
7521,asleire,1,0.00029,78594,22.95426,342394
7522,AsmaRahimAliJafri,1,0.00029,78595,22.95455,342394
7523,asmeikal,1,0.00029,78596,22.95484,342394
7524,asomethings,1,0.00029,78597,22.95513,342394
7525,asterix201,1,0.00029,78598,22.95543,342394
7526,ASudre,1,0.00029,78599,22.95572,342394
7527,a-thaler,1,0.00029,78600,22.95601,342394
7528,athensofamerica,1,0.00029,78601,22.95630,342394
7529,atif1996,1,0.00029,78602,22.95659,342394
7530,AtlanCI,1,0.00029,78603,22.95689,342394
7531,atnanda,1,0.00029,78604,22.95718,342394
7532,atokarev,1,0.00029,78605,22.95747,342394
7533,atorr0,1,0.00029,78606,22.95776,342394
7534,ATownsend,1,0.00029,78607,22.95805,342394
7535,atrinh567,1,0.00029,78608,22.95835,342394
7536,attachmentgenie,1,0.00029,78609,22.95864,342394
7537,atuk721,1,0.00029,78610,22.95893,342394
7538,atze234,1,0.00029,78611,22.95922,342394
7539,AudaxAli,1,0.00029,78612,22.95951,342394
7540,aupadh12,1,0.00029,78613,22.95981,342394
7541,AureaMohammadAlavi,1,0.00029,78614,22.96010,342394
7542,austina-lin,1,0.00029,78615,22.96039,342394
7543,austindev4,1,0.00029,78616,22.96068,342394
7544,automaticgiant-ml,1,0.00029,78617,22.96097,342394
7545,avandras,1,0.00029,78618,22.96127,342394
7546,averatio,1,0.00029,78619,22.96156,342394
7547,aveyuan,1,0.00029,78620,22.96185,342394
7548,avg07,1,0.00029,78621,22.96214,342394
7549,aviaviavi,1,0.00029,78622,22.96244,342394
7550,avinashbo,1,0.00029,78623,22.96273,342394
7551,Avinash-B-S,1,0.00029,78624,22.96302,342394
7552,avirampi,1,0.00029,78625,22.96331,342394
7553,aviv-amdocs,1,0.00029,78626,22.96360,342394
7554,avnerv,1,0.00029,78627,22.96390,342394
7555,avnes,1,0.00029,78628,22.96419,342394
7556,avtion,1,0.00029,78629,22.96448,342394
7557,avyamsh,1,0.00029,78630,22.96477,342394
7558,awasilyev,1,0.00029,78631,22.96506,342394
7559,aweeks,1,0.00029,78632,22.96536,342394
7560,awreece,1,0.00029,78633,22.96565,342394
7561,awsiv,1,0.00029,78634,22.96594,342394
7562,ax3353,1,0.00029,78635,22.96623,342394
7563,ayesjm,1,0.00029,78636,22.96652,342394
7564,ayz-lex,1,0.00029,78637,22.96682,342394
7565,AzadPolat,1,0.00029,78638,22.96711,342394
7566,azamafzaal,1,0.00029,78639,22.96740,342394
7567,azharprabudi,1,0.00029,78640,22.96769,342394
7568,azrng,1,0.00029,78641,22.96798,342394
7569,AZURETODD,1,0.00029,78642,22.96828,342394
7570,B3arp,1,0.00029,78643,22.96857,342394
7571,b3y0ndd34th,1,0.00029,78644,22.96886,342394
7572,B7478,1,0.00029,78645,22.96915,342394
7573,baaaaast,1,0.00029,78646,22.96944,342394
7574,baboune,1,0.00029,78647,22.96974,342394
7575,babubalagani,1,0.00029,78648,22.97003,342394
7576,balla18,1,0.00029,78649,22.97032,342394
7577,balrajkannan,1,0.00029,78650,22.97061,342394
7578,BalzGuenat,1,0.00029,78651,22.97090,342394
7579,BangHonor,1,0.00029,78652,22.97120,342394
7580,banjocat,1,0.00029,78653,22.97149,342394
7581,Barborica-Alexandru,1,0.00029,78654,22.97178,342394
7582,barektui,1,0.00029,78655,22.97207,342394
7583,bartdong,1,0.00029,78656,22.97237,342394
7584,barthalion,1,0.00029,78657,22.97266,342394
7585,bartoszcisek,1,0.00029,78658,22.97295,342394
7586,bartpeeters,1,0.00029,78659,22.97324,342394
7587,BaruchReut,1,0.00029,78660,22.97353,342394
7588,BasBremerTC,1,0.00029,78661,22.97383,342394
7589,baseTwo,1,0.00029,78662,22.97412,342394
7590,Bashorun97,1,0.00029,78663,22.97441,342394
7591,BaskiGIT,1,0.00029,78664,22.97470,342394
7592,batatch,1,0.00029,78665,22.97499,342394
7593,bawhetst,1,0.00029,78666,22.97529,342394
7594,BazTheLinuxGuy,1,0.00029,78667,22.97558,342394
7595,bbck,1,0.00029,78668,22.97587,342394
7596,bberst,1,0.00029,78669,22.97616,342394
7597,bbgobie,1,0.00029,78670,22.97645,342394
7598,BBQigniter,1,0.00029,78671,22.97675,342394
7599,bbratchiv,1,0.00029,78672,22.97704,342394
7600,bb-Ricardo,1,0.00029,78673,22.97733,342394
7601,bbtong,1,0.00029,78674,22.97762,342394
7602,bchahn,1,0.00029,78675,22.97791,342394
7603,bcharna,1,0.00029,78676,22.97821,342394
7604,bcismariu,1,0.00029,78677,22.97850,342394
7605,Bcodms,1,0.00029,78678,22.97879,342394
7606,bcouetil,1,0.00029,78679,22.97908,342394
7607,BDavisEagle,1,0.00029,78680,22.97937,342394
7608,bdonfouet,1,0.00029,78681,22.97967,342394
7609,bdshadow,1,0.00029,78682,22.97996,342394
7610,bduclaux,1,0.00029,78683,22.98025,342394
7611,beachwalker,1,0.00029,78684,22.98054,342394
7612,BeardyC,1,0.00029,78685,22.98083,342394
7613,beerent,1,0.00029,78686,22.98113,342394
7614,Begasus,1,0.00029,78687,22.98142,342394
7615,BegoniaGit,1,0.00029,78688,22.98171,342394
7616,Behnam-Emamian,1,0.00029,78689,22.98200,342394
7617,Benardi,1,0.00029,78690,22.98230,342394
7618,benbonnet,1,0.00029,78691,22.98259,342394
7619,BenDu89,1,0.00029,78692,22.98288,342394
7620,Benedikt1992,1,0.00029,78693,22.98317,342394
7621,bengray2,1,0.00029,78694,22.98346,342394
7622,benholtzmansmith,1,0.00029,78695,22.98376,342394
7623,benjaminjb,1,0.00029,78696,22.98405,342394
7624,BenjaminKeffer,1,0.00029,78697,22.98434,342394
7625,benjaminpreiss,1,0.00029,78698,22.98463,342394
7626,benjamin-wright,1,0.00029,78699,22.98492,342394
7627,benjimin,1,0.00029,78700,22.98522,342394
7628,ben-manes,1,0.00029,78701,22.98551,342394
7629,benner,1,0.00029,78702,22.98580,342394
7630,benny-bp,1,0.00029,78703,22.98609,342394
7631,bennythejudge,1,0.00029,78704,22.98638,342394
7632,benr,1,0.00029,78705,22.98668,342394
7633,benreynolds-drizly,1,0.00029,78706,22.98697,342394
7634,bensta,1,0.00029,78707,22.98726,342394
7635,Bergiu,1,0.00029,78708,22.98755,342394
7636,Beridgao,1,0.00029,78709,22.98784,342394
7637,Berkmann18,1,0.00029,78710,22.98814,342394
7638,bernardolk,1,0.00029,78711,22.98843,342394
7639,bernoli,1,0.00029,78712,22.98872,342394
7640,BeryJu,1,0.00029,78713,22.98901,342394
7641,beterhans,1,0.00029,78714,22.98930,342394
7642,better629,1,0.00029,78715,22.98960,342394
7643,bgaber,1,0.00029,78716,22.98989,342394
7644,bgeesaman,1,0.00029,78717,22.99018,342394
7645,bgpo,1,0.00029,78718,22.99047,342394
7646,bhamail,1,0.00029,78719,22.99077,342394
7647,bharatazmera,1,0.00029,78720,22.99106,342394
7648,bhechinger,1,0.00029,78721,22.99135,342394
7649,Bhumika1997,1,0.00029,78722,22.99164,342394
7650,bhunath,1,0.00029,78723,22.99193,342394
7651,biancarosa,1,0.00029,78724,22.99223,342394
7652,bidossessi,1,0.00029,78725,22.99252,342394
7653,bigcat26,1,0.00029,78726,22.99281,342394
7654,bigdimple,1,0.00029,78727,22.99310,342394
7655,BigFatDog,1,0.00029,78728,22.99339,342394
7656,bigfudan,1,0.00029,78729,22.99369,342394
7657,bigmua,1,0.00029,78730,22.99398,342394
7658,BigSammich,1,0.00029,78731,22.99427,342394
7659,Bigstiffy1488,1,0.00029,78732,22.99456,342394
7660,bilaloslo92,1,0.00029,78733,22.99485,342394
7661,bilbof,1,0.00029,78734,22.99515,342394
7662,billmetangmo,1,0.00029,78735,22.99544,342394
7663,biostone,1,0.00029,78736,22.99573,342394
7664,biozal,1,0.00029,78737,22.99602,342394
7665,biplabMazumdar,1,0.00029,78738,22.99631,342394
7666,Birdrock,1,0.00029,78739,22.99661,342394
7667,birkh8792,1,0.00029,78740,22.99690,342394
7668,bitjson,1,0.00029,78741,22.99719,342394
7669,bitspradp,1,0.00029,78742,22.99748,342394
7670,bitwalker,1,0.00029,78743,22.99777,342394
7671,bjanders,1,0.00029,78744,22.99807,342394
7672,bjd2385,1,0.00029,78745,22.99836,342394
7673,bjk-reddit,1,0.00029,78746,22.99865,342394
7674,bkadatz,1,0.00029,78747,22.99894,342394
7675,bkk-bcd,1,0.00029,78748,22.99923,342394
7676,Bklyn,1,0.00029,78749,22.99953,342394
7677,BlackCheshire,1,0.00029,78750,22.99982,342394
7678,blackrose28,1,0.00029,78751,23.00011,342394
7679,BlackWebWolf,1,0.00029,78752,23.00040,342394
7680,blinkiz,1,0.00029,78753,23.00070,342394
7681,blockchen-admin,1,0.00029,78754,23.00099,342394
7682,bloodsper,1,0.00029,78755,23.00128,342394
7683,bluefishforsale,1,0.00029,78756,23.00157,342394
7684,bluepuma77,1,0.00029,78757,23.00186,342394
7685,bm1216,1,0.00029,78758,23.00216,342394
7686,bmalehorn,1,0.00029,78759,23.00245,342394
7687,bmbferreira,1,0.00029,78760,23.00274,342394
7688,bmoeskau,1,0.00029,78761,23.00303,342394
7689,bn-amgen,1,0.00029,78762,23.00332,342394
7690,bnerd,1,0.00029,78763,23.00362,342394
7691,BnJam,1,0.00029,78764,23.00391,342394
7692,boarder7395,1,0.00029,78765,23.00420,342394
7693,bobaaaaa,1,0.00029,78766,23.00449,342394
7694,bobbygryzynger,1,0.00029,78767,23.00478,342394
7695,bobcallaway,1,0.00029,78768,23.00508,342394
7696,bobh66,1,0.00029,78769,23.00537,342394
7697,bocian67,1,0.00029,78770,23.00566,342394
7698,Boco10,1,0.00029,78771,23.00595,342394
7699,bodz1lla,1,0.00029,78772,23.00624,342394
7700,boenn,1,0.00029,78773,23.00654,342394
7701,bofei222,1,0.00029,78774,23.00683,342394
7702,BogdanAndreiRoman,1,0.00029,78775,23.00712,342394
7703,bogdanoliinyk,1,0.00029,78776,23.00741,342394
7704,bognerf,1,0.00029,78777,23.00770,342394
7705,Bohdan555,1,0.00029,78778,23.00800,342394
7706,bokan,1,0.00029,78779,23.00829,342394
7707,boney9,1,0.00029,78780,23.00858,342394
7708,bongwoobak,1,0.00029,78781,23.00887,342394
7709,Boolman,1,0.00029,78782,23.00916,342394
7710,BoolOrInt,1,0.00029,78783,23.00946,342394
7711,boomaker,1,0.00029,78784,23.00975,342394
7712,BoredEngineer,1,0.00029,78785,23.01004,342394
7713,borisovano,1,0.00029,78786,23.01033,342394
7714,bork91,1,0.00029,78787,23.01063,342394
7715,borodiliz,1,0.00029,78788,23.01092,342394
7716,botieking98,1,0.00029,78789,23.01121,342394
7717,bourskov83,1,0.00029,78790,23.01150,342394
7718,bowlesns,1,0.00029,78791,23.01179,342394
7719,Bo-Zi,1,0.00029,78792,23.01209,342394
7720,bpedersen2,1,0.00029,78793,23.01238,342394
7721,bpeicher,1,0.00029,78794,23.01267,342394
7722,bpetit,1,0.00029,78795,23.01296,342394
7723,bpfoster,1,0.00029,78796,23.01325,342394
7724,BPJ94487,1,0.00029,78797,23.01355,342394
7725,bputt-e,1,0.00029,78798,23.01384,342394
7726,bradrisse,1,0.00029,78799,23.01413,342394
7727,BrandonDalton,1,0.00029,78800,23.01442,342394
7728,brandon-piner-aruba,1,0.00029,78801,23.01471,342394
7729,Brandt1930,1,0.00029,78802,23.01501,342394
7730,bran-san,1,0.00029,78803,23.01530,342394
7731,brant4test,1,0.00029,78804,23.01559,342394
7732,braunsonm,1,0.00029,78805,23.01588,342394
7733,bredamatt,1,0.00029,78806,23.01617,342394
7734,brian14708,1,0.00029,78807,23.01647,342394
7735,brianbegy,1,0.00029,78808,23.01676,342394
7736,brianchhun-chime,1,0.00029,78809,23.01705,342394
7737,brianfleming,1,0.00029,78810,23.01734,342394
7738,brianpham,1,0.00029,78811,23.01763,342394
7739,Brice187,1,0.00029,78812,23.01793,342394
7740,briedel,1,0.00029,78813,23.01822,342394
7741,BrightXiaoHan,1,0.00029,78814,23.01851,342394
7742,brucelightyear,1,0.00029,78815,23.01880,342394
7743,brugnara,1,0.00029,78816,23.01909,342394
7744,bruno-,1,0.00029,78817,23.01939,342394
7745,brunodasilvalenga,1,0.00029,78818,23.01968,342394
7746,Brunomachadob,1,0.00029,78819,23.01997,342394
7747,bryantqo,1,0.00029,78820,23.02026,342394
7748,bsandusk,1,0.00029,78821,23.02056,342394
7749,bschooly,1,0.00029,78822,23.02085,342394
7750,bskidmore,1,0.00029,78823,23.02114,342394
7751,bspautz1969,1,0.00029,78824,23.02143,342394
7752,bspeiser,1,0.00029,78825,23.02172,342394
7753,bs-santhosh,1,0.00029,78826,23.02202,342394
7754,btat,1,0.00029,78827,23.02231,342394
7755,bubu11e,1,0.00029,78828,23.02260,342394
7756,Buddhimah,1,0.00029,78829,23.02289,342394
7757,BuffaloWill,1,0.00029,78830,23.02318,342394
7758,bufo333,1,0.00029,78831,23.02348,342394
7759,BugFreeSoftware,1,0.00029,78832,23.02377,342394
7760,bugre,1,0.00029,78833,23.02406,342394
7761,BUHPS2261R,1,0.00029,78834,23.02435,342394
7762,BuildAndDestroy,1,0.00029,78835,23.02464,342394
7763,bulbul-ismail,1,0.00029,78836,23.02494,342394
7764,bullwrinkle,1,0.00029,78837,23.02523,342394
7765,buptbubble,1,0.00029,78838,23.02552,342394
7766,burakakca,1,0.00029,78839,23.02581,342394
7767,buraksezer,1,0.00029,78840,23.02610,342394
7768,burkhat,1,0.00029,78841,23.02640,342394
7769,BurlyLuo,1,0.00029,78842,23.02669,342394
7770,buroa,1,0.00029,78843,23.02698,342394
7771,buryat,1,0.00029,78844,23.02727,342394
7772,BWagenerGenerali,1,0.00029,78845,23.02756,342394
7773,bytebae,1,0.00029,78846,23.02786,342394
7774,ByteFlow777,1,0.00029,78847,23.02815,342394
7775,bzed,1,0.00029,78848,23.02844,342394
7776,bznein,1,0.00029,78849,23.02873,342394
7777,c0depwn,1,0.00029,78850,23.02903,342394
7778,c0llab0rat0r,1,0.00029,78851,23.02932,342394
7779,C3PO-github,1,0.00029,78852,23.02961,342394
7780,C3sarRCDOU,1,0.00029,78853,23.02990,342394
7781,c4llous,1,0.00029,78854,23.03019,342394
7782,cachila,1,0.00029,78855,23.03049,342394
7783,cadiegoc,1,0.00029,78856,23.03078,342394
7784,caibirdme,1,0.00029,78857,23.03107,342394
7785,caioaao,1,0.00029,78858,23.03136,342394
7786,caiwenhao,1,0.00029,78859,23.03165,342394
7787,calbot,1,0.00029,78860,23.03195,342394
7788,calvh,1,0.00029,78861,23.03224,342394
7789,CalvinNeo,1,0.00029,78862,23.03253,342394
7790,candidoma,1,0.00029,78863,23.03282,342394
7791,candy02058912,1,0.00029,78864,23.03311,342394
7792,canthonyscott,1,0.00029,78865,23.03341,342394
7793,caobill,1,0.00029,78866,23.03370,342394
7794,CaoDonghui123,1,0.00029,78867,23.03399,342394
7795,capetonian,1,0.00029,78868,23.03428,342394
7796,cappyzawa,1,0.00029,78869,23.03457,342394
7797,CarloGiannattasio,1,0.00029,78870,23.03487,342394
7798,carloscruzadomatrix,1,0.00029,78871,23.03516,342394
7799,carlosescura,1,0.00029,78872,23.03545,342394
7800,carlosrmendes,1,0.00029,78873,23.03574,342394
7801,carlreid,1,0.00029,78874,23.03603,342394
7802,carl-reverb,1,0.00029,78875,23.03633,342394
7803,carmilea,1,0.00029,78876,23.03662,342394
7804,CaRRotOne,1,0.00029,78877,23.03691,342394
7805,cartmast-aws,1,0.00029,78878,23.03720,342394
7806,cas--,1,0.00029,78879,23.03749,342394
7807,castortech,1,0.00029,78880,23.03779,342394
7808,catnip-se,1,0.00029,78881,23.03808,342394
7809,cavdarturgay,1,0.00029,78882,23.03837,342394
7810,cbackstrom80,1,0.00029,78883,23.03866,342394
7811,cbanciu667,1,0.00029,78884,23.03896,342394
7812,cbirdcn,1,0.00029,78885,23.03925,342394
7813,cblecker-sockpuppet,1,0.00029,78886,23.03954,342394
7814,cb-manick,1,0.00029,78887,23.03983,342394
7815,cbm-gplassard,1,0.00029,78888,23.04012,342394
7816,cbndr,1,0.00029,78889,23.04042,342394
7817,cbonitz,1,0.00029,78890,23.04071,342394
7818,cbrewster,1,0.00029,78891,23.04100,342394
7819,cbyad,1,0.00029,78892,23.04129,342394
7820,ccannell67,1,0.00029,78893,23.04158,342394
7821,cchxn258886,1,0.00029,78894,23.04188,342394
7822,ccoulombe,1,0.00029,78895,23.04217,342394
7823,ccx1024cc,1,0.00029,78896,23.04246,342394
7824,CDFN,1,0.00029,78897,23.04275,342394
7825,cdjomga,1,0.00029,78898,23.04304,342394
7826,cdyue,1,0.00029,78899,23.04334,342394
7827,cedvan,1,0.00029,78900,23.04363,342394
7828,CezaryTarnowski-TomTom,1,0.00029,78901,23.04392,342394
7829,cezhang,1,0.00029,78902,23.04421,342394
7830,cfraleig,1,0.00029,78903,23.04450,342394
7831,cfuntis,1,0.00029,78904,23.04480,342394
7832,cgafool,1,0.00029,78905,23.04509,342394
7833,CGreenburg,1,0.00029,78906,23.04538,342394
7834,chadchristenson,1,0.00029,78907,23.04567,342394
7835,chadgeary,1,0.00029,78908,23.04596,342394
7836,chadmarchand,1,0.00029,78909,23.04626,342394
7837,ChainYo,1,0.00029,78910,23.04655,342394
7838,chaizhiwen,1,0.00029,78911,23.04684,342394
7839,chakch,1,0.00029,78912,23.04713,342394
7840,chandankashyap19,1,0.00029,78913,23.04742,342394
7841,chandra-dixit-hcl,1,0.00029,78914,23.04772,342394
7842,changtimwu,1,0.00029,78915,23.04801,342394
7843,ChangyuWang,1,0.00029,78916,23.04830,342394
7844,chan-wired,1,0.00029,78917,23.04859,342394
7845,ChAnYaNG97,1,0.00029,78918,23.04889,342394
7846,charan-amzn,1,0.00029,78919,23.04918,342394
7847,ChardyT,1,0.00029,78920,23.04947,342394
7848,charithmadhuranga,1,0.00029,78921,23.04976,342394
7849,charlesdaniels,1,0.00029,78922,23.05005,342394
7850,charlie430,1,0.00029,78923,23.05035,342394
7851,charlielin,1,0.00029,78924,23.05064,342394
7852,charlietsai,1,0.00029,78925,23.05093,342394
7853,charlspjohn,1,0.00029,78926,23.05122,342394
7854,chauhanshubham,1,0.00029,78927,23.05151,342394
7855,chavacava,1,0.00029,78928,23.05181,342394
7856,chdxD1,1,0.00029,78929,23.05210,342394
7857,cheeseandcereal,1,0.00029,78930,23.05239,342394
7858,chenchaowang,1,0.00029,78931,23.05268,342394
7859,cheng0214,1,0.00029,78932,23.05297,342394
7860,chengtg520,1,0.00029,78933,23.05327,342394
7861,chenhongyi,1,0.00029,78934,23.05356,342394
7862,chenjiandongx,1,0.00029,78935,23.05385,342394
7863,chenkaiyin1201,1,0.00029,78936,23.05414,342394
7864,chenlein,1,0.00029,78937,23.05443,342394
7865,chenlrambus,1,0.00029,78938,23.05473,342394
7866,chenluo1234,1,0.00029,78939,23.05502,342394
7867,chenmeng1996,1,0.00029,78940,23.05531,342394
7868,chenqiuhao1997,1,0.00029,78941,23.05560,342394
7869,chenrulongmaster,1,0.00029,78942,23.05589,342394
7870,chensun,1,0.00029,78943,23.05619,342394
7871,chenwng,1,0.00029,78944,23.05648,342394
7872,chenwnicole,1,0.00029,78945,23.05677,342394
7873,chenyanjunyjy,1,0.00029,78946,23.05706,342394
7874,chenya-zhang,1,0.00029,78947,23.05735,342394
7875,chenyg0911,1,0.00029,78948,23.05765,342394
7876,chenyue233,1,0.00029,78949,23.05794,342394
7877,CherylFlowers,1,0.00029,78950,23.05823,342394
7878,Chetan77-hub,1,0.00029,78951,23.05852,342394
7879,chethan-devopsnow,1,0.00029,78952,23.05882,342394
7880,chetniks,1,0.00029,78953,23.05911,342394
7881,chickentendies339,1,0.00029,78954,23.05940,342394
7882,ChiefGhostZero0x1,1,0.00029,78955,23.05969,342394
7883,chiefzor,1,0.00029,78956,23.05998,342394
7884,chiendm,1,0.00029,78957,23.06028,342394
7885,chikinchoi,1,0.00029,78958,23.06057,342394
7886,chiku11,1,0.00029,78959,23.06086,342394
7887,chilanti,1,0.00029,78960,23.06115,342394
7888,chillum,1,0.00029,78961,23.06144,342394
7889,chin1711,1,0.00029,78962,23.06174,342394
7890,ChinaSilence,1,0.00029,78963,23.06203,342394
7891,chinasubbareddym,1,0.00029,78964,23.06232,342394
7892,chinkung,1,0.00029,78965,23.06261,342394
7893,chipkillmar,1,0.00029,78966,23.06290,342394
7894,Chirag-786,1,0.00029,78967,23.06320,342394
7895,ChloeTigre,1,0.00029,78968,23.06349,342394
7896,CHN-WANGYU,1,0.00029,78969,23.06378,342394
7897,choeffer,1,0.00029,78970,23.06407,342394
7898,choldrim,1,0.00029,78971,23.06436,342394
7899,chongchaoyu,1,0.00029,78972,23.06466,342394
7900,chongkai,1,0.00029,78973,23.06495,342394
7901,chook,1,0.00029,78974,23.06524,342394
7902,choppspavan,1,0.00029,78975,23.06553,342394
7903,choyri,1,0.00029,78976,23.06582,342394
7904,chrifey,1,0.00029,78977,23.06612,342394
7905,chris3081,1,0.00029,78978,23.06641,342394
7906,chris3ware,1,0.00029,78979,23.06670,342394
7907,ChrisBit,1,0.00029,78980,23.06699,342394
7908,Chris-Carmichael,1,0.00029,78981,23.06729,342394
7909,ChrisChinchilla,1,0.00029,78982,23.06758,342394
7910,chris-cmsoft,1,0.00029,78983,23.06787,342394
7911,ChrisGitter,1,0.00029,78984,23.06816,342394
7912,chrishenley,1,0.00029,78985,23.06845,342394
7913,chris-lsn,1,0.00029,78986,23.06875,342394
7914,chrisob,1,0.00029,78987,23.06904,342394
7915,chrisromano,1,0.00029,78988,23.06933,342394
7916,chrissata,1,0.00029,78989,23.06962,342394
7917,chris-schra,1,0.00029,78990,23.06991,342394
7918,christianAckman,1,0.00029,78991,23.07021,342394
7919,christiangonre,1,0.00029,78992,23.07050,342394
7920,christianlang,1,0.00029,78993,23.07079,342394
7921,Christophe73,1,0.00029,78994,23.07108,342394
7922,ChristopherLenz,1,0.00029,78995,23.07137,342394
7923,chriswilley,1,0.00029,78996,23.07167,342394
7924,Chrooth,1,0.00029,78997,23.07196,342394
7925,chrwoizi,1,0.00029,78998,23.07225,342394
7926,chtourou-youssef,1,0.00029,78999,23.07254,342394
7927,chukka,1,0.00029,79000,23.07283,342394
7928,chuntaojun,1,0.00029,79001,23.07313,342394
7929,chunter0,1,0.00029,79002,23.07342,342394
7930,cigna-asoria,1,0.00029,79003,23.07371,342394
7931,cikupin,1,0.00029,79004,23.07400,342394
7932,cishidai,1,0.00029,79005,23.07429,342394
7933,cixtor,1,0.00029,79006,23.07459,342394
7934,cjeker,1,0.00029,79007,23.07488,342394
7935,CJoder,1,0.00029,79008,23.07517,342394
7936,ckazimie,1,0.00029,79009,23.07546,342394
7937,ckoredla,1,0.00029,79010,23.07575,342394
7938,ClaudioConsolmagno,1,0.00029,79011,23.07605,342394
7939,claudiohs-inditex,1,0.00029,79012,23.07634,342394
7940,claudiuvintila,1,0.00029,79013,23.07663,342394
7941,claudson-f3,1,0.00029,79014,23.07692,342394
7942,claywd-x,1,0.00029,79015,23.07722,342394
7943,clcollins,1,0.00029,79016,23.07751,342394
7944,clebio,1,0.00029,79017,23.07780,342394
7945,cleo2525,1,0.00029,79018,23.07809,342394
7946,clifford-sanders,1,0.00029,79019,23.07838,342394
7947,clock21am,1,0.00029,79020,23.07868,342394
7948,cloudyuga,1,0.00029,79021,23.07897,342394
7949,cloverheap,1,0.00029,79022,23.07926,342394
7950,clsater,1,0.00029,79023,23.07955,342394
7951,cm891237,1,0.00029,79024,23.07984,342394
7952,cmarasescu,1,0.00029,79025,23.08014,342394
7953,cmdub,1,0.00029,79026,23.08043,342394
7954,cmd-werner-diers,1,0.00029,79027,23.08072,342394
7955,cmiller-exos,1,0.00029,79028,23.08101,342394
7956,cmlino,1,0.00029,79029,23.08130,342394
7957,cmonty14,1,0.00029,79030,23.08160,342394
7958,cmotta2016,1,0.00029,79031,23.08189,342394
7959,cnukwas,1,0.00029,79032,23.08218,342394
7960,coachafei,1,0.00029,79033,23.08247,342394
7961,cobb-tx,1,0.00029,79034,23.08276,342394
7962,Cobesz,1,0.00029,79035,23.08306,342394
7963,cobly,1,0.00029,79036,23.08335,342394
7964,cobolbaby,1,0.00029,79037,23.08364,342394
7965,Cobra1978,1,0.00029,79038,23.08393,342394
7966,CodeByEddy,1,0.00029,79039,23.08422,342394
7967,codefalcon95,1,0.00029,79040,23.08452,342394
7968,codefrau,1,0.00029,79041,23.08481,342394
7969,code-is-art,1,0.00029,79042,23.08510,342394
7970,codeliuer,1,0.00029,79043,23.08539,342394
7971,codenow99,1,0.00029,79044,23.08568,342394
7972,coder543,1,0.00029,79045,23.08598,342394
7973,coder-faker,1,0.00029,79046,23.08627,342394
7974,coderharee,1,0.00029,79047,23.08656,342394
7975,coderpatros,1,0.00029,79048,23.08685,342394
7976,CoderPoet,1,0.00029,79049,23.08715,342394
7977,coder-user,1,0.00029,79050,23.08744,342394
7978,CodeSammich,1,0.00029,79051,23.08773,342394
7979,codesmon,1,0.00029,79052,23.08802,342394
7980,codihuston,1,0.00029,79053,23.08831,342394
7981,codingluke,1,0.00029,79054,23.08861,342394
7982,codings-dan,1,0.00029,79055,23.08890,342394
7983,codybuell,1,0.00029,79056,23.08919,342394
7984,coeuvre,1,0.00029,79057,23.08948,342394
7985,cokepizza,1,0.00029,79058,23.08977,342394
7986,colbyguan,1,0.00029,79059,23.09007,342394
7987,colearendt,1,0.00029,79060,23.09036,342394
7988,com30n,1,0.00029,79061,23.09065,342394
7989,comfuture,1,0.00029,79062,23.09094,342394
7990,comsky,1,0.00029,79063,23.09123,342394
7991,comunidadio,1,0.00029,79064,23.09153,342394
7992,conblem,1,0.00029,79065,23.09182,342394
7993,Concurrensee,1,0.00029,79066,23.09211,342394
7994,connorkuehl,1,0.00029,79067,23.09240,342394
7995,Conspir3D,1,0.00029,79068,23.09269,342394
7996,contactpunit,1,0.00029,79069,23.09299,342394
7997,contactsai123,1,0.00029,79070,23.09328,342394
7998,contrun,1,0.00029,79071,23.09357,342394
7999,cookew,1,0.00029,79072,23.09386,342394
8000,coolamiy,1,0.00029,79073,23.09415,342394
8001,coolio8818,1,0.00029,79074,23.09445,342394
8002,CoolLiuzw,1,0.00029,79075,23.09474,342394
8003,corburn,1,0.00029,79076,23.09503,342394
8004,corey-cole,1,0.00029,79077,23.09532,342394
8005,Corey-J,1,0.00029,79078,23.09561,342394
8006,coreywagehoft,1,0.00029,79079,23.09591,342394
8007,corganfuzz,1,0.00029,79080,23.09620,342394
8008,cortex3,1,0.00029,79081,23.09649,342394
8009,cory-at-confluent,1,0.00029,79082,23.09678,342394
8010,CoryKoehler,1,0.00029,79083,23.09708,342394
8011,costinmrr,1,0.00029,79084,23.09737,342394
8012,CourchesneA,1,0.00029,79085,23.09766,342394
8013,cp1408,1,0.00029,79086,23.09795,342394
8014,c-parsons,1,0.00029,79087,23.09824,342394
8015,cpinochet,1,0.00029,79088,23.09854,342394
8016,c-pius,1,0.00029,79089,23.09883,342394
8017,cpressland,1,0.00029,79090,23.09912,342394
8018,cptnnm,1,0.00029,79091,23.09941,342394
8019,cptTomato,1,0.00029,79092,23.09970,342394
8020,cpxPratik,1,0.00029,79093,23.10000,342394
8021,cqhan777,1,0.00029,79094,23.10029,342394
8022,cr4zy-C,1,0.00029,79095,23.10058,342394
8023,craig5,1,0.00029,79096,23.10087,342394
8024,craigmunro,1,0.00029,79097,23.10116,342394
8025,craized,1,0.00029,79098,23.10146,342394
8026,CraneShiEMC,1,0.00029,79099,23.10175,342394
8027,crankl,1,0.00029,79100,23.10204,342394
8028,Crazyigor1987,1,0.00029,79101,23.10233,342394
8029,creekpld,1,0.00029,79102,23.10262,342394
8030,creosonic,1,0.00029,79103,23.10292,342394
8031,crhuber,1,0.00029,79104,23.10321,342394
8032,cripperzprodigy,1,0.00029,79105,23.10350,342394
8033,crisrat,1,0.00029,79106,23.10379,342394
8034,crobert-1,1,0.00029,79107,23.10408,342394
8035,crobertson-conga,1,0.00029,79108,23.10438,342394
8036,cronolio,1,0.00029,79109,23.10467,342394
8037,crpotter,1,0.00029,79110,23.10496,342394
8038,crrazyman,1,0.00029,79111,23.10525,342394
8039,cryptoki,1,0.00029,79112,23.10555,342394
8040,csaba-g,1,0.00029,79113,23.10584,342394
8041,csabakos,1,0.00029,79114,23.10613,342394
8042,csidiro,1,0.00029,79115,23.10642,342394
8043,cskarby,1,0.00029,79116,23.10671,342394
8044,cskinfill,1,0.00029,79117,23.10701,342394
8045,cslovell,1,0.00029,79118,23.10730,342394
8046,cstruct,1,0.00029,79119,23.10759,342394
8047,ctavian,1,0.00029,79120,23.10788,342394
8048,ctharris77,1,0.00029,79121,23.10817,342394
8049,ctison,1,0.00029,79122,23.10847,342394
8050,ctoomey,1,0.00029,79123,23.10876,342394
8051,ctorrisi,1,0.00029,79124,23.10905,342394
8052,ctreatma,1,0.00029,79125,23.10934,342394
8053,ctrombley,1,0.00029,79126,23.10963,342394
8054,ctudball,1,0.00029,79127,23.10993,342394
8055,cugu,1,0.00029,79128,23.11022,342394
8056,cuiko,1,0.00029,79129,23.11051,342394
8057,curiosport,1,0.00029,79130,23.11080,342394
8058,cveilleux,1,0.00029,79131,23.11109,342394
8059,cvpatel,1,0.00029,79132,23.11139,342394
8060,cwildman,1,0.00029,79133,23.11168,342394
8061,cw-pratik,1,0.00029,79134,23.11197,342394
8062,cwtrex,1,0.00029,79135,23.11226,342394
8063,cy8aer,1,0.00029,79136,23.11255,342394
8064,cyanosp,1,0.00029,79137,23.11285,342394
8065,CyberTailor,1,0.00029,79138,23.11314,342394
8066,cyc1ingsir,1,0.00029,79139,23.11343,342394
8067,c-yco,1,0.00029,79140,23.11372,342394
8068,cyperplex,1,0.00029,79141,23.11401,342394
8069,cyrus-mc,1,0.00029,79142,23.11431,342394
8070,cysnet,1,0.00029,79143,23.11460,342394
8071,cyx,1,0.00029,79144,23.11489,342394
8072,CzarMich,1,0.00029,79145,23.11518,342394
8073,czchen,1,0.00029,79146,23.11548,342394
8074,czcibson,1,0.00029,79147,23.11577,342394
8075,czenker,1,0.00029,79148,23.11606,342394
8076,D3DeFi,1,0.00029,79149,23.11635,342394
8077,dacloutier,1,0.00029,79150,23.11664,342394
8078,daddz,1,0.00029,79151,23.11694,342394
8079,daemon027,1,0.00029,79152,23.11723,342394
8080,DaemonDude23,1,0.00029,79153,23.11752,342394
8081,dafzor,1,0.00029,79154,23.11781,342394
8082,DagDigg,1,0.00029,79155,23.11810,342394
8083,dageita,1,0.00029,79156,23.11840,342394
8084,daghaian,1,0.00029,79157,23.11869,342394
8085,daicheng123,1,0.00029,79158,23.11898,342394
8086,daihanhle,1,0.00029,79159,23.11927,342394
8087,DailyAlice,1,0.00029,79160,23.11956,342394
8088,daimatz,1,0.00029,79161,23.11986,342394
8089,daixijun,1,0.00029,79162,23.12015,342394
8090,dalemarchand,1,0.00029,79163,23.12044,342394
8091,damhau,1,0.00029,79164,23.12073,342394
8092,DamianFekete,1,0.00029,79165,23.12102,342394
8093,damian-keska,1,0.00029,79166,23.12132,342394
8094,damian-keska-f,1,0.00029,79167,23.12161,342394
8095,damikun,1,0.00029,79168,23.12190,342394
8096,DamonLin1992,1,0.00029,79169,23.12219,342394
8097,damyl4sure,1,0.00029,79170,23.12248,342394
8098,dan-baxter,1,0.00029,79171,23.12278,342394
8099,danedb,1,0.00029,79172,23.12307,342394
8100,danibaeyens,1,0.00029,79173,23.12336,342394
8101,DanielAGW,1,0.00029,79174,23.12365,342394
8102,danielakhterov,1,0.00029,79175,23.12394,342394
8103,DanielB1990,1,0.00029,79176,23.12424,342394
8104,DanielBanobreDopico,1,0.00029,79177,23.12453,342394
8105,danielberecz,1,0.00029,79178,23.12482,342394
8106,danielblando,1,0.00029,79179,23.12511,342394
8107,DanielDagnino,1,0.00029,79180,23.12541,342394
8108,danieldethloff1993,1,0.00029,79181,23.12570,342394
8109,danielefranceschi,1,0.00029,79182,23.12599,342394
8110,danielerota,1,0.00029,79183,23.12628,342394
8111,danielfoehrKn,1,0.00029,79184,23.12657,342394
8112,DanielHajduk2-TomTom,1,0.00029,79185,23.12687,342394
8113,danielkwinsor,1,0.00029,79186,23.12716,342394
8114,daniel-levin,1,0.00029,79187,23.12745,342394
8115,Daniel-Redeploy,1,0.00029,79188,23.12774,342394
8116,daniel-samet,1,0.00029,79189,23.12803,342394
8117,danielvrog,1,0.00029,79190,23.12833,342394
8118,danielwegener,1,0.00029,79191,23.12862,342394
8119,daniel-winter,1,0.00029,79192,23.12891,342394
8120,DanielZhangQD,1,0.00029,79193,23.12920,342394
8121,danirisdiandita,1,0.00029,79194,23.12949,342394
8122,danisafta,1,0.00029,79195,23.12979,342394
8123,danivendetta,1,0.00029,79196,23.13008,342394
8124,danludwig-happymoney,1,0.00029,79197,23.13037,342394
8125,Danny200,1,0.00029,79198,23.13066,342394
8126,Danny-m08,1,0.00029,79199,23.13095,342394
8127,dannyman,1,0.00029,79200,23.13125,342394
8128,dantiandb,1,0.00029,79201,23.13154,342394
8129,Danwakeem,1,0.00029,79202,23.13183,342394
8130,daotoulangzi,1,0.00029,79203,23.13212,342394
8131,darashevcstbg,1,0.00029,79204,23.13241,342394
8132,darint00,1,0.00029,79205,23.13271,342394
8133,darioxtx,1,0.00029,79206,23.13300,342394
8134,DARK-art108,1,0.00029,79207,23.13329,342394
8135,darkedges,1,0.00029,79208,23.13358,342394
8136,darklore,1,0.00029,79209,23.13388,342394
8137,darren-fu,1,0.00029,79210,23.13417,342394
8138,darryk10,1,0.00029,79211,23.13446,342394
8139,darshanhs09,1,0.00029,79212,23.13475,342394
8140,DarthJonathan,1,0.00029,79213,23.13504,342394
8141,dashanhust,1,0.00029,79214,23.13534,342394
8142,dastbe,1,0.00029,79215,23.13563,342394
8143,datacart,1,0.00029,79216,23.13592,342394
8144,datashaman,1,0.00029,79217,23.13621,342394
8145,datdefboi,1,0.00029,79218,23.13650,342394
8146,Dav1dde,1,0.00029,79219,23.13680,342394
8147,davclark,1,0.00029,79220,23.13709,342394
8148,dave-airkit,1,0.00029,79221,23.13738,342394
8149,davebarkerKount,1,0.00029,79222,23.13767,342394
8150,davegord,1,0.00029,79223,23.13796,342394
8151,davem-git,1,0.00029,79224,23.13826,342394
8152,davesave,1,0.00029,79225,23.13855,342394
8153,davetisyan95,1,0.00029,79226,23.13884,342394
8154,DaveWK,1,0.00029,79227,23.13913,342394
8155,david0,1,0.00029,79228,23.13942,342394
8156,davidamin,1,0.00029,79229,23.13972,342394
8157,david-becher,1,0.00029,79230,23.14001,342394
8158,DavidDarville,1,0.00029,79231,23.14030,342394
8159,daviddone,1,0.00029,79232,23.14059,342394
8160,daviddyball,1,0.00029,79233,23.14088,342394
8161,davidebianchi,1,0.00029,79234,23.14118,342394
8162,david-gang,1,0.00029,79235,23.14147,342394
8163,davidmateos,1,0.00029,79236,23.14176,342394
8164,davidpeinado-f3,1,0.00029,79237,23.14205,342394
8165,davidshare,1,0.00029,79238,23.14234,342394
8166,DavidSimner,1,0.00029,79239,23.14264,342394
8167,david-uash,1,0.00029,79240,23.14293,342394
8168,davidwparker,1,0.00029,79241,23.14322,342394
8169,DavidZemon,1,0.00029,79242,23.14351,342394
8170,davis-haba,1,0.00029,79243,23.14381,342394
8171,davissclark,1,0.00029,79244,23.14410,342394
8172,day1118,1,0.00029,79245,23.14439,342394
8173,Dazfl,1,0.00029,79246,23.14468,342394
8174,dbasden,1,0.00029,79247,23.14497,342394
8175,dbgjerez,1,0.00029,79248,23.14527,342394
8176,dbmathis,1,0.00029,79249,23.14556,342394
8177,dborysenko,1,0.00029,79250,23.14585,342394
8178,dboyleitrs,1,0.00029,79251,23.14614,342394
8179,dbs-gong,1,0.00029,79252,23.14643,342394
8180,dbuos,1,0.00029,79253,23.14673,342394
8181,dbxkoro,1,0.00029,79254,23.14702,342394
8182,ddave-440,1,0.00029,79255,23.14731,342394
8183,ddieruf,1,0.00029,79256,23.14760,342394
8184,ddl-kevin,1,0.00029,79257,23.14789,342394
8185,ddzero2c,1,0.00029,79258,23.14819,342394
8186,deadbeef-development,1,0.00029,79259,23.14848,342394
8187,DeadLion,1,0.00029,79260,23.14877,342394
8188,deagon,1,0.00029,79261,23.14906,342394
8189,dearoneesama,1,0.00029,79262,23.14935,342394
8190,debbiswal,1,0.00029,79263,23.14965,342394
8191,debjitk,1,0.00029,79264,23.14994,342394
8192,debu999,1,0.00029,79265,23.15023,342394
8193,declanlong,1,0.00029,79266,23.15052,342394
8194,declum,1,0.00029,79267,23.15081,342394
8195,deepakinseattle,1,0.00029,79268,23.15111,342394
8196,DeepDiver1975,1,0.00029,79269,23.15140,342394
8197,DeepSpace2,1,0.00029,79270,23.15169,342394
8198,defaultbr,1,0.00029,79271,23.15198,342394
8199,defnqta,1,0.00029,79272,23.15227,342394
8200,dekimsey,1,0.00029,79273,23.15257,342394
8201,delaneyj,1,0.00029,79274,23.15286,342394
8202,delc006,1,0.00029,79275,23.15315,342394
8203,delong-coder,1,0.00029,79276,23.15344,342394
8204,delulu,1,0.00029,79277,23.15374,342394
8205,demurray,1,0.00029,79278,23.15403,342394
8206,dengshenyu,1,0.00029,79279,23.15432,342394
8207,dengy2016,1,0.00029,79280,23.15461,342394
8208,denis256,1,0.00029,79281,23.15490,342394
8209,denis-osipov,1,0.00029,79282,23.15520,342394
8210,denissimonovski,1,0.00029,79283,23.15549,342394
8211,denisvmedia,1,0.00029,79284,23.15578,342394
8212,denitiu,1,0.00029,79285,23.15607,342394
8213,dennishog,1,0.00029,79286,23.15636,342394
8214,denrenchen,1,0.00029,79287,23.15666,342394
8215,des-esseintes,1,0.00029,79288,23.15695,342394
8216,DestroyerAlpha,1,0.00029,79289,23.15724,342394
8217,DevDmitryHub,1,0.00029,79290,23.15753,342394
8218,Develbold,1,0.00029,79291,23.15782,342394
8219,devendrapal-ag,1,0.00029,79292,23.15812,342394
8220,devlikai,1,0.00029,79293,23.15841,342394
8221,devozs,1,0.00029,79294,23.15870,342394
8222,dev-rowbot,1,0.00029,79295,23.15899,342394
8223,devzer01,1,0.00029,79296,23.15928,342394
8224,dfengshi,1,0.00029,79297,23.15958,342394
8225,dfoxg,1,0.00029,79298,23.15987,342394
8226,dgaffuri,1,0.00029,79299,23.16016,342394
8227,dgherman,1,0.00029,79300,23.16045,342394
8228,dgsardina,1,0.00029,79301,23.16074,342394
8229,Dh0ren,1,0.00029,79302,23.16104,342394
8230,DhayOfRedox,1,0.00029,79303,23.16133,342394
8231,dhermanns,1,0.00029,79304,23.16162,342394
8232,dhiemaz,1,0.00029,79305,23.16191,342394
8233,dhwthompson,1,0.00029,79306,23.16220,342394
8234,Diablo2050,1,0.00029,79307,23.16250,342394
8235,DickChesterwood,1,0.00029,79308,23.16279,342394
8236,dickescheid,1,0.00029,79309,23.16308,342394
8237,dicolasi,1,0.00029,79310,23.16337,342394
8238,didihongsheng,1,0.00029,79311,23.16367,342394
8239,diegoaguilar,1,0.00029,79312,23.16396,342394
8240,diegomarangoni,1,0.00029,79313,23.16425,342394
8241,Diggsey,1,0.00029,79314,23.16454,342394
8242,dileep-alla-by,1,0.00029,79315,23.16483,342394
8243,dileepyavan,1,0.00029,79316,23.16513,342394
8244,dimetron,1,0.00029,79317,23.16542,342394
8245,dimitrijevskiv,1,0.00029,79318,23.16571,342394
8246,dimitriosstander,1,0.00029,79319,23.16600,342394
8247,dimitrmo,1,0.00029,79320,23.16629,342394
8248,dinagraves,1,0.00029,79321,23.16659,342394
8249,dincciftci,1,0.00029,79322,23.16688,342394
8250,dindurthy,1,0.00029,79323,23.16717,342394
8251,dineshputchala,1,0.00029,79324,23.16746,342394
8252,dipanjank,1,0.00029,79325,23.16775,342394
8253,dipjyotimetia,1,0.00029,79326,23.16805,342394
8254,dipumonharidask,1,0.00029,79327,23.16834,342394
8255,direwolf424,1,0.00029,79328,23.16863,342394
8256,dirkm,1,0.00029,79329,23.16892,342394
8257,dirk-olmes,1,0.00029,79330,23.16921,342394
8258,dirsigler,1,0.00029,79331,23.16951,342394
8259,dirtyValera,1,0.00029,79332,23.16980,342394
8260,disparo13,1,0.00029,79333,23.17009,342394
8261,divad1196,1,0.00029,79334,23.17038,342394
8262,Divine1,1,0.00029,79335,23.17067,342394
8263,divmid,1,0.00029,79336,23.17097,342394
8264,dixon1e,1,0.00029,79337,23.17126,342394
8265,dj456119,1,0.00029,79338,23.17155,342394
8266,djain13,1,0.00029,79339,23.17184,342394
8267,djakielskiadesso,1,0.00029,79340,23.17214,342394
8268,djangolo,1,0.00029,79341,23.17243,342394
8269,djatkdgus789,1,0.00029,79342,23.17272,342394
8270,djl197,1,0.00029,79343,23.17301,342394
8271,djmnnit10,1,0.00029,79344,23.17330,342394
8272,djshow832,1,0.00029,79345,23.17360,342394
8273,djtuBIG-MaliceX,1,0.00029,79346,23.17389,342394
8274,dl13260888260,1,0.00029,79347,23.17418,342394
8275,dlcrista,1,0.00029,79348,23.17447,342394
8276,dlipofsky,1,0.00029,79349,23.17476,342394
8277,dlowrey,1,0.00029,79350,23.17506,342394
8278,dlsrb6342,1,0.00029,79351,23.17535,342394
8279,DMajrekar,1,0.00029,79352,23.17564,342394
8280,dmanser92,1,0.00029,79353,23.17593,342394
8281,dmavrommatis,1,0.00029,79354,23.17622,342394
8282,dmayott,1,0.00029,79355,23.17652,342394
8283,dmduggan,1,0.00029,79356,23.17681,342394
8284,dmerrick,1,0.00029,79357,23.17710,342394
8285,dmitriishaburov,1,0.00029,79358,23.17739,342394
8286,dmpavlidis,1,0.00029,79359,23.17768,342394
8287,dnutels,1,0.00029,79360,23.17798,342394
8288,dobrevavictoria,1,0.00029,79361,23.17827,342394
8289,doctorpangloss,1,0.00029,79362,23.17856,342394
8290,DodgeCamaro,1,0.00029,79363,23.17885,342394
8291,dogewzy,1,0.00029,79364,23.17914,342394
8292,dogslee,1,0.00029,79365,23.17944,342394
8293,dogzzdogzz,1,0.00029,79366,23.17973,342394
8294,doimet,1,0.00029,79367,23.18002,342394
8295,doktormerlin,1,0.00029,79368,23.18031,342394
8296,dolencd,1,0.00029,79369,23.18060,342394
8297,DoM1niC,1,0.00029,79370,23.18090,342394
8298,dominbdg,1,0.00029,79371,23.18119,342394
8299,dominikhiebler,1,0.00029,79372,23.18148,342394
8300,Domwa,1,0.00029,79373,23.18177,342394
8301,donelpedro,1,0.00029,79374,23.18207,342394
8302,donychen1134,1,0.00029,79375,23.18236,342394
8303,doortts,1,0.00029,79376,23.18265,342394
8304,doppleware,1,0.00029,79377,23.18294,342394
8305,dorongold,1,0.00029,79378,23.18323,342394
8306,dosmanak,1,0.00029,79379,23.18353,342394
8307,dossett,1,0.00029,79380,23.18382,342394
8308,dostalradim,1,0.00029,79381,23.18411,342394
8309,doug-ba,1,0.00029,79382,23.18440,342394
8310,dougfort,1,0.00029,79383,23.18469,342394
8311,dovefi,1,0.00029,79384,23.18499,342394
8312,dpachiappan,1,0.00029,79385,23.18528,342394
8313,dpaks,1,0.00029,79386,23.18557,342394
8314,dragonpaw,1,0.00029,79387,23.18586,342394
8315,drbennett,1,0.00029,79388,23.18615,342394
8316,dr-duke,1,0.00029,79389,23.18645,342394
8317,DreamDZhu,1,0.00029,79390,23.18674,342394
8318,drehpehs,1,0.00029,79391,23.18703,342394
8319,dreske,1,0.00029,79392,23.18732,342394
8320,drewmassey,1,0.00029,79393,23.18761,342394
8321,drewp,1,0.00029,79394,23.18791,342394
8322,drichards188,1,0.00029,79395,23.18820,342394
8323,driedler,1,0.00029,79396,23.18849,342394
8324,DriveAthelete,1,0.00029,79397,23.18878,342394
8325,drop-rahul,1,0.00029,79398,23.18907,342394
8326,DrPhil,1,0.00029,79399,23.18937,342394
8327,drriguz,1,0.00029,79400,23.18966,342394
8328,drshawnkwang,1,0.00029,79401,23.18995,342394
8329,dr-shim,1,0.00029,79402,23.19024,342394
8330,DRuggeri,1,0.00029,79403,23.19053,342394
8331,dsaintilma-flinks,1,0.00029,79404,23.19083,342394
8332,dsalisbury,1,0.00029,79405,23.19112,342394
8333,d-selifanov,1,0.00029,79406,23.19141,342394
8334,dsharp-pivotal,1,0.00029,79407,23.19170,342394
8335,dsmiley,1,0.00029,79408,23.19200,342394
8336,dsosale,1,0.00029,79409,23.19229,342394
8337,dsouzajaison,1,0.00029,79410,23.19258,342394
8338,dtthuynh,1,0.00029,79411,23.19287,342394
8339,duament,1,0.00029,79412,23.19316,342394
8340,Duanzhiwei,1,0.00029,79413,23.19346,342394
8341,dudniksergei,1,0.00029,79414,23.19375,342394
8342,duguhaotian,1,0.00029,79415,23.19404,342394
8343,dusk125,1,0.00029,79416,23.19433,342394
8344,duttonw,1,0.00029,79417,23.19462,342394
8345,duwanqiebi,1,0.00029,79418,23.19492,342394
8346,DVDripXvid,1,0.00029,79419,23.19521,342394
8347,dyasny,1,0.00029,79420,23.19550,342394
8348,dyfrgi,1,0.00029,79421,23.19579,342394
8349,dylanANZ,1,0.00029,79422,23.19608,342394
8350,Dymanik,1,0.00029,79423,23.19638,342394
8351,dytyniuk,1,0.00029,79424,23.19667,342394
8352,Dzejkop,1,0.00029,79425,23.19696,342394
8353,dzzmaster,1,0.00029,79426,23.19725,342394
8354,e96wic,1,0.00029,79427,23.19754,342394
8355,eak13,1,0.00029,79428,23.19784,342394
8356,eakraly,1,0.00029,79429,23.19813,342394
8357,eakurdyukov,1,0.00029,79430,23.19842,342394
8358,eb4x,1,0.00029,79431,23.19871,342394
8359,ebattat,1,0.00029,79432,23.19900,342394
8360,ebrianne,1,0.00029,79433,23.19930,342394
8361,Ebrithil95,1,0.00029,79434,23.19959,342394
8362,ebullient,1,0.00029,79435,23.19988,342394
8363,EchoZhaoH,1,0.00029,79436,23.20017,342394
8364,eclipsewebmaster,1,0.00029,79437,23.20046,342394
8365,eculver,1,0.00029,79438,23.20076,342394
8366,edanc,1,0.00029,79439,23.20105,342394
8367,Eddie-he,1,0.00029,79440,23.20134,342394
8368,eddiehoffman,1,0.00029,79441,23.20163,342394
8369,EDDYMENS,1,0.00029,79442,23.20193,342394
8370,edeati,1,0.00029,79443,23.20222,342394
8371,edemen,1,0.00029,79444,23.20251,342394
8372,edeNFed,1,0.00029,79445,23.20280,342394
8373,edenstrom,1,0.00029,79446,23.20309,342394
8374,Edgarmejiav,1,0.00029,79447,23.20339,342394
8375,edijsdrezovs,1,0.00029,79448,23.20368,342394
8376,edobry,1,0.00029,79449,23.20397,342394
8377,eduardoaw,1,0.00029,79450,23.20426,342394
8378,EduMorenoJ,1,0.00029,79451,23.20455,342394
8379,edwardcookemacu,1,0.00029,79452,23.20485,342394
8380,edwardmeng,1,0.00029,79453,23.20514,342394
8381,edward-pis-1670,1,0.00029,79454,23.20543,342394
8382,eechau,1,0.00029,79455,23.20572,342394
8383,ee-github,1,0.00029,79456,23.20601,342394
8384,Eerosal,1,0.00029,79457,23.20631,342394
8385,effitient,1,0.00029,79458,23.20660,342394
8386,effyyvv,1,0.00029,79459,23.20689,342394
8387,egavard,1,0.00029,79460,23.20718,342394
8388,egeste,1,0.00029,79461,23.20747,342394
8389,eggboy,1,0.00029,79462,23.20777,342394
8390,EGuesnet,1,0.00029,79463,23.20806,342394
8391,egzonzeneli,1,0.00029,79464,23.20835,342394
8392,EHEX-schildt,1,0.00029,79465,23.20864,342394
8393,ehjizao,1,0.00029,79466,23.20893,342394
8394,eightnoteight,1,0.00029,79467,23.20923,342394
8395,eikc,1,0.00029,79468,23.20952,342394
8396,eileensheu,1,0.00029,79469,23.20981,342394
8397,ejderdal,1,0.00029,79470,23.21010,342394
8398,ejianlv,1,0.00029,79471,23.21040,342394
8399,EJKinger,1,0.00029,79472,23.21069,342394
8400,ekcs,1,0.00029,79473,23.21098,342394
8401,ekovacs,1,0.00029,79474,23.21127,342394
8402,elasticjava,1,0.00029,79475,23.21156,342394
8403,elbaro,1,0.00029,79476,23.21186,342394
8404,elchesco,1,0.00029,79477,23.21215,342394
8405,Eldarrin,1,0.00029,79478,23.21244,342394
8406,elftech,1,0.00029,79479,23.21273,342394
8407,Eliah7,1,0.00029,79480,23.21302,342394
8408,eliassal,1,0.00029,79481,23.21332,342394
8409,elig-salt,1,0.00029,79482,23.21361,342394
8410,eliw00d,1,0.00029,79483,23.21390,342394
8411,elkh510,1,0.00029,79484,23.21419,342394
8412,ElkRom,1,0.00029,79485,23.21448,342394
8413,ellisio,1,0.00029,79486,23.21478,342394
8414,ellispritchard,1,0.00029,79487,23.21507,342394
8415,elocke,1,0.00029,79488,23.21536,342394
8416,elsony,1,0.00029,79489,23.21565,342394
8417,emalpb,1,0.00029,79490,23.21594,342394
8418,embcla,1,0.00029,79491,23.21624,342394
8419,emenendez,1,0.00029,79492,23.21653,342394
8420,emhelmich,1,0.00029,79493,23.21682,342394
8421,emilvberglind,1,0.00029,79494,23.21711,342394
8422,emily-chan-git,1,0.00029,79495,23.21740,342394
8423,emily-ganze,1,0.00029,79496,23.21770,342394
8424,eminalemdar,1,0.00029,79497,23.21799,342394
8425,emoritzx,1,0.00029,79498,23.21828,342394
8426,employeeeee,1,0.00029,79499,23.21857,342394
8427,encigem,1,0.00029,79500,23.21886,342394
8428,encryptblockr,1,0.00029,79501,23.21916,342394
8429,endianjoakim,1,0.00029,79502,23.21945,342394
8430,enerdgumen,1,0.00029,79503,23.21974,342394
8431,enniomorricone123,1,0.00029,79504,23.22003,342394
8432,Enough7,1,0.00029,79505,23.22033,342394
8433,enraiha0307,1,0.00029,79506,23.22062,342394
8434,Enrico204,1,0.00029,79507,23.22091,342394
8435,enthusiva,1,0.00029,79508,23.22120,342394
8436,entigo-mart-erlenheim,1,0.00029,79509,23.22149,342394
8437,eokorieFA,1,0.00029,79510,23.22179,342394
8438,ep4sh,1,0.00029,79511,23.22208,342394
8439,eperdeme,1,0.00029,79512,23.22237,342394
8440,eperezvcc,1,0.00029,79513,23.22266,342394
8441,epollia,1,0.00029,79514,23.22295,342394
8442,epoz,1,0.00029,79515,23.22325,342394
8443,epubreader,1,0.00029,79516,23.22354,342394
8444,eqsoft,1,0.00029,79517,23.22383,342394
8445,erdkse,1,0.00029,79518,23.22412,342394
8446,erenming,1,0.00029,79519,23.22441,342394
8447,erhwenkuo,1,0.00029,79520,23.22471,342394
8448,erickpeirson,1,0.00029,79521,23.22500,342394
8449,Erick-shi,1,0.00029,79522,23.22529,342394
8450,ericls,1,0.00029,79523,23.22558,342394
8451,eridiumdev,1,0.00029,79524,23.22587,342394
8452,erikanderson,1,0.00029,79525,23.22617,342394
8453,erkerb4,1,0.00029,79526,23.22646,342394
8454,erkules,1,0.00029,79527,23.22675,342394
8455,Erlichooo,1,0.00029,79528,23.22704,342394
8456,ermingpei,1,0.00029,79529,23.22733,342394
8457,erms77,1,0.00029,79530,23.22763,342394
8458,Erokos,1,0.00029,79531,23.22792,342394
8459,eroshiva,1,0.00029,79532,23.22821,342394
8460,erSitzt,1,0.00029,79533,23.22850,342394
8461,ErwinRebergen,1,0.00029,79534,23.22879,342394
8462,esenmx,1,0.00029,79535,23.22909,342394
8463,eshandhawan51,1,0.00029,79536,23.22938,342394
8464,esimim,1,0.00029,79537,23.22967,342394
8465,Eslam-mohammed-anwar,1,0.00029,79538,23.22996,342394
8466,esolCrusador,1,0.00029,79539,23.23026,342394
8467,esphen,1,0.00029,79540,23.23055,342394
8468,espizo,1,0.00029,79541,23.23084,342394
8469,estiller,1,0.00029,79542,23.23113,342394
8470,estk,1,0.00029,79543,23.23142,342394
8471,eternal-dragon,1,0.00029,79544,23.23172,342394
8472,EthanH-Li,1,0.00029,79545,23.23201,342394
8473,ethercrow,1,0.00029,79546,23.23230,342394
8474,e-tienne,1,0.00029,79547,23.23259,342394
8475,eugenberend,1,0.00029,79548,23.23288,342394
8476,eugene-katsevman,1,0.00029,79549,23.23318,342394
8477,EugenePeter,1,0.00029,79550,23.23347,342394
8478,Eugenevml,1,0.00029,79551,23.23376,342394
8479,EvanMachusakNCQA,1,0.00029,79552,23.23405,342394
8480,everops-matt,1,0.00029,79553,23.23434,342394
8481,eversC,1,0.00029,79554,23.23464,342394
8482,evertonevaristo,1,0.00029,79555,23.23493,342394
8483,evilgenius-jp,1,0.00029,79556,23.23522,342394
8484,evilhamsterman,1,0.00029,79557,23.23551,342394
8485,evilrussian,1,0.00029,79558,23.23580,342394
8486,evlon,1,0.00029,79559,23.23610,342394
8487,ewuknadierf,1,0.00029,79560,23.23639,342394
8488,exagil,1,0.00029,79561,23.23668,342394
8489,Expelizabeth,1,0.00029,79562,23.23697,342394
8490,eze-kiel,1,0.00029,79563,23.23726,342394
8491,f18m,1,0.00029,79564,23.23756,342394
8492,F34th3R,1,0.00029,79565,23.23785,342394
8493,f9-abs,1,0.00029,79566,23.23814,342394
8494,fabian-braun,1,0.00029,79567,23.23843,342394
8495,fabianfett,1,0.00029,79568,23.23872,342394
8496,FabianNiehaus,1,0.00029,79569,23.23902,342394
8497,fabianopimentel,1,0.00029,79570,23.23931,342394
8498,fabiolnm,1,0.00029,79571,23.23960,342394
8499,fabiosimeoni,1,0.00029,79572,23.23989,342394
8500,fabiovianadotcom,1,0.00029,79573,23.24019,342394
8501,fabistb,1,0.00029,79574,23.24048,342394
8502,fabn,1,0.00029,79575,23.24077,342394
8503,facundoalarcon,1,0.00029,79576,23.24106,342394
8504,faizanrafiq-fr,1,0.00029,79577,23.24135,342394
8505,Falimonda,1,0.00029,79578,23.24165,342394
8506,falk0069,1,0.00029,79579,23.24194,342394
8507,FalxDrako,1,0.00029,79580,23.24223,342394
8508,FanChenyu,1,0.00029,79581,23.24252,342394
8509,fanchuanster,1,0.00029,79582,23.24281,342394
8510,FanerYedermann,1,0.00029,79583,23.24311,342394
8511,farhanangullia,1,0.00029,79584,23.24340,342394
8512,FarhanKhan-sains,1,0.00029,79585,23.24369,342394
8513,farhansj,1,0.00029,79586,23.24398,342394
8514,farnsworth,1,0.00029,79587,23.24427,342394
8515,farooqte96,1,0.00029,79588,23.24457,342394
8516,fcamarro,1,0.00029,79589,23.24486,342394
8517,fcorti,1,0.00029,79590,23.24515,342394
8518,fdelucchijr,1,0.00029,79591,23.24544,342394
8519,FearlessHyena,1,0.00029,79592,23.24573,342394
8520,febus982,1,0.00029,79593,23.24603,342394
8521,FedericoJurio,1,0.00029,79594,23.24632,342394
8522,fedor-git,1,0.00029,79595,23.24661,342394
8523,feiniao886,1,0.00029,79596,23.24690,342394
8524,Felipemirand0,1,0.00029,79597,23.24719,342394
8525,felixfaisal,1,0.00029,79598,23.24749,342394
8526,felixfarquharson,1,0.00029,79599,23.24778,342394
8527,FelixSFD,1,0.00029,79600,23.24807,342394
8528,felixtoe,1,0.00029,79601,23.24836,342394
8529,fenfir,1,0.00029,79602,23.24866,342394
8530,fengwang666,1,0.00029,79603,23.24895,342394
8531,fengzhibin,1,0.00029,79604,23.24924,342394
8532,FerandoGH,1,0.00029,79605,23.24953,342394
8533,ferasawadi,1,0.00029,79606,23.24982,342394
8534,Ferenc-,1,0.00029,79607,23.25012,342394
8535,fernandino143,1,0.00029,79608,23.25041,342394
8536,fernandoTorresan,1,0.00029,79609,23.25070,342394
8537,FernFerret,1,0.00029,79610,23.25099,342394
8538,FeroVolar,1,0.00029,79611,23.25128,342394
8539,Ferror,1,0.00029,79612,23.25158,342394
8540,fethibilog,1,0.00029,79613,23.25187,342394
8541,fewdan,1,0.00029,79614,23.25216,342394
8542,FfffatAss,1,0.00029,79615,23.25245,342394
8543,fgascon,1,0.00029,79616,23.25274,342394
8544,fgendc,1,0.00029,79617,23.25304,342394
8545,fhera,1,0.00029,79618,23.25333,342394
8546,fhopfensperger,1,0.00029,79619,23.25362,342394
8547,fidian,1,0.00029,79620,23.25391,342394
8548,FieteO,1,0.00029,79621,23.25420,342394
8549,FilBot3,1,0.00029,79622,23.25450,342394
8550,filipenf,1,0.00029,79623,23.25479,342394
8551,FilipposKaragiannis,1,0.00029,79624,23.25508,342394
8552,Filter94,1,0.00029,79625,23.25537,342394
8553,Finfalter,1,0.00029,79626,23.25566,342394
8554,fingthinking,1,0.00029,79627,23.25596,342394
8555,firdavsich,1,0.00029,79628,23.25625,342394
8556,firefixmaarten,1,0.00029,79629,23.25654,342394
8557,firefly-serenity,1,0.00029,79630,23.25683,342394
8558,FischerLGLN,1,0.00029,79631,23.25712,342394
8559,fishANDdog,1,0.00029,79632,23.25742,342394
8560,fishpen0,1,0.00029,79633,23.25771,342394
8561,fjtirado,1,0.00029,79634,23.25800,342394
8562,fkaleo,1,0.00029,79635,23.25829,342394
8563,fktkrt,1,0.00029,79636,23.25859,342394
8564,flakeman2,1,0.00029,79637,23.25888,342394
8565,flamein,1,0.00029,79638,23.25917,342394
8566,flanger001,1,0.00029,79639,23.25946,342394
8567,FLavalliere,1,0.00029,79640,23.25975,342394
8568,flelain,1,0.00029,79641,23.26005,342394
8569,Flern,1,0.00029,79642,23.26034,342394
8570,flisak-robert,1,0.00029,79643,23.26063,342394
8571,floknip,1,0.00029,79644,23.26092,342394
8572,FlorinPeter,1,0.00029,79645,23.26121,342394
8573,flowbehappy,1,0.00029,79646,23.26151,342394
8574,flowly,1,0.00029,79647,23.26180,342394
8575,flowscolors,1,0.00029,79648,23.26209,342394
8576,fluxx-sleblanc,1,0.00029,79649,23.26238,342394
8577,FlxPeters,1,0.00029,79650,23.26267,342394
8578,flyinggecko,1,0.00029,79651,23.26297,342394
8579,flypolarbear,1,0.00029,79652,23.26326,342394
8580,fmbahrt,1,0.00029,79653,23.26355,342394
8581,fmg-dave,1,0.00029,79654,23.26384,342394
8582,fnkr,1,0.00029,79655,23.26413,342394
8583,foamkeen,1,0.00029,79656,23.26443,342394
8584,fockboi-lgtm,1,0.00029,79657,23.26472,342394
8585,Fomalhauthmj,1,0.00029,79658,23.26501,342394
8586,FonzTech,1,0.00029,79659,23.26530,342394
8587,fopina,1,0.00029,79660,23.26559,342394
8588,foreignmeloman,1,0.00029,79661,23.26589,342394
8589,fornellas,1,0.00029,79662,23.26618,342394
8590,forselli-stratio,1,0.00029,79663,23.26647,342394
8591,forthgate,1,0.00029,79664,23.26676,342394
8592,fox-md,1,0.00029,79665,23.26705,342394
8593,FrancoisPoinsot,1,0.00029,79666,23.26735,342394
8594,francozulian,1,0.00029,79667,23.26764,342394
8595,frandelgado,1,0.00029,79668,23.26793,342394
8596,franklinkim,1,0.00029,79669,23.26822,342394
8597,FrankWang1108,1,0.00029,79670,23.26852,342394
8598,fransemino,1,0.00029,79671,23.26881,342394
8599,frasercchristie,1,0.00029,79672,23.26910,342394
8600,fredcsfaria,1,0.00029,79673,23.26939,342394
8601,freddyfernando,1,0.00029,79674,23.26968,342394
8602,fredericpougnault,1,0.00029,79675,23.26998,342394
8603,fredrikaverpil,1,0.00029,79676,23.27027,342394
8604,friasandres,1,0.00029,79677,23.27056,342394
8605,fridgepoet,1,0.00029,79678,23.27085,342394
8606,fritz-net,1,0.00029,79679,23.27114,342394
8607,frommeyerc,1,0.00029,79680,23.27144,342394
8608,frsh-augustin,1,0.00029,79681,23.27173,342394
8609,fschmied,1,0.00029,79682,23.27202,342394
8610,fsduser,1,0.00029,79683,23.27231,342394
8611,fsperling,1,0.00029,79684,23.27260,342394
8612,Fullplate,1,0.00029,79685,23.27290,342394
8613,Funami580,1,0.00029,79686,23.27319,342394
8614,Funk66,1,0.00029,79687,23.27348,342394
8615,fvelaayl,1,0.00029,79688,23.27377,342394
8616,fvogl,1,0.00029,79689,23.27406,342394
8617,fw-ctf,1,0.00029,79690,23.27436,342394
8618,fwt11,1,0.00029,79691,23.27465,342394
8619,fxl0206,1,0.00029,79692,23.27494,342394
8620,fxshlein,1,0.00029,79693,23.27523,342394
8621,fzyzcjy,1,0.00029,79694,23.27552,342394
8622,g00nix,1,0.00029,79695,23.27582,342394
8623,g3kr,1,0.00029,79696,23.27611,342394
8624,g3rzi,1,0.00029,79697,23.27640,342394
8625,G5Olivieri,1,0.00029,79698,23.27669,342394
8626,ga0x1ang,1,0.00029,79699,23.27698,342394
8627,gabfelp,1,0.00029,79700,23.27728,342394
8628,gabrielalbino,1,0.00029,79701,23.27757,342394
8629,gabrieleiannetti,1,0.00029,79702,23.27786,342394
8630,GabrielLasso,1,0.00029,79703,23.27815,342394
8631,Gabriel-rd2,1,0.00029,79704,23.27845,342394
8632,gabrielribass,1,0.00029,79705,23.27874,342394
8633,gabrieltomasrizzo,1,0.00029,79706,23.27903,342394
8634,gabstv,1,0.00029,79707,23.27932,342394
8635,Gaen,1,0.00029,79708,23.27961,342394
8636,gagzm,1,0.00029,79709,23.27991,342394
8637,gai6948,1,0.00029,79710,23.28020,342394
8638,Gajanana,1,0.00029,79711,23.28049,342394
8639,gajda-b,1,0.00029,79712,23.28078,342394
8640,galemccommons,1,0.00029,79713,23.28107,342394
8641,galgross,1,0.00029,79714,23.28137,342394
8642,Gambero81,1,0.00029,79715,23.28166,342394
8643,gAmUssA,1,0.00029,79716,23.28195,342394
8644,g-andrade,1,0.00029,79717,23.28224,342394
8645,GaneshVKadam,1,0.00029,79718,23.28253,342394
8646,gao1399677,1,0.00029,79719,23.28283,342394
8647,garciarodrigor,1,0.00029,79720,23.28312,342394
8648,garenwen,1,0.00029,79721,23.28341,342394
8649,garrmark,1,0.00029,79722,23.28370,342394
8650,Gashmore1,1,0.00029,79723,23.28399,342394
8651,gastonborba,1,0.00029,79724,23.28429,342394
8652,gastrodon,1,0.00029,79725,23.28458,342394
8653,gauravb-uber,1,0.00029,79726,23.28487,342394
8654,gautamnaha,1,0.00029,79727,23.28516,342394
8655,gautampunhani,1,0.00029,79728,23.28545,342394
8656,gautamr,1,0.00029,79729,23.28575,342394
8657,gavenkoa,1,0.00029,79730,23.28604,342394
8658,gazben,1,0.00029,79731,23.28633,342394
8659,gbavoz1,1,0.00029,79732,23.28662,342394
8660,gbrayut,1,0.00029,79733,23.28692,342394
8661,gbstan92,1,0.00029,79734,23.28721,342394
8662,gbuirel,1,0.00029,79735,23.28750,342394
8663,gcampbell-mythical,1,0.00029,79736,23.28779,342394
8664,gcaracuel,1,0.00029,79737,23.28808,342394
8665,gcetrone3,1,0.00029,79738,23.28838,342394
8666,gcharnock,1,0.00029,79739,23.28867,342394
8667,gciavarrini,1,0.00029,79740,23.28896,342394
8668,gczarnocki,1,0.00029,79741,23.28925,342394
8669,gdams,1,0.00029,79742,23.28954,342394
8670,gdnnasonovandrey,1,0.00029,79743,23.28984,342394
8671,gdubicki,1,0.00029,79744,23.29013,342394
8672,gecgooden,1,0.00029,79745,23.29042,342394
8673,gedennis,1,0.00029,79746,23.29071,342394
8674,GeGavin,1,0.00029,79747,23.29100,342394
8675,gekonwi,1,0.00029,79748,23.29130,342394
8676,generalpax,1,0.00029,79749,23.29159,342394
8677,genieai-vikas,1,0.00029,79750,23.29188,342394
8678,Gentoli,1,0.00029,79751,23.29217,342394
8679,geoffrey-pascal,1,0.00029,79752,23.29246,342394
8680,georg007,1,0.00029,79753,23.29276,342394
8681,georgehao,1,0.00029,79754,23.29305,342394
8682,georgej-github,1,0.00029,79755,23.29334,342394
8683,georgestoica-prive,1,0.00029,79756,23.29363,342394
8684,gerardquinn43,1,0.00029,79757,23.29392,342394
8685,gerrywastaken,1,0.00029,79758,23.29422,342394
8686,gethash,1,0.00029,79759,23.29451,342394
8687,gevraud,1,0.00029,79760,23.29480,342394
8688,Gezx,1,0.00029,79761,23.29509,342394
8689,gfernandez1988,1,0.00029,79762,23.29538,342394
8690,gfppower,1,0.00029,79763,23.29568,342394
8691,gfrankliu,1,0.00029,79764,23.29597,342394
8692,gfuzz-asplos,1,0.00029,79765,23.29626,342394
8693,gfvirga,1,0.00029,79766,23.29655,342394
8694,gf-zhangdd,1,0.00029,79767,23.29685,342394
8695,ggalakhov,1,0.00029,79768,23.29714,342394
8696,ggallagher0,1,0.00029,79769,23.29743,342394
8697,gglnp,1,0.00029,79770,23.29772,342394
8698,ghairui,1,0.00029,79771,23.29801,342394
8699,ghdiska,1,0.00029,79772,23.29831,342394
8700,ghilman27,1,0.00029,79773,23.29860,342394
8701,ghoneimy,1,0.00029,79774,23.29889,342394
8702,GhostInThePotato,1,0.00029,79775,23.29918,342394
8703,ghrk91,1,0.00029,79776,23.29947,342394
8704,ghsbhatia,1,0.00029,79777,23.29977,342394
8705,gibbonsjohnm,1,0.00029,79778,23.30006,342394
8706,gibbscullen,1,0.00029,79779,23.30035,342394
8707,giezi,1,0.00029,79780,23.30064,342394
8708,gifhupp,1,0.00029,79781,23.30093,342394
8709,gigglegrig,1,0.00029,79782,23.30123,342394
8710,gigi-at-zymergen,1,0.00029,79783,23.30152,342394
8711,gigilee,1,0.00029,79784,23.30181,342394
8712,gilbahat,1,0.00029,79785,23.30210,342394
8713,gillesdouaire,1,0.00029,79786,23.30239,342394
8714,Gim6626,1,0.00029,79787,23.30269,342394
8715,gingercat-maki,1,0.00029,79788,23.30298,342394
8716,giorgiomondauto,1,0.00029,79789,23.30327,342394
8717,giorgosdi,1,0.00029,79790,23.30356,342394
8718,giselleserate-okta,1,0.00029,79791,23.30385,342394
8719,gitank007,1,0.00029,79792,23.30415,342394
8720,gitforanand,1,0.00029,79793,23.30444,342394
8721,GitHubFor122,1,0.00029,79794,23.30473,342394
8722,github-reader,1,0.00029,79795,23.30502,342394
8723,GithubRyze,1,0.00029,79796,23.30531,342394
8724,gitricko,1,0.00029,79797,23.30561,342394
8725,GiviMAD,1,0.00029,79798,23.30590,342394
8726,gjfzjj1995,1,0.00029,79799,23.30619,342394
8727,gjirm,1,0.00029,79800,23.30648,342394
8728,gjkloosterman,1,0.00029,79801,23.30678,342394
8729,gjp0609,1,0.00029,79802,23.30707,342394
8730,gkmahendran09,1,0.00029,79803,23.30736,342394
8731,gladiatr72,1,0.00029,79804,23.30765,342394
8732,GlassOfWhiskey,1,0.00029,79805,23.30794,342394
8733,GlebIgnatevEmlid,1,0.00029,79806,23.30824,342394
8734,glebk,1,0.00029,79807,23.30853,342394
8735,glightfoot,1,0.00029,79808,23.30882,342394
8736,g-linville,1,0.00029,79809,23.30911,342394
8737,gloscott,1,0.00029,79810,23.30940,342394
8738,glrf,1,0.00029,79811,23.30970,342394
8739,GLZjd4NMPVucBIvbWs,1,0.00029,79812,23.30999,342394
8740,Gmanweb,1,0.00029,79813,23.31028,342394
8741,gmarkey,1,0.00029,79814,23.31057,342394
8742,gmiam,1,0.00029,79815,23.31086,342394
8743,gmuth,1,0.00029,79816,23.31116,342394
8744,gnodet,1,0.00029,79817,23.31145,342394
8745,GNUGradyn,1,0.00029,79818,23.31174,342394
8746,gobins,1,0.00029,79819,23.31203,342394
8747,GodLoveMinch,1,0.00029,79820,23.31232,342394
8748,goelaashima,1,0.00029,79821,23.31262,342394
8749,gofort,1,0.00029,79822,23.31291,342394
8750,gokhan721,1,0.00029,79823,23.31320,342394
8751,golx,1,0.00029,79824,23.31349,342394
8752,gonejack,1,0.00029,79825,23.31378,342394
8753,gongzhun,1,0.00029,79826,23.31408,342394
8754,gooddalton,1,0.00029,79827,23.31437,342394
8755,good-good-study,1,0.00029,79828,23.31466,342394
8756,gopkg-dev,1,0.00029,79829,23.31495,342394
8757,gorantornqvist,1,0.00029,79830,23.31525,342394
8758,gorsr01,1,0.00029,79831,23.31554,342394
8759,GoSiddhartha,1,0.00029,79832,23.31583,342394
8760,gothrek22,1,0.00029,79833,23.31612,342394
8761,goto100,1,0.00029,79834,23.31641,342394
8762,gouravsw,1,0.00029,79835,23.31671,342394
8763,Gourds,1,0.00029,79836,23.31700,342394
8764,goutamtadi1,1,0.00029,79837,23.31729,342394
8765,Govinda-Fichtner,1,0.00029,79838,23.31758,342394
8766,govindkailas,1,0.00029,79839,23.31787,342394
8767,Gowlar,1,0.00029,79840,23.31817,342394
8768,GowthamShanmugam,1,0.00029,79841,23.31846,342394
8769,gpierard,1,0.00029,79842,23.31875,342394
8770,graham2071,1,0.00029,79843,23.31904,342394
8771,grahammather,1,0.00029,79844,23.31933,342394
8772,grajeshwaran,1,0.00029,79845,23.31963,342394
8773,grand-lotus-iroh,1,0.00029,79846,23.31992,342394
8774,grantral,1,0.00029,79847,23.32021,342394
8775,grascioni,1,0.00029,79848,23.32050,342394
8776,graydon,1,0.00029,79849,23.32079,342394
8777,gregbanks,1,0.00029,79850,23.32109,342394
8778,greghao,1,0.00029,79851,23.32138,342394
8779,gregkoganvmm,1,0.00029,79852,23.32167,342394
8780,gregory112,1,0.00029,79853,23.32196,342394
8781,gregorybleiker,1,0.00029,79854,23.32225,342394
8782,gricec,1,0.00029,79855,23.32255,342394
8783,gricuk,1,0.00029,79856,23.32284,342394
8784,gris-gris,1,0.00029,79857,23.32313,342394
8785,grmhay,1,0.00029,79858,23.32342,342394
8786,grobza,1,0.00029,79859,23.32371,342394
8787,groschi24,1,0.00029,79860,23.32401,342394
8788,grstein,1,0.00029,79861,23.32430,342394
8789,gruberdev,1,0.00029,79862,23.32459,342394
8790,Gruntdav,1,0.00029,79863,23.32488,342394
8791,gryevns,1,0.00029,79864,23.32518,342394
8792,grzebia,1,0.00029,79865,23.32547,342394
8793,grzegdl,1,0.00029,79866,23.32576,342394
8794,grzegorz-mirek,1,0.00029,79867,23.32605,342394
8795,gsaraf,1,0.00029,79868,23.32634,342394
8796,gshamov,1,0.00029,79869,23.32664,342394
8797,gsimoes,1,0.00029,79870,23.32693,342394
8798,gsingh-ds,1,0.00029,79871,23.32722,342394
8799,gsphanikumar,1,0.00029,79872,23.32751,342394
8800,gtato,1,0.00029,79873,23.32780,342394
8801,gtuk,1,0.00029,79874,23.32810,342394
8802,GuangTianLi,1,0.00029,79875,23.32839,342394
8803,GuanYin108,1,0.00029,79876,23.32868,342394
8804,guchao0318,1,0.00029,79877,23.32897,342394
8805,gugugubo,1,0.00029,79878,23.32926,342394
8806,guihouchang,1,0.00029,79879,23.32956,342394
8807,guilhermepiccoli,1,0.00029,79880,23.32985,342394
8808,guiliguili,1,0.00029,79881,23.33014,342394
8809,guillaumed-unity,1,0.00029,79882,23.33043,342394
8810,guillaume-philippon,1,0.00029,79883,23.33072,342394
8811,guillemj,1,0.00029,79884,23.33102,342394
8812,guschin,1,0.00029,79885,23.33131,342394
8813,guspio,1,0.00029,79886,23.33160,342394
8814,GusTheSadGeek,1,0.00029,79887,23.33189,342394
8815,GuyGrin,1,0.00029,79888,23.33218,342394
8816,guyoulan,1,0.00029,79889,23.33248,342394
8817,guyrleech,1,0.00029,79890,23.33277,342394
8818,guyromb,1,0.00029,79891,23.33306,342394
8819,gvanto,1,0.00029,79892,23.33335,342394
8820,gyakovlev,1,0.00029,79893,23.33364,342394
8821,gyaozhou,1,0.00029,79894,23.33394,342394
8822,gyeongsikjang,1,0.00029,79895,23.33423,342394
8823,gzdreamfly,1,0.00029,79896,23.33452,342394
8824,h3ar7dump,1,0.00029,79897,23.33481,342394
8825,h3n4l,1,0.00029,79898,23.33511,342394
8826,ha36d,1,0.00029,79899,23.33540,342394
8827,haandude,1,0.00029,79900,23.33569,342394
8828,habinaya28,1,0.00029,79901,23.33598,342394
8829,hackaholic,1,0.00029,79902,23.33627,342394
8830,hacker-qian,1,0.00029,79903,23.33657,342394
8831,hackpk,1,0.00029,79904,23.33686,342394
8832,hadi-mansoori,1,0.00029,79905,23.33715,342394
8833,hadogenes,1,0.00029,79906,23.33744,342394
8834,haeringer,1,0.00029,79907,23.33773,342394
8835,haimrait,1,0.00029,79908,23.33803,342394
8836,hajovonta,1,0.00029,79909,23.33832,342394
8837,halkalaldeh,1,0.00029,79910,23.33861,342394
8838,halradaideh,1,0.00029,79911,23.33890,342394
8839,hamersaw,1,0.00029,79912,23.33919,342394
8840,Hamza-Aziz,1,0.00029,79913,23.33949,342394
8841,hangedfish,1,0.00029,79914,23.33978,342394
8842,hannesknutsson,1,0.00029,79915,23.34007,342394
8843,hans-d,1,0.00029,79916,23.34036,342394
8844,hanyuancheung,1,0.00029,79917,23.34065,342394
8845,haoguanjun,1,0.00029,79918,23.34095,342394
8846,haorenfsa,1,0.00029,79919,23.34124,342394
8847,haoyangdeng,1,0.00029,79920,23.34153,342394
8848,HappyZombies,1,0.00029,79921,23.34182,342394
8849,haraldkoch,1,0.00029,79922,23.34211,342394
8850,hardboiled,1,0.00029,79923,23.34241,342394
8851,hardikmdev,1,0.00029,79924,23.34270,342394
8852,hargrave81,1,0.00029,79925,23.34299,342394
8853,HarikrishnanBalagopal,1,0.00029,79926,23.34328,342394
8854,harishkadamudi,1,0.00029,79927,23.34357,342394
8855,harold-kfuse,1,0.00029,79928,23.34387,342394
8856,HarryEMartland,1,0.00029,79929,23.34416,342394
8857,harryfeng72,1,0.00029,79930,23.34445,342394
8858,harryliu123,1,0.00029,79931,23.34474,342394
8859,harryyann,1,0.00029,79932,23.34504,342394
8860,HarshdeepGupta,1,0.00029,79933,23.34533,342394
8861,harshdevl,1,0.00029,79934,23.34562,342394
8862,hasanlik,1,0.00029,79935,23.34591,342394
8863,hashwing,1,0.00029,79936,23.34620,342394
8864,HassanAlsamahi,1,0.00029,79937,23.34650,342394
8865,hawkerm,1,0.00029,79938,23.34679,342394
8866,hawk-liu,1,0.00029,79939,23.34708,342394
8867,Haybu,1,0.00029,79940,23.34737,342394
8868,Hazmo,1,0.00029,79941,23.34766,342394
8869,hbhadvankar,1,0.00029,79942,23.34796,342394
8870,hbrls,1,0.00029,79943,23.34825,342394
8871,hdf15804299051,1,0.00029,79944,23.34854,342394
8872,heartTorres,1,0.00029,79945,23.34883,342394
8873,hechunping,1,0.00029,79946,23.34912,342394
8874,Hector242,1,0.00029,79947,23.34942,342394
8875,hectorjsmith,1,0.00029,79948,23.34971,342394
8876,heduxar,1,0.00029,79949,23.35000,342394
8877,hee-c,1,0.00029,79950,23.35029,342394
8878,heesuk-ahn,1,0.00029,79951,23.35058,342394
8879,hegderohit89,1,0.00029,79952,23.35088,342394
8880,hehuaidong,1,0.00029,79953,23.35117,342394
8881,heiderich,1,0.00029,79954,23.35146,342394
8882,heitorPB,1,0.00029,79955,23.35175,342394
8883,hejkerooo,1,0.00029,79956,23.35204,342394
8884,hellobiek,1,0.00029,79957,23.35234,342394
8885,hellochenpc,1,0.00029,79958,23.35263,342394
8886,helloeverone,1,0.00029,79959,23.35292,342394
8887,hellolittlewei,1,0.00029,79960,23.35321,342394
8888,helloxz,1,0.00029,79961,23.35351,342394
8889,hemna,1,0.00029,79962,23.35380,342394
8890,henderjm,1,0.00029,79963,23.35409,342394
8891,hendra-2020,1,0.00029,79964,23.35438,342394
8892,hengyu-coder,1,0.00029,79965,23.35467,342394
8893,HenkVanMaanen,1,0.00029,79966,23.35497,342394
8894,hennersz,1,0.00029,79967,23.35526,342394
8895,HenningCash,1,0.00029,79968,23.35555,342394
8896,henning-cg,1,0.00029,79969,23.35584,342394
8897,henrik242,1,0.00029,79970,23.35613,342394
8898,henriquebremenkanp,1,0.00029,79971,23.35643,342394
8899,henro001,1,0.00029,79972,23.35672,342394
8900,henrysachs,1,0.00029,79973,23.35701,342394
8901,henryto-happymoney,1,0.00029,79974,23.35730,342394
8902,henrywu2019,1,0.00029,79975,23.35759,342394
8903,hensur,1,0.00029,79976,23.35789,342394
8904,heoelri,1,0.00029,79977,23.35818,342394
8905,herbertgoto,1,0.00029,79978,23.35847,342394
8906,herbygillot,1,0.00029,79979,23.35876,342394
8907,herewasmike,1,0.00029,79980,23.35905,342394
8908,HessTina-YuI,1,0.00029,79981,23.35935,342394
8909,hetpats,1,0.00029,79982,23.35964,342394
8910,heubeck,1,0.00029,79983,23.35993,342394
8911,hey333,1,0.00029,79984,23.36022,342394
8912,heydonovan,1,0.00029,79985,23.36051,342394
8913,heyitsmdr,1,0.00029,79986,23.36081,342394
8914,heylongdacoder,1,0.00029,79987,23.36110,342394
8915,heyoheyo,1,0.00029,79988,23.36139,342394
8916,hfreire,1,0.00029,79989,23.36168,342394
8917,hgsigner,1,0.00029,79990,23.36197,342394
8918,hhunter-ms,1,0.00029,79991,23.36227,342394
8919,hhy5861,1,0.00029,79992,23.36256,342394
8920,hiboyang,1,0.00029,79993,23.36285,342394
8921,hieunc278,1,0.00029,79994,23.36314,342394
8922,hightechrdn,1,0.00029,79995,23.36344,342394
8923,HighWatersDev,1,0.00029,79996,23.36373,342394
8924,hijmen,1,0.00029,79997,23.36402,342394
8925,hilenko,1,0.00029,79998,23.36431,342394
8926,himani-dangwal,1,0.00029,79999,23.36460,342394
8927,Himanshu2107,1,0.00029,80000,23.36490,342394
8928,himslm01,1,0.00029,80001,23.36519,342394
8929,hippopos,1,0.00029,80002,23.36548,342394
8930,hiteshmathur19,1,0.00029,80003,23.36577,342394
8931,HitkoDev,1,0.00029,80004,23.36606,342394
8932,hjoly2003,1,0.00029,80005,23.36636,342394
8933,hjweddie,1,0.00029,80006,23.36665,342394
8934,HK250211,1,0.00029,80007,23.36694,342394
8935,hkapasi,1,0.00029,80008,23.36723,342394
8936,hkharmfulbear,1,0.00029,80009,23.36752,342394
8937,hkuersten,1,0.00029,80010,23.36782,342394
8938,hlatimer266,1,0.00029,80011,23.36811,342394
8939,hle2,1,0.00029,80012,23.36840,342394
8940,hmaiabrex,1,0.00029,80013,23.36869,342394
8941,hoffie,1,0.00029,80014,23.36898,342394
8942,hoklet,1,0.00029,80015,23.36928,342394
8943,hol430,1,0.00029,80016,23.36957,342394
8944,HolyMiss,1,0.00029,80017,23.36986,342394
8945,homholueng,1,0.00029,80018,23.37015,342394
8946,hongchangyan,1,0.00029,80019,23.37044,342394
8947,horca,1,0.00029,80020,23.37074,342394
8948,horihel,1,0.00029,80021,23.37103,342394
8949,Horkyze,1,0.00029,80022,23.37132,342394
8950,hornv,1,0.00029,80023,23.37161,342394
8951,HoseinGhanbari,1,0.00029,80024,23.37190,342394
8952,hostsamurai,1,0.00029,80025,23.37220,342394
8953,howardjones,1,0.00029,80026,23.37249,342394
8954,Howie59,1,0.00029,80027,23.37278,342394
8955,hoyho,1,0.00029,80028,23.37307,342394
8956,hpschry,1,0.00029,80029,23.37337,342394
8957,Hptux,1,0.00029,80030,23.37366,342394
8958,hroussez,1,0.00029,80031,23.37395,342394
8959,HRusby,1,0.00029,80032,23.37424,342394
8960,hsiang-ever,1,0.00029,80033,23.37453,342394
8961,HSUCHING,1,0.00029,80034,23.37483,342394
8962,huaizhengu,1,0.00029,80035,23.37512,342394
8963,huangjiecheng,1,0.00029,80036,23.37541,342394
8964,huangshuwei,1,0.00029,80037,23.37570,342394
8965,HuangYejing,1,0.00029,80038,23.37599,342394
8966,huangzhendong,1,0.00029,80039,23.37629,342394
8967,huangzhiyong,1,0.00029,80040,23.37658,342394
8968,huangzixun123,1,0.00029,80041,23.37687,342394
8969,huaraz,1,0.00029,80042,23.37716,342394
8970,HuBaX,1,0.00029,80043,23.37745,342394
8971,hudec,1,0.00029,80044,23.37775,342394
8972,Hughen,1,0.00029,80045,23.37804,342394
8973,HugoChanD,1,0.00029,80046,23.37833,342394
8974,HugoLei,1,0.00029,80047,23.37862,342394
8975,hugolurat,1,0.00029,80048,23.37891,342394
8976,huhan110,1,0.00029,80049,23.37921,342394
8977,hujun-open,1,0.00029,80050,23.37950,342394
8978,hunghip95,1,0.00029,80051,23.37979,342394
8979,huntedhappy,1,0.00029,80052,23.38008,342394
8980,HunzlaSheikh,1,0.00029,80053,23.38037,342394
8981,huornlmj,1,0.00029,80054,23.38067,342394
8982,husamrahman,1,0.00029,80055,23.38096,342394
8983,huseyinbabal,1,0.00029,80056,23.38125,342394
8984,husky-parul,1,0.00029,80057,23.38154,342394
8985,husoule,1,0.00029,80058,23.38183,342394
8986,husseinmkwizu,1,0.00029,80059,23.38213,342394
8987,huxulm,1,0.00029,80060,23.38242,342394
8988,hy0619,1,0.00029,80061,23.38271,342394
8989,hyakuhei,1,0.00029,80062,23.38300,342394
8990,hyl24lee,1,0.00029,80063,23.38330,342394
8991,hypervisorfdi,1,0.00029,80064,23.38359,342394
8992,hypervtechnics,1,0.00029,80065,23.38388,342394
8993,hywhuangyuwei,1,0.00029,80066,23.38417,342394
8994,hzde0128,1,0.00029,80067,23.38446,342394
8995,hzhongl,1,0.00029,80068,23.38476,342394
8996,hzlml,1,0.00029,80069,23.38505,342394
8997,i4never,1,0.00029,80070,23.38534,342394
8998,iainsmith,1,0.00029,80071,23.38563,342394
8999,iamacarpet,1,0.00029,80072,23.38592,342394
9000,iambami,1,0.00029,80073,23.38622,342394
9001,iamdinesh,1,0.00029,80074,23.38651,342394
9002,iamjoseph331,1,0.00029,80075,23.38680,342394
9003,Ian-Greene,1,0.00029,80076,23.38709,342394
9004,ianhundere,1,0.00029,80077,23.38738,342394
9005,ianonavy,1,0.00029,80078,23.38768,342394
9006,ianswett,1,0.00029,80079,23.38797,342394
9007,ianutin,1,0.00029,80080,23.38826,342394
9008,IArchi,1,0.00029,80081,23.38855,342394
9009,iAziz786,1,0.00029,80082,23.38884,342394
9010,ibowen,1,0.00029,80083,23.38914,342394
9011,IbraheemAlSaady,1,0.00029,80084,23.38943,342394
9012,ibudisteanu,1,0.00029,80085,23.38972,342394
9013,icecreamhead,1,0.00029,80086,23.39001,342394
9014,icelynjennings,1,0.00029,80087,23.39030,342394
9015,ichasco-heytrade,1,0.00029,80088,23.39060,342394
9016,ichbinblau,1,0.00029,80089,23.39089,342394
9017,ichikata,1,0.00029,80090,23.39118,342394
9018,ichn-hu,1,0.00029,80091,23.39147,342394
9019,idankish,1,0.00029,80092,23.39177,342394
9020,idawson-gl,1,0.00029,80093,23.39206,342394
9021,identifysun,1,0.00029,80094,23.39235,342394
9022,ides15,1,0.00029,80095,23.39264,342394
9023,idivyanshbansal,1,0.00029,80096,23.39293,342394
9024,ievgenii-shepeliuk,1,0.00029,80097,23.39323,342394
9025,ievgen-platonov,1,0.00029,80098,23.39352,342394
9026,iFrozenPhoenix,1,0.00029,80099,23.39381,342394
9027,igibek,1,0.00029,80100,23.39410,342394
9028,igmor,1,0.00029,80101,23.39439,342394
9029,igorakkerman,1,0.00029,80102,23.39469,342394
9030,IgorEulalio,1,0.00029,80103,23.39498,342394
9031,igorwwwwwwwwwwwwwwwwwwww,1,0.00029,80104,23.39527,342394
9032,igplanet,1,0.00029,80105,23.39556,342394
9033,ii64,1,0.00029,80106,23.39585,342394
9034,iinfotech006,1,0.00029,80107,23.39615,342394
9035,iiro,1,0.00029,80108,23.39644,342394
9036,ij1,1,0.00029,80109,23.39673,342394
9037,IJOL,1,0.00029,80110,23.39702,342394
9038,ikallali,1,0.00029,80111,23.39731,342394
9039,ikandars,1,0.00029,80112,23.39761,342394
9040,iKarthik,1,0.00029,80113,23.39790,342394
9041,ikaven1024,1,0.00029,80114,23.39819,342394
9042,ikerreyes,1,0.00029,80115,23.39848,342394
9043,ileixe,1,0.00029,80116,23.39877,342394
9044,IliaOrlov,1,0.00029,80117,23.39907,342394
9045,iljoong,1,0.00029,80118,23.39936,342394
9046,illidanzen163,1,0.00029,80119,23.39965,342394
9047,illrill,1,0.00029,80120,23.39994,342394
9048,ilyache,1,0.00029,80121,23.40023,342394
9049,ILyaCyclone,1,0.00029,80122,23.40053,342394
9050,IlyaNakhaichuk,1,0.00029,80123,23.40082,342394
9051,IlyaShestakov,1,0.00029,80124,23.40111,342394
9052,ilyesAj,1,0.00029,80125,23.40140,342394
9053,imad44,1,0.00029,80126,23.40170,342394
9054,Imboncy,1,0.00029,80127,23.40199,342394
9055,imgalli,1,0.00029,80128,23.40228,342394
9056,Imhven,1,0.00029,80129,23.40257,342394
9057,imitbn,1,0.00029,80130,23.40286,342394
9058,imle,1,0.00029,80131,23.40316,342394
9059,IMMORTALxJO,1,0.00029,80132,23.40345,342394
9060,impact-maker,1,0.00029,80133,23.40374,342394
9061,Imtiazwaraich,1,0.00029,80134,23.40403,342394
9062,imuni4fun,1,0.00029,80135,23.40432,342394
9063,imxw,1,0.00029,80136,23.40462,342394
9064,inderashah007,1,0.00029,80137,23.40491,342394
9065,infa-amohanda,1,0.00029,80138,23.40520,342394
9066,infa-ddeore,1,0.00029,80139,23.40549,342394
9067,infakt-HNP,1,0.00029,80140,23.40578,342394
9068,infa-pavakuma,1,0.00029,80141,23.40608,342394
9069,inforedaster,1,0.00029,80142,23.40637,342394
9070,ingvaldlorentzen,1,0.00029,80143,23.40666,342394
9071,inhuman,1,0.00029,80144,23.40695,342394
9072,innofocus,1,0.00029,80145,23.40724,342394
9073,insanebaba,1,0.00029,80146,23.40754,342394
9074,Insighter2k,1,0.00029,80147,23.40783,342394
9075,interceptor,1,0.00029,80148,23.40812,342394
9076,inversionhourglass,1,0.00029,80149,23.40841,342394
9077,Inx51,1,0.00029,80150,23.40870,342394
9078,iochagov,1,0.00029,80151,23.40900,342394
9079,iomarcovalente,1,0.00029,80152,23.40929,342394
9080,iosifnicolae2,1,0.00029,80153,23.40958,342394
9081,ipapast,1,0.00029,80154,23.40987,342394
9082,ipomoealba,1,0.00029,80155,23.41016,342394
9083,IppX,1,0.00029,80156,23.41046,342394
9084,ipv1337,1,0.00029,80157,23.41075,342394
9085,isaidashev,1,0.00029,80158,23.41104,342394
9086,isamuelson,1,0.00029,80159,23.41133,342394
9087,isbang,1,0.00029,80160,23.41163,342394
9088,ishan2790,1,0.00029,80161,23.41192,342394
9089,ishanjainn,1,0.00029,80162,23.41221,342394
9090,ishworg,1,0.00029,80163,23.41250,342394
9091,ishworkhanal900,1,0.00029,80164,23.41279,342394
9092,Isma001,1,0.00029,80165,23.41309,342394
9093,ismaeljpv,1,0.00029,80166,23.41338,342394
9094,issamahmoud355,1,0.00029,80167,23.41367,342394
9095,istvanek,1,0.00029,80168,23.41396,342394
9096,istvansc,1,0.00029,80169,23.41425,342394
9097,IstvanSzilagyi,1,0.00029,80170,23.41455,342394
9098,ita1024,1,0.00029,80171,23.41484,342394
9099,itaispiegel,1,0.00029,80172,23.41513,342394
9100,Itanvee,1,0.00029,80173,23.41542,342394
9101,itay-grudev,1,0.00029,80174,23.41571,342394
9102,ithildir-paypal,1,0.00029,80175,23.41601,342394
9103,ith-yurybebsh,1,0.00029,80176,23.41630,342394
9104,itlinux,1,0.00029,80177,23.41659,342394
9105,itmwiw,1,0.00029,80178,23.41688,342394
9106,iTonyYo,1,0.00029,80179,23.41717,342394
9107,itroyano,1,0.00029,80180,23.41747,342394
9108,itsnitish22,1,0.00029,80181,23.41776,342394
9109,itsSaad,1,0.00029,80182,23.41805,342394
9110,itziklavon,1,0.00029,80183,23.41834,342394
9111,iugastefan922,1,0.00029,80184,23.41863,342394
9112,iulianionita-ai,1,0.00029,80185,23.41893,342394
9113,iustin,1,0.00029,80186,23.41922,342394
9114,iutx,1,0.00029,80187,23.41951,342394
9115,IvanJosipovic,1,0.00029,80188,23.41980,342394
9116,IvanKuchin,1,0.00029,80189,23.42009,342394
9117,ivanovpavel1983,1,0.00029,80190,23.42039,342394
9118,ivanspasov99,1,0.00029,80191,23.42068,342394
9119,iwanczuk,1,0.00029,80192,23.42097,342394
9120,iweixubin,1,0.00029,80193,23.42126,342394
9121,ixniz,1,0.00029,80194,23.42156,342394
9122,iyurev,1,0.00029,80195,23.42185,342394
9123,izelnakri,1,0.00029,80196,23.42214,342394
9124,J0WI,1,0.00029,80197,23.42243,342394
9125,j3e99,1,0.00029,80198,23.42272,342394
9126,j6s,1,0.00029,80199,23.42302,342394
9127,jack1902,1,0.00029,80200,23.42331,342394
9128,jack-ra,1,0.00029,80201,23.42360,342394
9129,jacksenechal,1,0.00029,80202,23.42389,342394
9130,jacksondb80,1,0.00029,80203,23.42418,342394
9131,jacky68147527,1,0.00029,80204,23.42448,342394
9132,jackychow,1,0.00029,80205,23.42477,342394
9133,jacobfederer,1,0.00029,80206,23.42506,342394
9134,jacoovan,1,0.00029,80207,23.42535,342394
9135,jacy450,1,0.00029,80208,23.42564,342394
9136,jadiaheno,1,0.00029,80209,23.42594,342394
9137,jaffcheng,1,0.00029,80210,23.42623,342394
9138,jaggerwang,1,0.00029,80211,23.42652,342394
9139,jagitch,1,0.00029,80212,23.42681,342394
9140,jagretti,1,0.00029,80213,23.42710,342394
9141,jaipalkomakula,1,0.00029,80214,23.42740,342394
9142,jairaju,1,0.00029,80215,23.42769,342394
9143,jajaislanina,1,0.00029,80216,23.42798,342394
9144,jaketerrito,1,0.00029,80217,23.42827,342394
9145,jakubbaron,1,0.00029,80218,23.42856,342394
9146,jakubpartyka,1,0.00029,80219,23.42886,342394
9147,jali-clarke,1,0.00029,80220,23.42915,342394
9148,jamesawebb,1,0.00029,80221,23.42944,342394
9149,JamesCHub,1,0.00029,80222,23.42973,342394
9150,JamesGuthrie,1,0.00029,80223,23.43003,342394
9151,JamesTimms,1,0.00029,80224,23.43032,342394
9152,JamesXNelson,1,0.00029,80225,23.43061,342394
9153,jamie-34254,1,0.00029,80226,23.43090,342394
9154,JamieDanielson,1,0.00029,80227,23.43119,342394
9155,janethavi,1,0.00029,80228,23.43149,342394
9156,jankalinic,1,0.00029,80229,23.43178,342394
9157,jankoprowski,1,0.00029,80230,23.43207,342394
9158,janlauber,1,0.00029,80231,23.43236,342394
9159,janLo,1,0.00029,80232,23.43265,342394
9160,janosdebugs,1,0.00029,80233,23.43295,342394
9161,JanPokorny,1,0.00029,80234,23.43324,342394
9162,jan-safranek,1,0.00029,80235,23.43353,342394
9163,janskto1,1,0.00029,80236,23.43382,342394
9164,jan-xyz,1,0.00029,80237,23.43411,342394
9165,jare19,1,0.00029,80238,23.43441,342394
9166,jaredmcqueen,1,0.00029,80239,23.43470,342394
9167,jaredstehler,1,0.00029,80240,23.43499,342394
9168,jaredweinfurtner,1,0.00029,80241,23.43528,342394
9169,jarias,1,0.00029,80242,23.43557,342394
9170,jarlva,1,0.00029,80243,23.43587,342394
9171,jarrettprosser,1,0.00029,80244,23.43616,342394
9172,jarzyna63,1,0.00029,80245,23.43645,342394
9173,jas02,1,0.00029,80246,23.43674,342394
9174,jasalgado,1,0.00029,80247,23.43703,342394
9175,jask87,1,0.00029,80248,23.43733,342394
9176,JasmineJ1230,1,0.00029,80249,23.43762,342394
9177,jason-edstrom,1,0.00029,80250,23.43791,342394
9178,JasonKeirstead,1,0.00029,80251,23.43820,342394
9179,jason-matthew,1,0.00029,80252,23.43849,342394
9180,jasonneurohr,1,0.00029,80253,23.43879,342394
9181,jason-visotrust,1,0.00029,80254,23.43908,342394
9182,jasonyic,1,0.00029,80255,23.43937,342394
9183,jastBytes,1,0.00029,80256,23.43966,342394
9184,jatin-pathangi,1,0.00029,80257,23.43996,342394
9185,javahwh,1,0.00029,80258,23.44025,342394
9186,jav-rod,1,0.00029,80259,23.44054,342394
9187,jawabuu,1,0.00029,80260,23.44083,342394
9188,Jay-Funk,1,0.00029,80261,23.44112,342394
9189,JayJay-K,1,0.00029,80262,23.44142,342394
9190,jayzhenghan,1,0.00029,80263,23.44171,342394
9191,jazeem-azeez,1,0.00029,80264,23.44200,342394
9192,jbdell,1,0.00029,80265,23.44229,342394
9193,jbeere,1,0.00029,80266,23.44258,342394
9194,jbg,1,0.00029,80267,23.44288,342394
9195,jbowen93,1,0.00029,80268,23.44317,342394
9196,jbraidju,1,0.00029,80269,23.44346,342394
9197,jbyers19,1,0.00029,80270,23.44375,342394
9198,jcadavez,1,0.00029,80271,23.44404,342394
9199,jcafarelli-chwy,1,0.00029,80272,23.44434,342394
9200,jcanseco,1,0.00029,80273,23.44463,342394
9201,jcfj,1,0.00029,80274,23.44492,342394
9202,Jchicode,1,0.00029,80275,23.44521,342394
9203,jdechicchis,1,0.00029,80276,23.44550,342394
9204,jdiglesias,1,0.00029,80277,23.44580,342394
9205,jdkramhoft,1,0.00029,80278,23.44609,342394
9206,jdreesen,1,0.00029,80279,23.44638,342394
9207,jdstrand,1,0.00029,80280,23.44667,342394
9208,jduimovich,1,0.00029,80281,23.44696,342394
9209,jeacott1,1,0.00029,80282,23.44726,342394
9210,jeanlouhallee,1,0.00029,80283,23.44755,342394
9211,jecnua,1,0.00029,80284,23.44784,342394
9212,jedisct1,1,0.00029,80285,23.44813,342394
9213,Jeeppler,1,0.00029,80286,23.44842,342394
9214,jeferson-ls-ribeiro,1,0.00029,80287,23.44872,342394
9215,jeffaryhe,1,0.00029,80288,23.44901,342394
9216,jeffery7,1,0.00029,80289,23.44930,342394
9217,jeffoverflow,1,0.00029,80290,23.44959,342394
9218,jeffreyyjp,1,0.00029,80291,23.44989,342394
9219,jeffro94,1,0.00029,80292,23.45018,342394
9220,jeffwji,1,0.00029,80293,23.45047,342394
9221,JeffXue,1,0.00029,80294,23.45076,342394
9222,jehof,1,0.00029,80295,23.45105,342394
9223,jelmer,1,0.00029,80296,23.45135,342394
9224,jemc,1,0.00029,80297,23.45164,342394
9225,JenniferMack,1,0.00029,80298,23.45193,342394
9226,jenniferpinder,1,0.00029,80299,23.45222,342394
9227,jerem0808,1,0.00029,80300,23.45251,342394
9228,jeremybaumont,1,0.00029,80301,23.45281,342394
9229,JeremyBolster,1,0.00029,80302,23.45310,342394
9230,jeremy-chua,1,0.00029,80303,23.45339,342394
9231,jeremyroy,1,0.00029,80304,23.45368,342394
9232,jerger,1,0.00029,80305,23.45397,342394
9233,JeroenBos,1,0.00029,80306,23.45427,342394
9234,jeroenherczeg,1,0.00029,80307,23.45456,342394
9235,jeroenjacobs79,1,0.00029,80308,23.45485,342394
9236,jeroenvandevelde,1,0.00029,80309,23.45514,342394
9237,jerome-ibanes,1,0.00029,80310,23.45543,342394
9238,jerome-quere,1,0.00029,80311,23.45573,342394
9239,jerry-tao,1,0.00029,80312,23.45602,342394
9240,JerusJ,1,0.00029,80313,23.45631,342394
9241,jess-belliveau,1,0.00029,80314,23.45660,342394
9242,Jesse0Michael,1,0.00029,80315,23.45689,342394
9243,Jesse-duanji,1,0.00029,80316,23.45719,342394
9244,jesselang,1,0.00029,80317,23.45748,342394
9245,Jessev6,1,0.00029,80318,23.45777,342394
9246,jevon-23,1,0.00029,80319,23.45806,342394
9247,JeyShaw,1,0.00029,80320,23.45835,342394
9248,jfb74,1,0.00029,80321,23.45865,342394
9249,jfbrennan,1,0.00029,80322,23.45894,342394
9250,jferris,1,0.00029,80323,23.45923,342394
9251,jfg956,1,0.00029,80324,23.45952,342394
9252,jfgosselin,1,0.00029,80325,23.45982,342394
9253,jfmeachum,1,0.00029,80326,23.46011,342394
9254,j-fuentes,1,0.00029,80327,23.46040,342394
9255,jgerry2002,1,0.00029,80328,23.46069,342394
9256,jgilfoil,1,0.00029,80329,23.46098,342394
9257,jgillich,1,0.00029,80330,23.46128,342394
9258,jgminer,1,0.00029,80331,23.46157,342394
9259,JGoldman110,1,0.00029,80332,23.46186,342394
9260,jgold-stripe,1,0.00029,80333,23.46215,342394
9261,jgregorcmh,1,0.00029,80334,23.46244,342394
9262,jhaumont,1,0.00029,80335,23.46274,342394
9263,jhcolville,1,0.00029,80336,23.46303,342394
9264,jhdalek55,1,0.00029,80337,23.46332,342394
9265,jherman3,1,0.00029,80338,23.46361,342394
9266,jhoenger,1,0.00029,80339,23.46390,342394
9267,jhonDoe15,1,0.00029,80340,23.46420,342394
9268,jhonsfran1165,1,0.00029,80341,23.46449,342394
9269,jhpratt,1,0.00029,80342,23.46478,342394
9270,jhrcz-ls,1,0.00029,80343,23.46507,342394
9271,jhskone,1,0.00029,80344,23.46536,342394
9272,jhuang2snap,1,0.00029,80345,23.46566,342394
9273,jhuliano,1,0.00029,80346,23.46595,342394
9274,jiachinzhao,1,0.00029,80347,23.46624,342394
9275,jiangguilong2000,1,0.00029,80348,23.46653,342394
9276,jiangqiwei,1,0.00029,80349,23.46682,342394
9277,jiangyingforSH,1,0.00029,80350,23.46712,342394
9278,jianyuan,1,0.00029,80351,23.46741,342394
9279,jiaqiluo,1,0.00029,80352,23.46770,342394
9280,jiashuChen,1,0.00029,80353,23.46799,342394
9281,jiawei666,1,0.00029,80354,23.46829,342394
9282,jiggyjigsj,1,0.00029,80355,23.46858,342394
9283,jijosg,1,0.00029,80356,23.46887,342394
9284,jim-barber-he,1,0.00029,80357,23.46916,342394
9285,Jin-2019,1,0.00029,80358,23.46945,342394
9286,jingao-msft,1,0.00029,80359,23.46975,342394
9287,jingcheng88,1,0.00029,80360,23.47004,342394
9288,JingLMalan,1,0.00029,80361,23.47033,342394
9289,jingzhao-self,1,0.00029,80362,23.47062,342394
9290,jino-mariath,1,0.00029,80363,23.47091,342394
9291,jintusebastian,1,0.00029,80364,23.47121,342394
9292,jinxuan-LY,1,0.00029,80365,23.47150,342394
9293,jiriklein,1,0.00029,80366,23.47179,342394
9294,jixox,1,0.00029,80367,23.47208,342394
9295,jizi,1,0.00029,80368,23.47237,342394
9296,jj-2020,1,0.00029,80369,23.47267,342394
9297,jjackson-s,1,0.00029,80370,23.47296,342394
9298,jjb,1,0.00029,80371,23.47325,342394
9299,jjcallis,1,0.00029,80372,23.47354,342394
9300,jjjjose,1,0.00029,80373,23.47383,342394
9301,jjoynsonerwin,1,0.00029,80374,23.47413,342394
9302,jjq-spirit,1,0.00029,80375,23.47442,342394
9303,jjschwarz,1,0.00029,80376,23.47471,342394
9304,jk5228,1,0.00029,80377,23.47500,342394
9305,jkabat,1,0.00029,80378,23.47529,342394
9306,jketcham,1,0.00029,80379,23.47559,342394
9307,jkirkham-ratehub,1,0.00029,80380,23.47588,342394
9308,jkreller,1,0.00029,80381,23.47617,342394
9309,jlee-idbydna,1,0.00029,80382,23.47646,342394
9310,jlegoff,1,0.00029,80383,23.47675,342394
9311,jlemaes,1,0.00029,80384,23.47705,342394
9312,j-manu,1,0.00029,80385,23.47734,342394
9313,jmbradshaw79,1,0.00029,80386,23.47763,342394
9314,jmcastellote,1,0.00029,80387,23.47792,342394
9315,jmcxw,1,0.00029,80388,23.47822,342394
9316,jmeza-xyz,1,0.00029,80389,23.47851,342394
9317,jmorrim3,1,0.00029,80390,23.47880,342394
9318,jmunson,1,0.00029,80391,23.47909,342394
9319,JMurph2015,1,0.00029,80392,23.47938,342394
9320,jmyoung,1,0.00029,80393,23.47968,342394
9321,jnahelou,1,0.00029,80394,23.47997,342394
9322,joakimwar,1,0.00029,80395,23.48026,342394
9323,joaoborsoi,1,0.00029,80396,23.48055,342394
9324,joaogui1,1,0.00029,80397,23.48084,342394
9325,joaopauloksn,1,0.00029,80398,23.48114,342394
9326,JoaquinJimenezGarcia,1,0.00029,80399,23.48143,342394
9327,jochemvankessel,1,0.00029,80400,23.48172,342394
9328,jochristian,1,0.00029,80401,23.48201,342394
9329,joda01,1,0.00029,80402,23.48230,342394
9330,jodhi,1,0.00029,80403,23.48260,342394
9331,joeblubaugh,1,0.00029,80404,23.48289,342394
9332,joekrill,1,0.00029,80405,23.48318,342394
9333,joelhoisko,1,0.00029,80406,23.48347,342394
9334,joell,1,0.00029,80407,23.48376,342394
9335,joelmeier,1,0.00029,80408,23.48406,342394
9336,joel-simonsson,1,0.00029,80409,23.48435,342394
9337,joepio,1,0.00029,80410,23.48464,342394
9338,joe-pll,1,0.00029,80411,23.48493,342394
9339,joeynaor,1,0.00029,80412,23.48522,342394
9340,joggeli34,1,0.00029,80413,23.48552,342394
9341,johanneskastl,1,0.00029,80414,23.48581,342394
9342,john1337,1,0.00029,80415,23.48610,342394
9343,JohnGossett,1,0.00029,80416,23.48639,342394
9344,john-jun,1,0.00029,80417,23.48668,342394
9345,johnkk84,1,0.00029,80418,23.48698,342394
9346,john-livelyvideo,1,0.00029,80419,23.48727,342394
9347,JohnMops,1,0.00029,80420,23.48756,342394
9348,JohnnyLufa,1,0.00029,80421,23.48785,342394
9349,johnnyreilly,1,0.00029,80422,23.48815,342394
9350,johnny-the-coder,1,0.00029,80423,23.48844,342394
9351,johnseekins,1,0.00029,80424,23.48873,342394
9352,johnytiago,1,0.00029,80425,23.48902,342394
9353,Johnz86,1,0.00029,80426,23.48931,342394
9354,joinvimals,1,0.00029,80427,23.48961,342394
9355,JokerQueue,1,0.00029,80428,23.48990,342394
9356,Jonas18175,1,0.00029,80429,23.49019,342394
9357,jonasnordlund,1,0.00029,80430,23.49048,342394
9358,jonathan-albrecht-ibm,1,0.00029,80431,23.49077,342394
9359,Jonathanbenilan,1,0.00029,80432,23.49107,342394
9360,jonathan-dale,1,0.00029,80433,23.49136,342394
9361,jonathang-simplex,1,0.00029,80434,23.49165,342394
9362,jonathanmdr,1,0.00029,80435,23.49194,342394
9363,jonbuckley33,1,0.00029,80436,23.49223,342394
9364,joncoelloaccess,1,0.00029,80437,23.49253,342394
9365,jondkelley,1,0.00029,80438,23.49282,342394
9366,jon-grey,1,0.00029,80439,23.49311,342394
9367,Jonomir,1,0.00029,80440,23.49340,342394
9368,jonyjalfon94,1,0.00029,80441,23.49369,342394
9369,joost14,1,0.00029,80442,23.49399,342394
9370,JoostvdB94,1,0.00029,80443,23.49428,342394
9371,jopapo,1,0.00029,80444,23.49457,342394
9372,JordanPawlett,1,0.00029,80445,23.49486,342394
9373,jordanrule,1,0.00029,80446,23.49515,342394
9374,jordan-seemplicity,1,0.00029,80447,23.49545,342394
9375,jordiprats,1,0.00029,80448,23.49574,342394
9376,jorgemarey,1,0.00029,80449,23.49603,342394
9377,jorhett,1,0.00029,80450,23.49632,342394
9378,jorisaxual,1,0.00029,80451,23.49662,342394
9379,joriskt,1,0.00029,80452,23.49691,342394
9380,jorotg,1,0.00029,80453,23.49720,342394
9381,josandstrom,1,0.00029,80454,23.49749,342394
9382,josb,1,0.00029,80455,23.49778,342394
9383,josegarridoa,1,0.00029,80456,23.49808,342394
9384,josemaia,1,0.00029,80457,23.49837,342394
9385,JosemyDuarte,1,0.00029,80458,23.49866,342394
9386,joseph-d-p,1,0.00029,80459,23.49895,342394
9387,joseph-woodward-form3,1,0.00029,80460,23.49924,342394
9388,JoseVillalta,1,0.00029,80461,23.49954,342394
9389,joshbode,1,0.00029,80462,23.49983,342394
9390,josh-endries,1,0.00029,80463,23.50012,342394
9391,joshsten,1,0.00029,80464,23.50041,342394
9392,JoshuaFox,1,0.00029,80465,23.50070,342394
9393,joshuawhite929,1,0.00029,80466,23.50100,342394
9394,joshunger,1,0.00029,80467,23.50129,342394
9395,joshwlewis,1,0.00029,80468,23.50158,342394
9396,jotacamou,1,0.00029,80469,23.50187,342394
9397,jotamartos,1,0.00029,80470,23.50216,342394
9398,jotasixto,1,0.00029,80471,23.50246,342394
9399,jotavar,1,0.00029,80472,23.50275,342394
9400,jovalle,1,0.00029,80473,23.50304,342394
9401,Jownathan,1,0.00029,80474,23.50333,342394
9402,joyrex2001,1,0.00029,80475,23.50362,342394
9403,jpcarpanezi,1,0.00029,80476,23.50392,342394
9404,jperttul,1,0.00029,80477,23.50421,342394
9405,jpfourny,1,0.00029,80478,23.50450,342394
9406,jphavoc,1,0.00029,80479,23.50479,342394
9407,jphx,1,0.00029,80480,23.50508,342394
9408,jpic,1,0.00029,80481,23.50538,342394
9409,jpikoulas,1,0.00029,80482,23.50567,342394
9410,jpshackelford,1,0.00029,80483,23.50596,342394
9411,jr200,1,0.00029,80484,23.50625,342394
9412,jradikk,1,0.00029,80485,23.50655,342394
9413,jramospagantis,1,0.00029,80486,23.50684,342394
9414,jrapoport,1,0.00029,80487,23.50713,342394
9415,jr-araujo,1,0.00029,80488,23.50742,342394
9416,jrehnen,1,0.00029,80489,23.50771,342394
9417,jrhoward,1,0.00029,80490,23.50801,342394
9418,jroes,1,0.00029,80491,23.50830,342394
9419,JsBergbau,1,0.00029,80492,23.50859,342394
9420,jsburckhardt,1,0.00029,80493,23.50888,342394
9421,JSC0DE,1,0.00029,80494,23.50917,342394
9422,jschwanz,1,0.00029,80495,23.50947,342394
9423,jschwinger233,1,0.00029,80496,23.50976,342394
9424,jsinghuy,1,0.00029,80497,23.51005,342394
9425,jsonbruce,1,0.00029,80498,23.51034,342394
9426,jspeiser,1,0.00029,80499,23.51063,342394
9427,jstaf,1,0.00029,80500,23.51093,342394
9428,jstdips,1,0.00029,80501,23.51122,342394
9429,js-timbirkett,1,0.00029,80502,23.51151,342394
9430,jsubirat,1,0.00029,80503,23.51180,342394
9431,jsvasquez,1,0.00029,80504,23.51209,342394
9432,jthunderbird,1,0.00029,80505,23.51239,342394
9433,jtnz,1,0.00029,80506,23.51268,342394
9434,jtrbs,1,0.00029,80507,23.51297,342394
9435,jtzell,1,0.00029,80508,23.51326,342394
9436,juadk,1,0.00029,80509,23.51355,342394
9437,juanluelguerre,1,0.00029,80510,23.51385,342394
9438,juanvasquezreyes,1,0.00029,80511,23.51414,342394
9439,juanyque,1,0.00029,80512,23.51443,342394
9440,juchom,1,0.00029,80513,23.51472,342394
9441,juckerf,1,0.00029,80514,23.51501,342394
9442,juergenzimmermann,1,0.00029,80515,23.51531,342394
9443,jufabeck2202,1,0.00029,80516,23.51560,342394
9444,jugglingthebits,1,0.00029,80517,23.51589,342394
9445,Jujuyeh,1,0.00029,80518,23.51618,342394
9446,jukelly,1,0.00029,80519,23.51648,342394
9447,Juliahahaha,1,0.00029,80520,23.51677,342394
9448,Julia-Melgare,1,0.00029,80521,23.51706,342394
9449,JulianBirch,1,0.00029,80522,23.51735,342394
9450,Juliandb1708,1,0.00029,80523,23.51764,342394
9451,julian-hecker,1,0.00029,80524,23.51794,342394
9452,julianogv,1,0.00029,80525,23.51823,342394
9453,juliaogris,1,0.00029,80526,23.51852,342394
9454,jumakasy,1,0.00029,80527,23.51881,342394
9455,June1991,1,0.00029,80528,23.51910,342394
9456,junjieyjj,1,0.00029,80529,23.51940,342394
9457,junly917,1,0.00029,80530,23.51969,342394
9458,jurabek,1,0.00029,80531,23.51998,342394
9459,justabaka,1,0.00029,80532,23.52027,342394
9460,justinrush,1,0.00029,80533,23.52056,342394
9461,JustUse,1,0.00029,80534,23.52086,342394
9462,justyntemme,1,0.00029,80535,23.52115,342394
9463,juur,1,0.00029,80536,23.52144,342394
9464,juwens,1,0.00029,80537,23.52173,342394
9465,juzy,1,0.00029,80538,23.52202,342394
9466,JVMartin,1,0.00029,80539,23.52232,342394
9467,jvs87,1,0.00029,80540,23.52261,342394
9468,jwalitptl,1,0.00029,80541,23.52290,342394
9469,jwdonahue,1,0.00029,80542,23.52319,342394
9470,jweschenfelder,1,0.00029,80543,23.52348,342394
9471,jwineinger,1,0.00029,80544,23.52378,342394
9472,jwlawrence,1,0.00029,80545,23.52407,342394
9473,JYlag,1,0.00029,80546,23.52436,342394
9474,Ka0o0,1,0.00029,80547,23.52465,342394
9475,ka1em,1,0.00029,80548,23.52494,342394
9476,kaaboaye,1,0.00029,80549,23.52524,342394
9477,kabnfever,1,0.00029,80550,23.52553,342394
9478,kadamanas93,1,0.00029,80551,23.52582,342394
9479,kadeatfox,1,0.00029,80552,23.52611,342394
9480,Kaezon,1,0.00029,80553,23.52641,342394
9481,kafteji,1,0.00029,80554,23.52670,342394
9482,kaganmersin,1,0.00029,80555,23.52699,342394
9483,KagurazakaNyaa,1,0.00029,80556,23.52728,342394
9484,Kahavens,1,0.00029,80557,23.52757,342394
9485,kahirokunn,1,0.00029,80558,23.52787,342394
9486,kaihil,1,0.00029,80559,23.52816,342394
9487,kaikash,1,0.00029,80560,23.52845,342394
9488,kalafut,1,0.00029,80561,23.52874,342394
9489,kallaics,1,0.00029,80562,23.52903,342394
9490,KALoftin,1,0.00029,80563,23.52933,342394
9491,Kamalesh3112,1,0.00029,80564,23.52962,342394
9492,kamalid,1,0.00029,80565,23.52991,342394
9493,kamasylvia,1,0.00029,80566,23.53020,342394
9494,kambei,1,0.00029,80567,23.53049,342394
9495,kamel1239,1,0.00029,80568,23.53079,342394
9496,kaminzo,1,0.00029,80569,23.53108,342394
9497,kang-makes,1,0.00029,80570,23.53137,342394
9498,kangtao,1,0.00029,80571,23.53166,342394
9499,kanxoramesh,1,0.00029,80572,23.53195,342394
9500,KaoruDev,1,0.00029,80573,23.53225,342394
9501,kapad,1,0.00029,80574,23.53254,342394
9502,karanalang,1,0.00029,80575,23.53283,342394
9503,karansinghneu,1,0.00029,80576,23.53312,342394
9504,karianna,1,0.00029,80577,23.53341,342394
9505,karlhjm,1,0.00029,80578,23.53371,342394
9507,karolmigo,1,0.00029,80580,23.53429,342394
9508,karpikpl,1,0.00029,80581,23.53458,342394
9509,Kartikeya99,1,0.00029,80582,23.53488,342394
9510,karuboniru,1,0.00029,80583,23.53517,342394
9511,karunasagark,1,0.00029,80584,23.53546,342394
9512,kasimon,1,0.00029,80585,23.53575,342394
9513,KatieLo,1,0.00029,80586,23.53604,342394
9514,katoquro,1,0.00029,80587,23.53634,342394
9515,Kaushal28,1,0.00029,80588,23.53663,342394
9516,KazakovDenis,1,0.00029,80589,23.53692,342394
9517,kbelosevic,1,0.00029,80590,23.53721,342394
9518,ke1satsu,1,0.00029,80591,23.53750,342394
9519,keepupon,1,0.00029,80592,23.53780,342394
9520,keifgwinn,1,0.00029,80593,23.53809,342394
9521,keir-rex,1,0.00029,80594,23.53838,342394
9522,keith0591,1,0.00029,80595,23.53867,342394
9523,KelvinVenancio,1,0.00029,80596,23.53896,342394
9524,ken-ie,1,0.00029,80597,23.53926,342394
9525,Kenme1234,1,0.00029,80598,23.53955,342394
9526,kennethjor,1,0.00029,80599,23.53984,342394
9527,kenny-chow-my,1,0.00029,80600,23.54013,342394
9528,kenny-heyi,1,0.00029,80601,23.54042,342394
9529,kenrobbins,1,0.00029,80602,23.54072,342394
9530,kenshaw,1,0.00029,80603,23.54101,342394
9531,kentnsw,1,0.00029,80604,23.54130,342394
9532,kernle32dll,1,0.00029,80605,23.54159,342394
9533,Kerrnel,1,0.00029,80606,23.54188,342394
9534,kesavkolla,1,0.00029,80607,23.54218,342394
9535,KetchupBomb,1,0.00029,80608,23.54247,342394
9536,ketronkowski,1,0.00029,80609,23.54276,342394
9537,kevholmes,1,0.00029,80610,23.54305,342394
9538,keviiin38,1,0.00029,80611,23.54334,342394
9539,KevinBdev,1,0.00029,80612,23.54364,342394
9540,kevinlul,1,0.00029,80613,23.54393,342394
9541,kevinniu666,1,0.00029,80614,23.54422,342394
9542,kevin-shelaga,1,0.00029,80615,23.54451,342394
9543,kevintatro,1,0.00029,80616,23.54481,342394
9544,kevinwubert,1,0.00029,80617,23.54510,342394
9545,kevmo314,1,0.00029,80618,23.54539,342394
9546,keweishang,1,0.00029,80619,23.54568,342394
9547,keyword1983,1,0.00029,80620,23.54597,342394
9548,kfkonrad,1,0.00029,80621,23.54627,342394
9549,KfreeZ,1,0.00029,80622,23.54656,342394
9550,khabalevskyi,1,0.00029,80623,23.54685,342394
9551,khakunin,1,0.00029,80624,23.54714,342394
9552,khaldelshiekh,1,0.00029,80625,23.54743,342394
9553,khanhtc1202,1,0.00029,80626,23.54773,342394
9554,khanjasir90,1,0.00029,80627,23.54802,342394
9555,khushbr,1,0.00029,80628,23.54831,342394
9556,ki0,1,0.00029,80629,23.54860,342394
9557,kictto,1,0.00029,80630,23.54889,342394
9558,KidA001,1,0.00029,80631,23.54919,342394
9559,kilimar,1,0.00029,80632,23.54948,342394
9560,killua202,1,0.00029,80633,23.54977,342394
9561,kimte124,1,0.00029,80634,23.55006,342394
9562,kimullaa,1,0.00029,80635,23.55035,342394
9563,kimvu3010,1,0.00029,80636,23.55065,342394
9564,kimyongyeon,1,0.00029,80637,23.55094,342394
9565,kineta-Jiang,1,0.00029,80638,23.55123,342394
9566,king3379,1,0.00029,80639,23.55152,342394
9567,kingeasternsun,1,0.00029,80640,23.55181,342394
9568,kingjan1999,1,0.00029,80641,23.55211,342394
9569,kinglong08,1,0.00029,80642,23.55240,342394
9570,kinsolee,1,0.00029,80643,23.55269,342394
9571,kioqueiroz,1,0.00029,80644,23.55298,342394
9572,kir4h,1,0.00029,80645,23.55327,342394
9573,KiranHighNote,1,0.00029,80646,23.55357,342394
9574,kirbyquerby,1,0.00029,80647,23.55386,342394
9575,kirbyzhou,1,0.00029,80648,23.55415,342394
9576,kirkanos,1,0.00029,80649,23.55444,342394
9577,kirt13,1,0.00029,80650,23.55474,342394
9578,Kirubason,1,0.00029,80651,23.55503,342394
9579,KirubelT,1,0.00029,80652,23.55532,342394
9580,kitkars,1,0.00029,80653,23.55561,342394
9581,kjagiello,1,0.00029,80654,23.55590,342394
9582,Kjir,1,0.00029,80655,23.55620,342394
9583,kjohulo,1,0.00029,80656,23.55649,342394
9584,kkurten,1,0.00029,80657,23.55678,342394
9585,klamkma,1,0.00029,80658,23.55707,342394
9586,klose4711,1,0.00029,80659,23.55736,342394
9587,kmaheswar,1,0.00029,80660,23.55766,342394
9588,kmannuz,1,0.00029,80661,23.55795,342394
9589,kmdnexusvsts,1,0.00029,80662,23.55824,342394
9590,kmhagan,1,0.00029,80663,23.55853,342394
9591,kmikko,1,0.00029,80664,23.55882,342394
9592,kmott,1,0.00029,80665,23.55912,342394
9593,k-m-y,1,0.00029,80666,23.55941,342394
9594,knapo,1,0.00029,80667,23.55970,342394
9595,knarewski,1,0.00029,80668,23.55999,342394
9596,KnechtionsCoding,1,0.00029,80669,23.56028,342394
9597,kniec,1,0.00029,80670,23.56058,342394
9598,knkarthik,1,0.00029,80671,23.56087,342394
9599,koba1t,1,0.00029,80672,23.56116,342394
9600,kobe2000,1,0.00029,80673,23.56145,342394
9601,kobejn-jb,1,0.00029,80674,23.56174,342394
9602,KoelhoSec,1,0.00029,80675,23.56204,342394
9603,Kogs,1,0.00029,80676,23.56233,342394
9604,kollachaitanyakrishna,1,0.00029,80677,23.56262,342394
9605,kolovo,1,0.00029,80678,23.56291,342394
9606,komalali,1,0.00029,80679,23.56320,342394
9607,komalkumbh,1,0.00029,80680,23.56350,342394
9608,koneko096,1,0.00029,80681,23.56379,342394
9609,Konig-Corey,1,0.00029,80682,23.56408,342394
9610,koolay,1,0.00029,80683,23.56437,342394
9611,korae29,1,0.00029,80684,23.56467,342394
9612,koralcem,1,0.00029,80685,23.56496,342394
9613,Korusuke,1,0.00029,80686,23.56525,342394
9614,kos9kus,1,0.00029,80687,23.56554,342394
9615,kosik86,1,0.00029,80688,23.56583,342394
9616,kostas-theo,1,0.00029,80689,23.56613,342394
9617,kothabindu,1,0.00029,80690,23.56642,342394
9618,KouriR,1,0.00029,80691,23.56671,342394
9619,koushyk,1,0.00029,80692,23.56700,342394
9620,kozdincer,1,0.00029,80693,23.56729,342394
9621,kpalaparthi,1,0.00029,80694,23.56759,342394
9622,kpbll,1,0.00029,80695,23.56788,342394
9623,kpbommag,1,0.00029,80696,23.56817,342394
9624,kpinarci,1,0.00029,80697,23.56846,342394
9625,kravciak,1,0.00029,80698,23.56875,342394
9626,kravvcu,1,0.00029,80699,23.56905,342394
9627,krdhruva,1,0.00029,80700,23.56934,342394
9628,krdln,1,0.00029,80701,23.56963,342394
9629,krfong916,1,0.00029,80702,23.56992,342394
9630,KrisBNelson,1,0.00029,80703,23.57021,342394
9631,krishnaarava,1,0.00029,80704,23.57051,342394
9632,krishna-birla,1,0.00029,80705,23.57080,342394
9633,krishnendudas1979,1,0.00029,80706,23.57109,342394
9634,KrisLau,1,0.00029,80707,23.57138,342394
9635,krjw-eyev,1,0.00029,80708,23.57167,342394
9636,krohila,1,0.00029,80709,23.57197,342394
9637,kromanow94,1,0.00029,80710,23.57226,342394
9638,krsaurav044,1,0.00029,80711,23.57255,342394
9639,kruegener,1,0.00029,80712,23.57284,342394
9640,k-rus,1,0.00029,80713,23.57314,342394
9641,krystan,1,0.00029,80714,23.57343,342394
9642,krystianmlynek,1,0.00029,80715,23.57372,342394
9643,kscherer,1,0.00029,80716,23.57401,342394
9644,ksdaftari,1,0.00029,80717,23.57430,342394
9645,kseckinc,1,0.00029,80718,23.57460,342394
9646,KShivendu,1,0.00029,80719,23.57489,342394
9647,kshpak,1,0.00029,80720,23.57518,342394
9648,kskem,1,0.00029,80721,23.57547,342394
9649,ksliu58,1,0.00029,80722,23.57576,342394
9650,ksmiller-dispatch,1,0.00029,80723,23.57606,342394
9651,ksooner,1,0.00029,80724,23.57635,342394
9652,k-s-t-i,1,0.00029,80725,23.57664,342394
9653,kubabialy,1,0.00029,80726,23.57693,342394
9654,kubernegit,1,0.00029,80727,23.57722,342394
9655,kukulam-allegro,1,0.00029,80728,23.57752,342394
9656,kulhadia,1,0.00029,80729,23.57781,342394
9657,kunfoo,1,0.00029,80730,23.57810,342394
9658,Kunkunprince,1,0.00029,80731,23.57839,342394
9659,kuraleb,1,0.00029,80732,23.57868,342394
9660,kurtb,1,0.00029,80733,23.57898,342394
9661,kurtostfeld,1,0.00029,80734,23.57927,342394
9662,kurtseifried,1,0.00029,80735,23.57956,342394
9663,Kusuma16,1,0.00029,80736,23.57985,342394
9664,Kuzbekov,1,0.00029,80737,23.58014,342394
9665,kuznetsovkk,1,0.00029,80738,23.58044,342394
9666,kvijay1918,1,0.00029,80739,23.58073,342394
9667,KVInventoR,1,0.00029,80740,23.58102,342394
9668,KVS85,1,0.00029,80741,23.58131,342394
9669,kwangil-ha,1,0.00029,80742,23.58160,342394
9670,kwapik,1,0.00029,80743,23.58190,342394
9671,kwencel,1,0.00029,80744,23.58219,342394
9672,kwisniewski98,1,0.00029,80745,23.58248,342394
9673,kylebrandt,1,0.00029,80746,23.58277,342394
9674,kylegibbons,1,0.00029,80747,23.58307,342394
9675,KyleSanderson,1,0.00029,80748,23.58336,342394
9676,ky-ma,1,0.00029,80749,23.58365,342394
9677,KyongSik-Yoon,1,0.00029,80750,23.58394,342394
9678,KyrieY,1,0.00029,80751,23.58423,342394
9679,Kyslik,1,0.00029,80752,23.58453,342394
9680,kzap,1,0.00029,80753,23.58482,342394
9681,kzh,1,0.00029,80754,23.58511,342394
9682,kzvonov,1,0.00029,80755,23.58540,342394
9683,l0u1sg,1,0.00029,80756,23.58569,342394
9684,lachezar,1,0.00029,80757,23.58599,342394
9685,lachieh,1,0.00029,80758,23.58628,342394
9686,lachlan-roberts,1,0.00029,80759,23.58657,342394
9687,lackofdream,1,0.00029,80760,23.58686,342394
9688,lakerhu999,1,0.00029,80761,23.58715,342394
9689,lalit774,1,0.00029,80762,23.58745,342394
9690,lallinger-arbeit,1,0.00029,80763,23.58774,342394
9691,lambchr,1,0.00029,80764,23.58803,342394
9692,lamebear,1,0.00029,80765,23.58832,342394
9693,lancehudson,1,0.00029,80766,23.58861,342394
9694,landerz123,1,0.00029,80767,23.58891,342394
9695,lantrix,1,0.00029,80768,23.58920,342394
9696,laotoutou,1,0.00029,80769,23.58949,342394
9697,laptimus,1,0.00029,80770,23.58978,342394
9698,larryliuqing,1,0.00029,80771,23.59007,342394
9699,larspaulsen,1,0.00029,80772,23.59037,342394
9700,laskdjlaskdj12,1,0.00029,80773,23.59066,342394
9701,Lastin,1,0.00029,80774,23.59095,342394
9702,latentd,1,0.00029,80775,23.59124,342394
9703,LaurensVanAcker,1,0.00029,80776,23.59153,342394
9704,Laurianti,1,0.00029,80777,23.59183,342394
9705,laurivosandi,1,0.00029,80778,23.59212,342394
9706,lavcraft,1,0.00029,80779,23.59241,342394
9707,lavrov,1,0.00029,80780,23.59270,342394
9708,LawrenceHecht,1,0.00029,80781,23.59300,342394
9709,lawschlosser,1,0.00029,80782,23.59329,342394
9710,lbarnkow,1,0.00029,80783,23.59358,342394
9711,lbischof,1,0.00029,80784,23.59387,342394
9712,lborisevich-clgx,1,0.00029,80785,23.59416,342394
9713,lc-bitsec,1,0.00029,80786,23.59446,342394
9714,lcharest-godaddy,1,0.00029,80787,23.59475,342394
9715,lchdev,1,0.00029,80788,23.59504,342394
9716,lco38,1,0.00029,80789,23.59533,342394
9717,ldb,1,0.00029,80790,23.59562,342394
9718,ldimitrov,1,0.00029,80791,23.59592,342394
9719,ldrmcml,1,0.00029,80792,23.59621,342394
9720,learc83,1,0.00029,80793,23.59650,342394
9721,learn0208,1,0.00029,80794,23.59679,342394
9722,lebonez,1,0.00029,80795,23.59708,342394
9723,lechgu,1,0.00029,80796,23.59738,342394
9724,ledergec,1,0.00029,80797,23.59767,342394
9725,lee-b,1,0.00029,80798,23.59796,342394
9726,lee-count-from-zero,1,0.00029,80799,23.59825,342394
9727,leedsjb,1,0.00029,80800,23.59854,342394
9728,leemeichin,1,0.00029,80801,23.59884,342394
9729,leemos-xx,1,0.00029,80802,23.59913,342394
9730,leeqiang,1,0.00029,80803,23.59942,342394
9731,leforthomas,1,0.00029,80804,23.59971,342394
9732,lehors,1,0.00029,80805,23.60000,342394
9733,Leidrin,1,0.00029,80806,23.60030,342394
9734,leisurelyclouds,1,0.00029,80807,23.60059,342394
9735,LeiZhang-Hunter,1,0.00029,80808,23.60088,342394
9736,LemmyHuang,1,0.00029,80809,23.60117,342394
9737,lemongarbage,1,0.00029,80810,23.60146,342394
9738,lengrongfu,1,0.00029,80811,23.60176,342394
9739,lennartjuette,1,0.00029,80812,23.60205,342394
9740,leokhachatorians,1,0.00029,80813,23.60234,342394
9741,leoll2,1,0.00029,80814,23.60263,342394
9742,leonids2005,1,0.00029,80815,23.60293,342394
9743,leonid-shevtsov,1,0.00029,80816,23.60322,342394
9744,leonstafford,1,0.00029,80817,23.60351,342394
9745,leonwiddershoven,1,0.00029,80818,23.60380,342394
9746,leonz,1,0.00029,80819,23.60409,342394
9747,leoplo,1,0.00029,80820,23.60439,342394
9748,leoskyrocker,1,0.00029,80821,23.60468,342394
9749,leroyZTE,1,0.00029,80822,23.60497,342394
9750,LetoLetoD,1,0.00029,80823,23.60526,342394
9751,letseeqiji,1,0.00029,80824,23.60555,342394
9752,leungtimothy,1,0.00029,80825,23.60585,342394
9753,levitomer,1,0.00029,80826,23.60614,342394
9754,levonet,1,0.00029,80827,23.60643,342394
9755,levya4,1,0.00029,80828,23.60672,342394
9756,lewandowskim1988,1,0.00029,80829,23.60701,342394
9757,lexin10,1,0.00029,80830,23.60731,342394
9758,lfvjimisola,1,0.00029,80831,23.60760,342394
9759,lhaussknecht,1,0.00029,80832,23.60789,342394
9760,lholland421,1,0.00029,80833,23.60818,342394
9761,li3,1,0.00029,80834,23.60847,342394
9762,liangdong1992,1,0.00029,80835,23.60877,342394
9763,liangrui1988,1,0.00029,80836,23.60906,342394
9764,lianxmfor,1,0.00029,80837,23.60935,342394
9765,libinglong,1,0.00029,80838,23.60964,342394
9766,liboz,1,0.00029,80839,23.60993,342394
9767,libratiger,1,0.00029,80840,23.61023,342394
9768,lichti81,1,0.00029,80841,23.61052,342394
9769,lichunzhu,1,0.00029,80842,23.61081,342394
9770,liger1978,1,0.00029,80843,23.61110,342394
9771,Lightn,1,0.00029,80844,23.61140,342394
9772,lijiansgit,1,0.00029,80845,23.61169,342394
9773,lijok,1,0.00029,80846,23.61198,342394
9774,liluo1990,1,0.00029,80847,23.61227,342394
9775,liminxufen,1,0.00029,80848,23.61256,342394
9776,linch0312,1,0.00029,80849,23.61286,342394
9777,linfengOu,1,0.00029,80850,23.61315,342394
9778,lingpeng0314,1,0.00029,80851,23.61344,342394
9779,linkensphere201,1,0.00029,80852,23.61373,342394
9780,linkous8,1,0.00029,80853,23.61402,342394
9781,Links2004,1,0.00029,80854,23.61432,342394
9782,linlih,1,0.00029,80855,23.61461,342394
9783,linsmalldragon,1,0.00029,80856,23.61490,342394
9784,linucksrox,1,0.00029,80857,23.61519,342394
9785,Linutux,1,0.00029,80858,23.61548,342394
9786,linuxananth1976,1,0.00029,80859,23.61578,342394
9787,linuxhatto,1,0.00029,80860,23.61607,342394
9788,linuxpham,1,0.00029,80861,23.61636,342394
9789,LionH,1,0.00029,80862,23.61665,342394
9790,lipovsek,1,0.00029,80863,23.61694,342394
9791,lirlia,1,0.00029,80864,23.61724,342394
9792,lisenet,1,0.00029,80865,23.61753,342394
9793,litewhatever,1,0.00029,80866,23.61782,342394
9794,litianxi,1,0.00029,80867,23.61811,342394
9795,LittleAaron,1,0.00029,80868,23.61840,342394
9796,liufangwai,1,0.00029,80869,23.61870,342394
9797,liushi001,1,0.00029,80870,23.61899,342394
9798,liushifa,1,0.00029,80871,23.61928,342394
9799,liutaot,1,0.00029,80872,23.61957,342394
9800,liuwenping,1,0.00029,80873,23.61986,342394
9801,liuxiang88,1,0.00029,80874,23.62016,342394
9802,LIVelasco,1,0.00029,80875,23.62045,342394
9803,lizhenhuan,1,0.00029,80876,23.62074,342394
9804,lizztheblizz,1,0.00029,80877,23.62103,342394
9805,ljmict,1,0.00029,80878,23.62133,342394
9806,ljmsc,1,0.00029,80879,23.62162,342394
9807,lkj19zpdiDDe,1,0.00029,80880,23.62191,342394
9808,lkladnit,1,0.00029,80881,23.62220,342394
9809,lknite,1,0.00029,80882,23.62249,342394
9810,lkoniecz,1,0.00029,80883,23.62279,342394
9811,llabordehpe,1,0.00029,80884,23.62308,342394
9812,LLay,1,0.00029,80885,23.62337,342394
9813,llech,1,0.00029,80886,23.62366,342394
9814,Llewellynvdm,1,0.00029,80887,23.62395,342394
9815,lmilbaum,1,0.00029,80888,23.62425,342394
9816,lmuench,1,0.00029,80889,23.62454,342394
9817,LockDownPT,1,0.00029,80890,23.62483,342394
9818,LockLi,1,0.00029,80891,23.62512,342394
9819,loeken,1,0.00029,80892,23.62541,342394
9820,logan2211,1,0.00029,80893,23.62571,342394
9821,loganknecht,1,0.00029,80894,23.62600,342394
9822,logerror,1,0.00029,80895,23.62629,342394
9823,logileifs,1,0.00029,80896,23.62658,342394
9824,lo-jason,1,0.00029,80897,23.62687,342394
9825,loligans,1,0.00029,80898,23.62717,342394
9826,loliveiracodacy,1,0.00029,80899,23.62746,342394
9827,longtian,1,0.00029,80900,23.62775,342394
9828,lonwern,1,0.00029,80901,23.62804,342394
9829,looking-for-my-magic-bean,1,0.00029,80902,23.62833,342394
9830,loomis-relativity,1,0.00029,80903,23.62863,342394
9831,Lordnibbler,1,0.00029,80904,23.62892,342394
9832,lordnynex,1,0.00029,80905,23.62921,342394
9833,lorefnon,1,0.00029,80906,23.62950,342394
9834,losinggeneration,1,0.00029,80907,23.62979,342394
9835,louis-cuny,1,0.00029,80908,23.63009,342394
9836,lovelinuxalot,1,0.00029,80909,23.63038,342394
9837,Lovepreetlavi,1,0.00029,80910,23.63067,342394
9838,loxal,1,0.00029,80911,23.63096,342394
9839,loyaxa,1,0.00029,80912,23.63126,342394
9840,loyldg,1,0.00029,80913,23.63155,342394
9841,lpapudippu,1,0.00029,80914,23.63184,342394
9842,lpashos,1,0.00029,80915,23.63213,342394
9843,lqlamTMA,1,0.00029,80916,23.63242,342394
9844,LQss11,1,0.00029,80917,23.63272,342394
9845,lrascao,1,0.00029,80918,23.63301,342394
9846,lroque2021,1,0.00029,80919,23.63330,342394
9847,lrwh,1,0.00029,80920,23.63359,342394
9848,L-Sypniewski,1,0.00029,80921,23.63388,342394
9849,ltamasi,1,0.00029,80922,23.63418,342394
9850,LtChae,1,0.00029,80923,23.63447,342394
9851,lucasbento,1,0.00029,80924,23.63476,342394
9852,lucasdc6,1,0.00029,80925,23.63505,342394
9853,lucasteligioridis,1,0.00029,80926,23.63534,342394
9854,lucazz,1,0.00029,80927,23.63564,342394
9855,Lucifergene,1,0.00029,80928,23.63593,342394
9856,lugray,1,0.00029,80929,23.63622,342394
9857,luismaqueda,1,0.00029,80930,23.63651,342394
9858,LuisPRamos,1,0.00029,80931,23.63680,342394
9859,LuisRodri21,1,0.00029,80932,23.63710,342394
9860,luk3thomas,1,0.00029,80933,23.63739,342394
9861,LukasJerabek,1,0.00029,80934,23.63768,342394
9862,lukasnalezenec,1,0.00029,80935,23.63797,342394
9863,lukasz-pyrzyk,1,0.00029,80936,23.63826,342394
9864,LukaszWasko,1,0.00029,80937,23.63856,342394
9865,lukepolo,1,0.00029,80938,23.63885,342394
9866,LunaTK,1,0.00029,80939,23.63914,342394
9867,Lunchee85,1,0.00029,80940,23.63943,342394
9868,luneo7,1,0.00029,80941,23.63972,342394
9869,lungati,1,0.00029,80942,23.64002,342394
9870,luodianhanxuan,1,0.00029,80943,23.64031,342394
9871,LuoRongLuoRong,1,0.00029,80944,23.64060,342394
9872,LupoOnGitHub,1,0.00029,80945,23.64089,342394
9873,luukkemp,1,0.00029,80946,23.64119,342394
9874,luvukr,1,0.00029,80947,23.64148,342394
9875,lvchongyi,1,0.00029,80948,23.64177,342394
9876,lxv458,1,0.00029,80949,23.64206,342394
9877,lyman9966,1,0.00029,80950,23.64235,342394
9878,lyoshakarpenko,1,0.00029,80951,23.64265,342394
9879,Lyrositor,1,0.00029,80952,23.64294,342394
9880,Lyrwon,1,0.00029,80953,23.64323,342394
9881,Lyudmila-Maltsev-8451,1,0.00029,80954,23.64352,342394
9882,lzadjsf,1,0.00029,80955,23.64381,342394
9883,lzl01,1,0.00029,80956,23.64411,342394
9884,lzm0,1,0.00029,80957,23.64440,342394
9885,lzolezzi,1,0.00029,80958,23.64469,342394
9886,LZorglub,1,0.00029,80959,23.64498,342394
9887,m1nish1208,1,0.00029,80960,23.64527,342394
9888,m1stegmann,1,0.00029,80961,23.64557,342394
9889,m1stermanager,1,0.00029,80962,23.64586,342394
9890,Ma2lik,1,0.00029,80963,23.64615,342394
9891,maartengo,1,0.00029,80964,23.64644,342394
9892,maatumo,1,0.00029,80965,23.64673,342394
9893,mab,1,0.00029,80966,23.64703,342394
9894,mac2000,1,0.00029,80967,23.64732,342394
9895,machine3,1,0.00029,80968,23.64761,342394
9896,maciejtulaza,1,0.00029,80969,23.64790,342394
9897,macsmax,1,0.00029,80970,23.64819,342394
9898,Madara789,1,0.00029,80971,23.64849,342394
9899,Madebymaurice,1,0.00029,80972,23.64878,342394
9900,madeline-brennan,1,0.00029,80973,23.64907,342394
9901,madhukiranbr,1,0.00029,80974,23.64936,342394
9902,Maellooou,1,0.00029,80975,23.64966,342394
9903,mafn,1,0.00029,80976,23.64995,342394
9904,magec,1,0.00029,80977,23.65024,342394
9905,magf,1,0.00029,80978,23.65053,342394
9906,MagicStarTrace,1,0.00029,80979,23.65082,342394
9907,magnushernegren,1,0.00029,80980,23.65112,342394
9908,MahaZaid,1,0.00029,80981,23.65141,342394
9909,maikebing,1,0.00029,80982,23.65170,342394
9910,maikeldotuk,1,0.00029,80983,23.65199,342394
9911,maikereis,1,0.00029,80984,23.65228,342394
9912,maimar-sw,1,0.00029,80985,23.65258,342394
9913,Mainintowhile,1,0.00029,80986,23.65287,342394
9914,major7x,1,0.00029,80987,23.65316,342394
9915,MajorBreakfast,1,0.00029,80988,23.65345,342394
9916,makkarpov,1,0.00029,80989,23.65374,342394
9917,makomatic,1,0.00029,80990,23.65404,342394
9918,makoto-engineer,1,0.00029,80991,23.65433,342394
9919,maliksjsu,1,0.00029,80992,23.65462,342394
9920,malikumaliku,1,0.00029,80993,23.65491,342394
9921,Malivix,1,0.00029,80994,23.65520,342394
9922,maltewhiite,1,0.00029,80995,23.65550,342394
9923,maltfield,1,0.00029,80996,23.65579,342394
9924,malvinpatrick,1,0.00029,80997,23.65608,342394
9925,mambax,1,0.00029,80998,23.65637,342394
9926,mamiu,1,0.00029,80999,23.65666,342394
9927,mamy-CS,1,0.00029,81000,23.65696,342394
9928,mandelsoft,1,0.00029,81001,23.65725,342394
9929,manderson23,1,0.00029,81002,23.65754,342394
9930,ManishOffi,1,0.00029,81003,23.65783,342394
9931,manjukashyap,1,0.00029,81004,23.65812,342394
9932,MannyPamintuanAtCare,1,0.00029,81005,23.65842,342394
9933,manu0996,1,0.00029,81006,23.65871,342394
9934,ManuelMueller1st,1,0.00029,81007,23.65900,342394
9935,manuelnp,1,0.00029,81008,23.65929,342394
9936,manuelottlik,1,0.00029,81009,23.65959,342394
9937,manusant,1,0.00029,81010,23.65988,342394
9938,ManveerBhullar,1,0.00029,81011,23.66017,342394
9939,manvik4u,1,0.00029,81012,23.66046,342394
9940,manzato,1,0.00029,81013,23.66075,342394
9941,maokomioko,1,0.00029,81014,23.66105,342394
9942,maomyu,1,0.00029,81015,23.66134,342394
9943,maour,1,0.00029,81016,23.66163,342394
9944,mapadhi,1,0.00029,81017,23.66192,342394
9945,maple5233,1,0.00029,81018,23.66221,342394
9946,marcaudefroy,1,0.00029,81019,23.66251,342394
9947,marcelloromani,1,0.00029,81020,23.66280,342394
9948,marceloboeira,1,0.00029,81021,23.66309,342394
9949,marcelohpf,1,0.00029,81022,23.66338,342394
9950,marcindulak,1,0.00029,81023,23.66367,342394
9951,marco-lancini,1,0.00029,81024,23.66397,342394
9952,marco-m-pix4d,1,0.00029,81025,23.66426,342394
9953,marcorichetta,1,0.00029,81026,23.66455,342394
9954,Marco-Zheng,1,0.00029,81027,23.66484,342394
9955,marcphilipp,1,0.00029,81028,23.66513,342394
9956,marct83,1,0.00029,81029,23.66543,342394
9957,marcusjsford,1,0.00029,81030,23.66572,342394
9958,marekp0,1,0.00029,81031,23.66601,342394
9959,mareq,1,0.00029,81032,23.66630,342394
9960,margocrawf,1,0.00029,81033,23.66659,342394
9961,MariaPaypoint,1,0.00029,81034,23.66689,342394
9962,Mariappan,1,0.00029,81035,23.66718,342394
9963,marier-nico,1,0.00029,81036,23.66747,342394
9964,Mario-F,1,0.00029,81037,23.66776,342394
9965,mariomerco,1,0.00029,81038,23.66805,342394
9966,marjorienorm,1,0.00029,81039,23.66835,342394
9967,markayre,1,0.00029,81040,23.66864,342394
9968,mark-dropbear,1,0.00029,81041,23.66893,342394
9969,markrendle,1,0.00029,81042,23.66922,342394
9970,Marks-Ed,1,0.00029,81043,23.66952,342394
9971,markshawtoronto,1,0.00029,81044,23.66981,342394
9972,markusl,1,0.00029,81045,23.67010,342394
9973,markussiebert,1,0.00029,81046,23.67039,342394
9974,markvdlaan93,1,0.00029,81047,23.67068,342394
9975,MarouaneTn,1,0.00029,81048,23.67098,342394
9976,marqdouj,1,0.00029,81049,23.67127,342394
9977,MartijnBNG,1,0.00029,81050,23.67156,342394
9978,martin-bucinskas,1,0.00029,81051,23.67185,342394
9979,martingaleh,1,0.00029,81052,23.67214,342394
9980,Martin-Hogge,1,0.00029,81053,23.67244,342394
9981,Martin-Luther,1,0.00029,81054,23.67273,342394
9982,martinohansen,1,0.00029,81055,23.67302,342394
9983,martinsmatthews,1,0.00029,81056,23.67331,342394
9984,martin-sucha,1,0.00029,81057,23.67360,342394
9985,martintreurnicht,1,0.00029,81058,23.67390,342394
9986,marvinpan8,1,0.00029,81059,23.67419,342394
9987,marwaelayyadi,1,0.00029,81060,23.67448,342394
9988,maschind,1,0.00029,81061,23.67477,342394
9989,mason-liu,1,0.00029,81062,23.67506,342394
9990,MassimoC,1,0.00029,81063,23.67536,342394
9991,massood,1,0.00029,81064,23.67565,342394
9992,MasterLover,1,0.00029,81065,23.67594,342394
9993,maszczyn,1,0.00029,81066,23.67623,342394
9994,mateuszjenek,1,0.00029,81067,23.67652,342394
9995,mateuszstompor,1,0.00029,81068,23.67682,342394
9996,matheuspatury,1,0.00029,81069,23.67711,342394
9997,mathiasslawik,1,0.00029,81070,23.67740,342394
9998,mathisve,1,0.00029,81071,23.67769,342394
9999,matihost,1,0.00029,81072,23.67799,342394
10000,matmicro,1,0.00029,81073,23.67828,342394
10001,mator,1,0.00029,81074,23.67857,342394
10002,mattchrist,1,0.00029,81075,23.67886,342394
10003,mattcobb,1,0.00029,81076,23.67915,342394
10004,matteosilv,1,0.00029,81077,23.67945,342394
10005,MattFame,1,0.00029,81078,23.67974,342394
10006,matthewmrichter,1,0.00029,81079,23.68003,342394
10007,MatthewScholefield,1,0.00029,81080,23.68032,342394
10008,MatthiasKuehneEllerhold,1,0.00029,81081,23.68061,342394
10009,MatthiasWinzeler,1,0.00029,81082,23.68091,342394
10010,MattiasAng,1,0.00029,81083,23.68120,342394
10011,mattisonchao,1,0.00029,81084,23.68149,342394
10012,mattjanson,1,0.00029,81085,23.68178,342394
10013,mattkenn4545,1,0.00029,81086,23.68207,342394
10014,mattmodene,1,0.00029,81087,23.68237,342394
10015,mattoz0,1,0.00029,81088,23.68266,342394
10016,matt-woodruff-f3,1,0.00029,81089,23.68295,342394
10017,MatviyivR,1,0.00029,81090,23.68324,342394
10018,maugsbur,1,0.00029,81091,23.68353,342394
10019,maulikusdad,1,0.00029,81092,23.68383,342394
10020,maurerbot,1,0.00029,81093,23.68412,342394
10021,mautematico,1,0.00029,81094,23.68441,342394
10022,mawen741,1,0.00029,81095,23.68470,342394
10023,max0ne,1,0.00029,81096,23.68499,342394
10024,maxaggedon,1,0.00029,81097,23.68529,342394
10025,maxarndt,1,0.00029,81098,23.68558,342394
10026,maxcaresywwforever,1,0.00029,81099,23.68587,342394
10027,maxdml,1,0.00029,81100,23.68616,342394
10028,maxekman,1,0.00029,81101,23.68645,342394
10029,MaxiHafer,1,0.00029,81102,23.68675,342394
10030,maxlemieux,1,0.00029,81103,23.68704,342394
10031,maxlevinps,1,0.00029,81104,23.68733,342394
10032,maxshuang,1,0.00029,81105,23.68762,342394
10033,maxvt-tonal,1,0.00029,81106,23.68792,342394
10034,MayeulC,1,0.00029,81107,23.68821,342394
10035,maysamyabandeh,1,0.00029,81108,23.68850,342394
10036,MayukhSobo,1,0.00029,81109,23.68879,342394
10037,mayzyo,1,0.00029,81110,23.68908,342394
10038,mazele,1,0.00029,81111,23.68938,342394
10039,mbateman-vz,1,0.00029,81112,23.68967,342394
10040,MBcom,1,0.00029,81113,23.68996,342394
10041,mbfr,1,0.00029,81114,23.69025,342394
10042,mblasi,1,0.00029,81115,23.69054,342394
10043,mb-qco,1,0.00029,81116,23.69084,342394
10044,mbyio,1,0.00029,81117,23.69113,342394
10045,mcammisa78,1,0.00029,81118,23.69142,342394
10046,mcatany,1,0.00029,81119,23.69171,342394
10047,mcbanderson,1,0.00029,81120,23.69200,342394
10048,mcc138,1,0.00029,81121,23.69230,342394
10049,mcgitty,1,0.00029,81122,23.69259,342394
10050,mchtech,1,0.00029,81123,23.69288,342394
10051,mchudinov,1,0.00029,81124,23.69317,342394
10052,mclouds2020,1,0.00029,81125,23.69346,342394
10053,mcolladoio,1,0.00029,81126,23.69376,342394
10054,mcr,1,0.00029,81127,23.69405,342394
10055,McSoda,1,0.00029,81128,23.69434,342394
10056,mcullenEST,1,0.00029,81129,23.69463,342394
10057,mdcrawford,1,0.00029,81130,23.69492,342394
10058,mddeff,1,0.00029,81131,23.69522,342394
10059,mdg215199,1,0.00029,81132,23.69551,342394
10060,mecmus,1,0.00029,81133,23.69580,342394
10061,mecseid,1,0.00029,81134,23.69609,342394
10062,mederel,1,0.00029,81135,23.69638,342394
10063,mEDI-S,1,0.00029,81136,23.69668,342394
10064,medzin,1,0.00029,81137,23.69697,342394
10065,megadrifter,1,0.00029,81138,23.69726,342394
10066,Megan96,1,0.00029,81139,23.69755,342394
10067,meganlyntalley,1,0.00029,81140,23.69785,342394
10068,mehdiMj-ir,1,0.00029,81141,23.69814,342394
10069,mehemken,1,0.00029,81142,23.69843,342394
10070,mehmetmalli,1,0.00029,81143,23.69872,342394
10071,mehrdadpfg,1,0.00029,81144,23.69901,342394
10072,mehrdadsilver,1,0.00029,81145,23.69931,342394
10073,Mei-pris,1,0.00029,81146,23.69960,342394
10074,meis4h,1,0.00029,81147,23.69989,342394
10075,melden19,1,0.00029,81148,23.70018,342394
10076,melissachang,1,0.00029,81149,23.70047,342394
10077,melissaklein24,1,0.00029,81150,23.70077,342394
10078,meln5674,1,0.00029,81151,23.70106,342394
10079,MeMineToMe,1,0.00029,81152,23.70135,342394
10080,menghan18,1,0.00029,81153,23.70164,342394
10081,mengxiangyue,1,0.00029,81154,23.70193,342394
10082,mengxin9014,1,0.00029,81155,23.70223,342394
10083,meokz,1,0.00029,81156,23.70252,342394
10084,mephmanx,1,0.00029,81157,23.70281,342394
10085,meredrica,1,0.00029,81158,23.70310,342394
10086,metacyclic,1,0.00029,81159,23.70339,342394
10087,metadataengine,1,0.00029,81160,23.70369,342394
10088,MetalRex101,1,0.00029,81161,23.70398,342394
10089,metroshica,1,0.00029,81162,23.70427,342394
10090,mfridman,1,0.00029,81163,23.70456,342394
10091,mfvanek,1,0.00029,81164,23.70485,342394
10092,mfwarren,1,0.00029,81165,23.70515,342394
10093,mgazz,1,0.00029,81166,23.70544,342394
10094,MGlants,1,0.00029,81167,23.70573,342394
10095,mgorny,1,0.00029,81168,23.70602,342394
10096,m-guesnon-pvotal,1,0.00029,81169,23.70631,342394
10097,mgutierrez98,1,0.00029,81170,23.70661,342394
10098,mgzam,1,0.00029,81171,23.70690,342394
10099,mhash17,1,0.00029,81172,23.70719,342394
10100,mhill-holoplot,1,0.00029,81173,23.70748,342394
10101,mhio,1,0.00029,81174,23.70778,342394
10102,mhite,1,0.00029,81175,23.70807,342394
10103,mhkarimi1383,1,0.00029,81176,23.70836,342394
10104,miaoshixuan,1,0.00029,81177,23.70865,342394
10105,mic4ael,1,0.00029,81178,23.70894,342394
10106,michael-careplanner,1,0.00029,81179,23.70924,342394
10107,michael-db,1,0.00029,81180,23.70953,342394
10108,michaeldotmike,1,0.00029,81181,23.70982,342394
10109,michaelfavia,1,0.00029,81182,23.71011,342394
10110,michaelfortunato,1,0.00029,81183,23.71040,342394
10111,MichaelHindley,1,0.00029,81184,23.71070,342394
10112,michaelmwangi,1,0.00029,81185,23.71099,342394
10113,michelsampil,1,0.00029,81186,23.71128,342394
10114,mickelsonmichael,1,0.00029,81187,23.71157,342394
10115,mickeypash,1,0.00029,81188,23.71186,342394
10116,mick-feller,1,0.00029,81189,23.71216,342394
10117,micmarti85,1,0.00029,81190,23.71245,342394
10118,micw,1,0.00029,81191,23.71274,342394
10119,midannii,1,0.00029,81192,23.71303,342394
10120,midhun-mohan,1,0.00029,81193,23.71332,342394
10121,mifrost,1,0.00029,81194,23.71362,342394
10122,Miguelixxx,1,0.00029,81195,23.71391,342394
10123,miguepintor,1,0.00029,81196,23.71420,342394
10124,mihalycsokas,1,0.00029,81197,23.71449,342394
10125,mihele95,1,0.00029,81198,23.71478,342394
10126,mihica123,1,0.00029,81199,23.71508,342394
10127,mikart143,1,0.00029,81200,23.71537,342394
10128,MikeC-Sysdig,1,0.00029,81201,23.71566,342394
10129,MikeGoltsov,1,0.00029,81202,23.71595,342394
10130,mikegpl,1,0.00029,81203,23.71625,342394
10131,mikeinton,1,0.00029,81204,23.71654,342394
10132,mikelaspina,1,0.00029,81205,23.71683,342394
10133,mikemorris,1,0.00029,81206,23.71712,342394
10134,MikePapinski,1,0.00029,81207,23.71741,342394
10135,mikeparker,1,0.00029,81208,23.71771,342394
10136,mikestef9,1,0.00029,81209,23.71800,342394
10137,mikeykoelbl,1,0.00029,81210,23.71829,342394
10138,mikolajprzybysz,1,0.00029,81211,23.71858,342394
10139,milieu,1,0.00029,81212,23.71887,342394
10140,millermatt,1,0.00029,81213,23.71917,342394
10141,milosmns,1,0.00029,81214,23.71946,342394
10142,milpog,1,0.00029,81215,23.71975,342394
10143,Miltonjacomini,1,0.00029,81216,23.72004,342394
10144,mimatache,1,0.00029,81217,23.72033,342394
10145,mindcrime,1,0.00029,81218,23.72063,342394
10146,minejzy,1,0.00029,81219,23.72092,342394
10147,mingaliu,1,0.00029,81220,23.72121,342394
10148,minicloudsky,1,0.00029,81221,23.72150,342394
10149,minight,1,0.00029,81222,23.72179,342394
10150,minimonsters,1,0.00029,81223,23.72209,342394
10151,mionskowski-form3,1,0.00029,81224,23.72238,342394
10152,MioOgbeni,1,0.00029,81225,23.72267,342394
10153,mirekphd,1,0.00029,81226,23.72296,342394
10154,mirocody,1,0.00029,81227,23.72325,342394
10155,miroslav-beranic,1,0.00029,81228,23.72355,342394
10156,mirskiy,1,0.00029,81229,23.72384,342394
10157,misberner,1,0.00029,81230,23.72413,342394
10158,missthesky,1,0.00029,81231,23.72442,342394
10159,Missxiaoguo,1,0.00029,81232,23.72471,342394
10160,mitch-mckenzie,1,0.00029,81233,23.72501,342394
10161,mitchsw,1,0.00029,81234,23.72530,342394
10162,mitesh-devops,1,0.00029,81235,23.72559,342394
10163,miyucy,1,0.00029,81236,23.72588,342394
10164,mjedwabn,1,0.00029,81237,23.72618,342394
10165,mjf9999,1,0.00029,81238,23.72647,342394
10166,mjnagel,1,0.00029,81239,23.72676,342394
10167,mjwaxios,1,0.00029,81240,23.72705,342394
10168,MKadaner,1,0.00029,81241,23.72734,342394
10169,mkaiserincomm,1,0.00029,81242,23.72764,342394
10170,mkellermeier,1,0.00029,81243,23.72793,342394
10171,mKeRix,1,0.00029,81244,23.72822,342394
10172,mkopinsky,1,0.00029,81245,23.72851,342394
10173,mkozal,1,0.00029,81246,23.72880,342394
10174,mkroitor2,1,0.00029,81247,23.72910,342394
10175,mkrull,1,0.00029,81248,23.72939,342394
10176,mkuf,1,0.00029,81249,23.72968,342394
10177,mkuthan,1,0.00029,81250,23.72997,342394
10178,ml-,1,0.00029,81251,23.73026,342394
10179,mladenkralev,1,0.00029,81252,23.73056,342394
10180,mladlow,1,0.00029,81253,23.73085,342394
10181,mleray24,1,0.00029,81254,23.73114,342394
10182,mlkmhd,1,0.00029,81255,23.73143,342394
10183,mlnj,1,0.00029,81256,23.73172,342394
10184,mlschindler,1,0.00029,81257,23.73202,342394
10185,mmiranda,1,0.00029,81258,23.73231,342394
10186,mmizutani,1,0.00029,81259,23.73260,342394
10187,mmoron,1,0.00029,81260,23.73289,342394
10188,mnacharov,1,0.00029,81261,23.73318,342394
10189,mnoskoski,1,0.00029,81262,23.73348,342394
10190,mnp,1,0.00029,81263,23.73377,342394
10191,moabukar,1,0.00029,81264,23.73406,342394
10192,moandersson,1,0.00029,81265,23.73435,342394
10193,modalkonform,1,0.00029,81266,23.73464,342394
10194,modulec,1,0.00029,81267,23.73494,342394
10195,moenzuel,1,0.00029,81268,23.73523,342394
10196,Moglum,1,0.00029,81269,23.73552,342394
10197,mohamedA007,1,0.00029,81270,23.73581,342394
10198,mohammadasim,1,0.00029,81271,23.73611,342394
10199,mohannmurthy,1,0.00029,81272,23.73640,342394
10200,mohit94614,1,0.00029,81273,23.73669,342394
10201,Mohitj252,1,0.00029,81274,23.73698,342394
10202,Mohjive,1,0.00029,81275,23.73727,342394
10203,monergeim,1,0.00029,81276,23.73757,342394
10204,monojit18,1,0.00029,81277,23.73786,342394
10205,Monster-Zhu,1,0.00029,81278,23.73815,342394
10206,moonman81,1,0.00029,81279,23.73844,342394
10207,mooyoul,1,0.00029,81280,23.73873,342394
10208,morganmspencer,1,0.00029,81281,23.73903,342394
10209,mosaicwang,1,0.00029,81282,23.73932,342394
10210,mosajjal,1,0.00029,81283,23.73961,342394
10211,Moscagus,1,0.00029,81284,23.73990,342394
10212,moshebeeri,1,0.00029,81285,23.74019,342394
10213,moshewe,1,0.00029,81286,23.74049,342394
10214,MostafaNegim,1,0.00029,81287,23.74078,342394
10215,mouchar,1,0.00029,81288,23.74107,342394
10216,moussdia,1,0.00029,81289,23.74136,342394
10217,moz2nci,1,0.00029,81290,23.74165,342394
10218,mpenick,1,0.00029,81291,23.74195,342394
10219,mpmdtdev,1,0.00029,81292,23.74224,342394
10220,mpradeep23,1,0.00029,81293,23.74253,342394
10221,mprimi,1,0.00029,81294,23.74282,342394
10222,mprokopov,1,0.00029,81295,23.74311,342394
10223,mr1name,1,0.00029,81296,23.74341,342394
10224,mraghu4,1,0.00029,81297,23.74370,342394
10225,mrangjunboon2017s,1,0.00029,81298,23.74399,342394
10226,MrBlenny,1,0.00029,81299,23.74428,342394
10227,MrCoderYu,1,0.00029,81300,23.74457,342394
10228,MrDeej,1,0.00029,81301,23.74487,342394
10229,mrethers,1,0.00029,81302,23.74516,342394
10230,mrgleeco,1,0.00029,81303,23.74545,342394
10231,mrhydejc,1,0.00029,81304,23.74574,342394
10232,mrkeyiano,1,0.00029,81305,23.74604,342394
10233,Mrluobo,1,0.00029,81306,23.74633,342394
10234,mr-ma,1,0.00029,81307,23.74662,342394
10235,mrmartan,1,0.00029,81308,23.74691,342394
10236,mrnetops,1,0.00029,81309,23.74720,342394
10237,mroussel,1,0.00029,81310,23.74750,342394
10238,MrSuperKevin,1,0.00029,81311,23.74779,342394
10239,mrvisser,1,0.00029,81312,23.74808,342394
10240,MrWormHole,1,0.00029,81313,23.74837,342394
10241,mrzor,1,0.00029,81314,23.74866,342394
10242,msa48,1,0.00029,81315,23.74896,342394
10243,msakall1,1,0.00029,81316,23.74925,342394
10244,ms-choudhary,1,0.00029,81317,23.74954,342394
10245,mshilamk8s,1,0.00029,81318,23.74983,342394
10246,msjingli,1,0.00029,81319,23.75012,342394
10247,msjo66,1,0.00029,81320,23.75042,342394
10248,msmith93,1,0.00029,81321,23.75071,342394
10249,mstergianis,1,0.00029,81322,23.75100,342394
10250,mszlgr,1,0.00029,81323,23.75129,342394
10251,Mtan6666666,1,0.00029,81324,23.75158,342394
10252,mtavaresmedeiros,1,0.00029,81325,23.75188,342394
10253,mtg06001,1,0.00029,81326,23.75217,342394
10254,mttkay,1,0.00029,81327,23.75246,342394
10255,Muh812,1,0.00029,81328,23.75275,342394
10256,muhammadbilal20130,1,0.00029,81329,23.75304,342394
10257,muhammadmohie,1,0.00029,81330,23.75334,342394
10258,MuhammadMunir12,1,0.00029,81331,23.75363,342394
10259,MuhammadNaeemAkhtar,1,0.00029,81332,23.75392,342394
10260,muhanator,1,0.00029,81333,23.75421,342394
10261,mulawam,1,0.00029,81334,23.75451,342394
10262,Mulkave,1,0.00029,81335,23.75480,342394
10263,muradhajiyev,1,0.00029,81336,23.75509,342394
10264,muraliedupuganti,1,0.00029,81337,23.75538,342394
10265,murech,1,0.00029,81338,23.75567,342394
10266,murindwaz,1,0.00029,81339,23.75597,342394
10267,murrellrr,1,0.00029,81340,23.75626,342394
10268,MusaddikAccuKnox,1,0.00029,81341,23.75655,342394
10269,mustafa-guler,1,0.00029,81342,23.75684,342394
10270,MustafaHaddara,1,0.00029,81343,23.75713,342394
10271,mvgmb,1,0.00029,81344,23.75743,342394
10272,mvynnych,1,0.00029,81345,23.75772,342394
10273,mway-niels,1,0.00029,81346,23.75801,342394
10274,mwz,1,0.00029,81347,23.75830,342394
10275,mxmorin,1,0.00029,81348,23.75859,342394
10276,mxm-tr,1,0.00029,81349,23.75889,342394
10277,MxNxPx,1,0.00029,81350,23.75918,342394
10278,mycoditcodihub,1,0.00029,81351,23.75947,342394
10279,myf5,1,0.00029,81352,23.75976,342394
10280,mykytaDrapatyi,1,0.00029,81353,23.76005,342394
10281,mylokin,1,0.00029,81354,23.76035,342394
10282,mymarche,1,0.00029,81355,23.76064,342394
10283,mypractice96,1,0.00029,81356,23.76093,342394
10284,mysteriouspants,1,0.00029,81357,23.76122,342394
10285,MysticalMount,1,0.00029,81358,23.76151,342394
10286,mythsman,1,0.00029,81359,23.76181,342394
10287,mzjp2,1,0.00029,81360,23.76210,342394
10288,n0vad3v,1,0.00029,81361,23.76239,342394
10289,n1ckdm,1,0.00029,81362,23.76268,342394
10290,n1hility,1,0.00029,81363,23.76297,342394
10291,naaly17,1,0.00029,81364,23.76327,342394
10292,nabiladoui,1,0.00029,81365,23.76356,342394
10293,nabilblk,1,0.00029,81366,23.76385,342394
10294,nabulsi,1,0.00029,81367,23.76414,342394
10295,nachogoca,1,0.00029,81368,23.76444,342394
10296,nachtschatt3n,1,0.00029,81369,23.76473,342394
10297,nadavtoldo,1,0.00029,81370,23.76502,342394
10298,nadenf,1,0.00029,81371,23.76531,342394
10299,nadworny,1,0.00029,81372,23.76560,342394
10300,nags28,1,0.00029,81373,23.76590,342394
10301,NahisWayard,1,0.00029,81374,23.76619,342394
10302,nahum-litvin-hs,1,0.00029,81375,23.76648,342394
10303,naimo84,1,0.00029,81376,23.76677,342394
10304,NaincyKumariKnoldus,1,0.00029,81377,23.76706,342394
10305,nairb774,1,0.00029,81378,23.76736,342394
10306,nakarinh14,1,0.00029,81379,23.76765,342394
10307,nakshatra-maheshwari,1,0.00029,81380,23.76794,342394
10308,nallagondu,1,0.00029,81381,23.76823,342394
10309,namaiiee2222,1,0.00029,81382,23.76852,342394
10310,namgonkim,1,0.00029,81383,23.76882,342394
10311,nancliu,1,0.00029,81384,23.76911,342394
10312,nandakumar-sre,1,0.00029,81385,23.76940,342394
10313,NandoTheessen,1,0.00029,81386,23.76969,342394
10314,nandu1508,1,0.00029,81387,23.76998,342394
10315,nandy007,1,0.00029,81388,23.77028,342394
10316,nange-Blog,1,0.00029,81389,23.77057,342394
10317,NaNi-Z,1,0.00029,81390,23.77086,342394
10318,naormatania,1,0.00029,81391,23.77115,342394
10319,narenderramireddy,1,0.00029,81392,23.77144,342394
10320,NarenGV,1,0.00029,81393,23.77174,342394
10321,NasAmin,1,0.00029,81394,23.77203,342394
10322,nashtsai,1,0.00029,81395,23.77232,342394
10323,nasonovandrey,1,0.00029,81396,23.77261,342394
10324,nasuku,1,0.00029,81397,23.77290,342394
10325,natarajinnavoto,1,0.00029,81398,23.77320,342394
10326,natejgardner,1,0.00029,81399,23.77349,342394
10327,nathana1,1,0.00029,81400,23.77378,342394
10328,nathanael-h,1,0.00029,81401,23.77407,342394
10329,nathanielop,1,0.00029,81402,23.77437,342394
10330,nathanweeks,1,0.00029,81403,23.77466,342394
10331,nathanwong91,1,0.00029,81404,23.77495,342394
10332,natherz97,1,0.00029,81405,23.77524,342394
10333,naveenb29,1,0.00029,81406,23.77553,342394
10334,naveenc,1,0.00029,81407,23.77583,342394
10335,naveen-marthala,1,0.00029,81408,23.77612,342394
10336,NavinPro,1,0.00029,81409,23.77641,342394
10337,navnitDevOps,1,0.00029,81410,23.77670,342394
10338,navry,1,0.00029,81411,23.77699,342394
10339,nax20210524,1,0.00029,81412,23.77729,342394
10340,Nayan155,1,0.00029,81413,23.77758,342394
10341,nbari,1,0.00029,81414,23.77787,342394
10342,nbon12,1,0.00029,81415,23.77816,342394
10343,ncattuong,1,0.00029,81416,23.77845,342394
10344,ncjones,1,0.00029,81417,23.77875,342394
10345,ndimitry,1,0.00029,81418,23.77904,342394
10346,nea1,1,0.00029,81419,23.77933,342394
10347,nearbyfly,1,0.00029,81420,23.77962,342394
10348,necipakca,1,0.00029,81421,23.77991,342394
10349,needleshaped,1,0.00029,81422,23.78021,342394
10350,neerjol,1,0.00029,81423,23.78050,342394
10351,NeesonD,1,0.00029,81424,23.78079,342394
10352,neetika-Sri,1,0.00029,81425,23.78108,342394
10353,nehaldattani,1,0.00029,81426,23.78137,342394
10354,neiba,1,0.00029,81427,23.78167,342394
10355,neil-re,1,0.00029,81428,23.78196,342394
10356,nekufa,1,0.00029,81429,23.78225,342394
10357,Nelkir,1,0.00029,81430,23.78254,342394
10358,nelson3219,1,0.00029,81431,23.78283,342394
10359,nelsonomuto,1,0.00029,81432,23.78313,342394
10360,nelzkiddom,1,0.00029,81433,23.78342,342394
10361,Neo2308,1,0.00029,81434,23.78371,342394
10362,neo502721,1,0.00029,81435,23.78400,342394
10363,neovatar,1,0.00029,81436,23.78430,342394
10364,NeoyeElf,1,0.00029,81437,23.78459,342394
10365,Net301,1,0.00029,81438,23.78488,342394
10366,netguino,1,0.00029,81439,23.78517,342394
10367,netlox-io,1,0.00029,81440,23.78546,342394
10368,netwrk197,1,0.00029,81441,23.78576,342394
10369,Neustradamus,1,0.00029,81442,23.78605,342394
10370,neutronscott,1,0.00029,81443,23.78634,342394
10371,nexustar,1,0.00029,81444,23.78663,342394
10372,Nezteb,1,0.00029,81445,23.78692,342394
10373,nflux-pyang,1,0.00029,81446,23.78722,342394
10374,nfuden,1,0.00029,81447,23.78751,342394
10375,ngc104,1,0.00029,81448,23.78780,342394
10376,ngoyal16,1,0.00029,81449,23.78809,342394
10377,ngryman,1,0.00029,81450,23.78838,342394
10378,NguyenKyThinh94,1,0.00029,81451,23.78868,342394
10379,nhartner,1,0.00029,81452,23.78897,342394
10380,n-hebert,1,0.00029,81453,23.78926,342394
10381,nhoughto,1,0.00029,81454,23.78955,342394
10382,nhynes,1,0.00029,81455,23.78984,342394
10383,nibbleshift,1,0.00029,81456,23.79014,342394
10384,NiccoloFei,1,0.00029,81457,23.79043,342394
10385,nicholasmhughes,1,0.00029,81458,23.79072,342394
10386,nickcampbell18,1,0.00029,81459,23.79101,342394
10387,nickdanil,1,0.00029,81460,23.79130,342394
10388,nickezekias,1,0.00029,81461,23.79160,342394
10389,nickjj,1,0.00029,81462,23.79189,342394
10390,nickperkins,1,0.00029,81463,23.79218,342394
10391,nickwhitt,1,0.00029,81464,23.79247,342394
10392,nicolasderycke,1,0.00029,81465,23.79277,342394
10393,nicolas-g,1,0.00029,81466,23.79306,342394
10394,nicolashmln,1,0.00029,81467,23.79335,342394
10395,nidomoko,1,0.00029,81468,23.79364,342394
10396,NielsUll,1,0.00029,81469,23.79393,342394
10397,night-gold,1,0.00029,81470,23.79423,342394
10398,nightmareze1,1,0.00029,81471,23.79452,342394
10399,Nighttraveler,1,0.00029,81472,23.79481,342394
10400,nikitamikhaylov,1,0.00029,81473,23.79510,342394
10401,nikitka,1,0.00029,81474,23.79539,342394
10402,niklasweimann,1,0.00029,81475,23.79569,342394
10403,niko-achilles,1,0.00029,81476,23.79598,342394
10404,nikonovak,1,0.00029,81477,23.79627,342394
10405,nikunjmasrani,1,0.00029,81478,23.79656,342394
10406,nilsvond,1,0.00029,81479,23.79685,342394
10407,nimaft,1,0.00029,81480,23.79715,342394
10408,Nindaleth,1,0.00029,81481,23.79744,342394
10409,ninhpham0902,1,0.00029,81482,23.79773,342394
10410,ninjaslothx,1,0.00029,81483,23.79802,342394
10411,ninuxio,1,0.00029,81484,23.79831,342394
10412,niontive,1,0.00029,81485,23.79861,342394
10413,nipr-jdoenges,1,0.00029,81486,23.79890,342394
10414,nirmalaagash,1,0.00029,81487,23.79919,342394
10415,nirroz93,1,0.00029,81488,23.79948,342394
10416,nirui,1,0.00029,81489,23.79977,342394
10417,nisainan,1,0.00029,81490,23.80007,342394
10418,nishanth-pinnapareddy,1,0.00029,81491,23.80036,342394
10419,nishantmalviya,1,0.00029,81492,23.80065,342394
10420,nishantpatel11,1,0.00029,81493,23.80094,342394
10421,Nitesh-vaidyanath,1,0.00029,81494,23.80123,342394
10422,niting3c,1,0.00029,81495,23.80153,342394
10423,nitinsh99,1,0.00029,81496,23.80182,342394
10424,nitrocode,1,0.00029,81497,23.80211,342394
10425,nitroin,1,0.00029,81498,23.80240,342394
10426,NitsujY,1,0.00029,81499,23.80270,342394
10427,NiubilityOptimus,1,0.00029,81500,23.80299,342394
10428,niuxiaojuan-github,1,0.00029,81501,23.80328,342394
10429,NivedhaSenthil,1,0.00029,81502,23.80357,342394
10430,niwatorrri,1,0.00029,81503,23.80386,342394
10431,nixon89,1,0.00029,81504,23.80416,342394
10432,nmacgreg,1,0.00029,81505,23.80445,342394
10433,nmeum,1,0.00029,81506,23.80474,342394
10434,nmorey-ratehub,1,0.00029,81507,23.80503,342394
10435,nmrkic,1,0.00029,81508,23.80532,342394
10436,nnahaliel,1,0.00029,81509,23.80562,342394
10437,nneul,1,0.00029,81510,23.80591,342394
10438,nnewc,1,0.00029,81511,23.80620,342394
10439,nniehoff,1,0.00029,81512,23.80649,342394
10440,nnseva,1,0.00029,81513,23.80678,342394
10441,No9,1,0.00029,81514,23.80708,342394
10442,noahbailey,1,0.00029,81515,23.80737,342394
10443,noahjd,1,0.00029,81516,23.80766,342394
10444,noahlz,1,0.00029,81517,23.80795,342394
10445,noamsan,1,0.00029,81518,23.80824,342394
10446,nobiit,1,0.00029,81519,23.80854,342394
10447,nodje,1,0.00029,81520,23.80883,342394
10448,Noel-Dason,1,0.00029,81521,23.80912,342394
10449,nolith,1,0.00029,81522,23.80941,342394
10450,noliverio,1,0.00029,81523,23.80970,342394
10451,nomeelnoj,1,0.00029,81524,23.81000,342394
10452,noniu,1,0.00029,81525,23.81029,342394
10453,novotnej,1,0.00029,81526,23.81058,342394
10454,NOWYOU,1,0.00029,81527,23.81087,342394
10455,npd26,1,0.00029,81528,23.81116,342394
10456,npordash,1,0.00029,81529,23.81146,342394
10457,npreiser,1,0.00029,81530,23.81175,342394
10458,nq0m,1,0.00029,81531,23.81204,342394
10459,n-rodriguez,1,0.00029,81532,23.81233,342394
10460,ns-wwilkins,1,0.00029,81533,23.81263,342394
10461,nterra-paul,1,0.00029,81534,23.81292,342394
10462,nthsky,1,0.00029,81535,23.81321,342394
10463,nuclear0wl,1,0.00029,81536,23.81350,342394
10464,nuguni,1,0.00029,81537,23.81379,342394
10465,nuharaf,1,0.00029,81538,23.81409,342394
10466,nulf,1,0.00029,81539,23.81438,342394
10467,nullpainter,1,0.00029,81540,23.81467,342394
10468,number21,1,0.00029,81541,23.81496,342394
10469,nuno-faria,1,0.00029,81542,23.81525,342394
10470,nunojca,1,0.00029,81543,23.81555,342394
10471,nunomrc,1,0.00029,81544,23.81584,342394
10472,Nurik-K,1,0.00029,81545,23.81613,342394
10473,nutslove,1,0.00029,81546,23.81642,342394
10474,Nuxij,1,0.00029,81547,23.81671,342394
10475,nuzurie,1,0.00029,81548,23.81701,342394
10476,nvcnvn,1,0.00029,81549,23.81730,342394
10477,nvx,1,0.00029,81550,23.81759,342394
10478,nwalters512,1,0.00029,81551,23.81788,342394
10479,nwithers-ecr,1,0.00029,81552,23.81817,342394
10480,nwsparks,1,0.00029,81553,23.81847,342394
10481,nyap,1,0.00029,81554,23.81876,342394
10482,nysan,1,0.00029,81555,23.81905,342394
10483,nyurik,1,0.00029,81556,23.81934,342394
10484,nzomkxia,1,0.00029,81557,23.81963,342394
10485,o11ydemo,1,0.00029,81558,23.81993,342394
10486,obailiumingo,1,0.00029,81559,23.82022,342394
10487,obalunenko,1,0.00029,81560,23.82051,342394
10488,obawin,1,0.00029,81561,23.82080,342394
10489,obean,1,0.00029,81562,23.82109,342394
10490,obesser,1,0.00029,81563,23.82139,342394
10491,obigcat,1,0.00029,81564,23.82168,342394
10492,obito,1,0.00029,81565,23.82197,342394
10493,obsjmartin,1,0.00029,81566,23.82226,342394
10494,oceanroleplay,1,0.00029,81567,23.82256,342394
10495,octopop,1,0.00029,81568,23.82285,342394
10496,odelreym,1,0.00029,81569,23.82314,342394
10497,odsod,1,0.00029,81570,23.82343,342394
10498,OferPRTZ,1,0.00029,81571,23.82372,342394
10499,ogazitt,1,0.00029,81572,23.82402,342394
10500,ogermann,1,0.00029,81573,23.82431,342394
10501,Ognian,1,0.00029,81574,23.82460,342394
10502,ohadbeck,1,0.00029,81575,23.82489,342394
10503,ohadgur,1,0.00029,81576,23.82518,342394
10504,oif,1,0.00029,81577,23.82548,342394
10505,Oinari,1,0.00029,81578,23.82577,342394
10506,OkabeRitarou,1,0.00029,81579,23.82606,342394
10507,okechukwu-opara,1,0.00029,81580,23.82635,342394
10508,Okhoshi,1,0.00029,81581,23.82664,342394
10509,okin,1,0.00029,81582,23.82694,342394
10510,olddriver4,1,0.00029,81583,23.82723,342394
10511,oldluke92,1,0.00029,81584,23.82752,342394
10512,oleksandr-codefresh,1,0.00029,81585,23.82781,342394
10513,olenm,1,0.00029,81586,23.82810,342394
10514,olevitt,1,0.00029,81587,23.82840,342394
10515,olicu,1,0.00029,81588,23.82869,342394
10516,olivejing,1,0.00029,81589,23.82898,342394
10517,OliverCole,1,0.00029,81590,23.82927,342394
10518,oliverdawid,1,0.00029,81591,23.82956,342394
10519,oliversalzburg,1,0.00029,81592,23.82986,342394
10520,oliverwehrens,1,0.00029,81593,23.83015,342394
10521,oliwave,1,0.00029,81594,23.83044,342394
10522,OllowainT,1,0.00029,81595,23.83073,342394
10523,ollydixon,1,0.00029,81596,23.83103,342394
10524,omaidb,1,0.00029,81597,23.83132,342394
10525,Omega-Centauri-21,1,0.00029,81598,23.83161,342394
10526,omer-sd,1,0.00029,81599,23.83190,342394
10527,OMGUPTA21,1,0.00029,81600,23.83219,342394
10528,ominiet,1,0.00029,81601,23.83249,342394
10529,OmkarKirpan,1,0.00029,81602,23.83278,342394
10530,Omniscience619,1,0.00029,81603,23.83307,342394
10531,Omran-Hazaa,1,0.00029,81604,23.83336,342394
10532,OmriSteiner,1,0.00029,81605,23.83365,342394
10533,onap4105,1,0.00029,81606,23.83395,342394
10534,ondrejmo,1,0.00029,81607,23.83424,342394
10535,onehao,1,0.00029,81608,23.83453,342394
10536,OneideLuizSchneider,1,0.00029,81609,23.83482,342394
10537,onesail,1,0.00029,81610,23.83511,342394
10538,oneslideicywater,1,0.00029,81611,23.83541,342394
10539,onmomo,1,0.00029,81612,23.83570,342394
10540,ontehfritz,1,0.00029,81613,23.83599,342394
10541,oocx,1,0.00029,81614,23.83628,342394
10542,oontvoo,1,0.00029,81615,23.83657,342394
10543,openJT,1,0.00029,81616,23.83687,342394
10544,openstack-test,1,0.00029,81617,23.83716,342394
10545,Oper18,1,0.00029,81618,23.83745,342394
10546,opsb,1,0.00029,81619,23.83774,342394
10547,ops-hummus,1,0.00029,81620,23.83803,342394
10548,optimizasean,1,0.00029,81621,23.83833,342394
10549,oradwell,1,0.00029,81622,23.83862,342394
10550,oramraz,1,0.00029,81623,23.83891,342394
10551,orcutt989,1,0.00029,81624,23.83920,342394
10552,Orenus,1,0.00029,81625,23.83949,342394
10553,orfins,1,0.00029,81626,23.83979,342394
10554,origliante,1,0.00029,81627,23.84008,342394
10555,OriishiTakahiro,1,0.00029,81628,23.84037,342394
10556,Ornias1993,1,0.00029,81629,23.84066,342394
10557,oronsh,1,0.00029,81630,23.84096,342394
10558,orvice,1,0.00029,81631,23.84125,342394
10559,osas1111,1,0.00029,81632,23.84154,342394
10560,oscar60310,1,0.00029,81633,23.84183,342394
10561,oscarnevarezleal,1,0.00029,81634,23.84212,342394
10562,oscaromeu,1,0.00029,81635,23.84242,342394
10563,oscarprol,1,0.00029,81636,23.84271,342394
10564,oscartrullols,1,0.00029,81637,23.84300,342394
10565,oscrx,1,0.00029,81638,23.84329,342394
10566,osilkin98,1,0.00029,81639,23.84358,342394
10567,ossparvinder,1,0.00029,81640,23.84388,342394
10568,ostavnaas,1,0.00029,81641,23.84417,342394
10569,otherguy,1,0.00029,81642,23.84446,342394
10570,OussamaSALAHOUELHADJ,1,0.00029,81643,23.84475,342394
10571,owen-mc,1,0.00029,81644,23.84504,342394
10572,oybed,1,0.00029,81645,23.84534,342394
10573,ozahavi,1,0.00029,81646,23.84563,342394
10574,ozanyldzgithuboffical,1,0.00029,81647,23.84592,342394
10575,Oznup,1,0.00029,81648,23.84621,342394
10576,ozzy92,1,0.00029,81649,23.84650,342394
10577,ozzyian,1,0.00029,81650,23.84680,342394
10578,p120ph37,1,0.00029,81651,23.84709,342394
10579,pachalk,1,0.00029,81652,23.84738,342394
10580,pachecopaulo,1,0.00029,81653,23.84767,342394
10581,paediatbalcabch,1,0.00029,81654,23.84796,342394
10582,paigr,1,0.00029,81655,23.84826,342394
10583,painhardcore,1,0.00029,81656,23.84855,342394
10584,pajel,1,0.00029,81657,23.84884,342394
10585,pakuwa,1,0.00029,81658,23.84913,342394
10586,pandagodyyy,1,0.00029,81659,23.84942,342394
10587,pando85,1,0.00029,81660,23.84972,342394
10588,PangQingcheng,1,0.00029,81661,23.85001,342394
10589,panhaitao,1,0.00029,81662,23.85030,342394
10590,panthamm,1,0.00029,81663,23.85059,342394
10591,panxunying,1,0.00029,81664,23.85089,342394
10592,papcik,1,0.00029,81665,23.85118,342394
10593,Parcley,1,0.00029,81666,23.85147,342394
10594,parera10,1,0.00029,81667,23.85176,342394
10595,parsifallo,1,0.00029,81668,23.85205,342394
10596,parth-pandit,1,0.00029,81669,23.85235,342394
10597,parvaths1118,1,0.00029,81670,23.85264,342394
10598,patcon,1,0.00029,81671,23.85293,342394
10599,pathanzafar702,1,0.00029,81672,23.85322,342394
10600,pathob,1,0.00029,81673,23.85351,342394
10601,patiln,1,0.00029,81674,23.85381,342394
10602,patrickhoefler,1,0.00029,81675,23.85410,342394
10603,patrickhuy,1,0.00029,81676,23.85439,342394
10604,patrickjahns,1,0.00029,81677,23.85468,342394
10605,patrickShaikh,1,0.00029,81678,23.85497,342394
10606,patrickstrick,1,0.00029,81679,23.85527,342394
10607,PatrickWolleb,1,0.00029,81680,23.85556,342394
10608,patvdleer,1,0.00029,81681,23.85585,342394
10609,paul-cummings,1,0.00029,81682,23.85614,342394
10610,paule96,1,0.00029,81683,23.85643,342394
10611,paulgreenbank,1,0.00029,81684,23.85673,342394
10612,PaulinaParangerHr,1,0.00029,81685,23.85702,342394
10613,paul-mesnilgrente,1,0.00029,81686,23.85731,342394
10614,paulovmr,1,0.00029,81687,23.85760,342394
10615,paulwfield,1,0.00029,81688,23.85789,342394
10616,paulzhn,1,0.00029,81689,23.85819,342394
10617,pavelanni,1,0.00029,81690,23.85848,342394
10618,PavelKarpenka,1,0.00029,81691,23.85877,342394
10619,pavmohan1,1,0.00029,81692,23.85906,342394
10620,pawandwivedi,1,0.00029,81693,23.85936,342394
10621,PawelKopel,1,0.00029,81694,23.85965,342394
10622,PawelSpoon,1,0.00029,81695,23.85994,342394
10623,pawsey-kbuckley,1,0.00029,81696,23.86023,342394
10624,paxbit,1,0.00029,81697,23.86052,342394
10625,paya-cz,1,0.00029,81698,23.86082,342394
10626,pb0501x,1,0.00029,81699,23.86111,342394
10627,pbabbott,1,0.00029,81700,23.86140,342394
10628,pbiggar,1,0.00029,81701,23.86169,342394
10629,pcmoritz,1,0.00029,81702,23.86198,342394
10630,pcornelissen,1,0.00029,81703,23.86228,342394
10631,pctseng7,1,0.00029,81704,23.86257,342394
10632,pdaBlueVoyant,1,0.00029,81705,23.86286,342394
10633,pde-rent,1,0.00029,81706,23.86315,342394
10634,pdmelon,1,0.00029,81707,23.86344,342394
10635,PDQDakota,1,0.00029,81708,23.86374,342394
10636,pduchnovsky,1,0.00029,81709,23.86403,342394
10637,PeerXu,1,0.00029,81710,23.86432,342394
10638,pefeigl,1,0.00029,81711,23.86461,342394
10639,PehrGit,1,0.00029,81712,23.86490,342394
10640,peixiaoqing,1,0.00029,81713,23.86520,342394
10641,pelt,1,0.00029,81714,23.86549,342394
10642,pencilkill,1,0.00029,81715,23.86578,342394
10643,PendaGTP,1,0.00029,81716,23.86607,342394
10644,penglongli,1,0.00029,81717,23.86636,342394
10645,pengyuan,1,0.00029,81718,23.86666,342394
10646,PennaLai,1,0.00029,81719,23.86695,342394
10647,pentlander,1,0.00029,81720,23.86724,342394
10648,PerkinTahmaz,1,0.00029,81721,23.86753,342394
10649,PetarBersic,1,0.00029,81722,23.86782,342394
10650,petedyerarm,1,0.00029,81723,23.86812,342394
10651,peterhirn,1,0.00029,81724,23.86841,342394
10652,peterliu526,1,0.00029,81725,23.86870,342394
10653,PeterPilley,1,0.00029,81726,23.86899,342394
10654,PeterThomasAwen,1,0.00029,81727,23.86929,342394
10655,petethepig,1,0.00029,81728,23.86958,342394
10656,petr-buchin,1,0.00029,81729,23.86987,342394
10657,petros-d,1,0.00029,81730,23.87016,342394
10658,PetrSilar,1,0.00029,81731,23.87045,342394
10659,pflueras,1,0.00029,81732,23.87075,342394
10660,pfriedland,1,0.00029,81733,23.87104,342394
10661,pgendreau,1,0.00029,81734,23.87133,342394
10662,pgilfillan,1,0.00029,81735,23.87162,342394
10663,pgoodman,1,0.00029,81736,23.87191,342394
10664,pgouda89,1,0.00029,81737,23.87221,342394
10665,phani-rudra9,1,0.00029,81738,23.87250,342394
10666,phcaguiar,1,0.00029,81739,23.87279,342394
10667,philipp-becker,1,0.00029,81740,23.87308,342394
10668,philipsu522,1,0.00029,81741,23.87337,342394
10669,philnate,1,0.00029,81742,23.87367,342394
10670,philnielsen,1,0.00029,81743,23.87396,342394
10671,phlawski,1,0.00029,81744,23.87425,342394
10672,Phoebus888,1,0.00029,81745,23.87454,342394
10673,phoenix741,1,0.00029,81746,23.87483,342394
10674,phoenix-muecahit,1,0.00029,81747,23.87513,342394
10675,phuongnd96,1,0.00029,81748,23.87542,342394
10676,phxism,1,0.00029,81749,23.87571,342394
10677,piano-man,1,0.00029,81750,23.87600,342394
10678,PicksUpTheGauntlet,1,0.00029,81751,23.87629,342394
10679,PicoCreator,1,0.00029,81752,23.87659,342394
10680,pierlucg-xs,1,0.00029,81753,23.87688,342394
10681,pietermarsman,1,0.00029,81754,23.87717,342394
10682,pigLoveRabbit520,1,0.00029,81755,23.87746,342394
10683,Piioo,1,0.00029,81756,23.87775,342394
10684,pinaki124,1,0.00029,81757,23.87805,342394
10685,Pinepure,1,0.00029,81758,23.87834,342394
10686,pingenglj,1,0.00029,81759,23.87863,342394
10687,pingsutw,1,0.00029,81760,23.87892,342394
10688,pinkfloydx33,1,0.00029,81761,23.87922,342394
10689,pinlast,1,0.00029,81762,23.87951,342394
10690,piotom,1,0.00029,81763,23.87980,342394
10691,Piotr1215,1,0.00029,81764,23.88009,342394
10692,piotrminkina,1,0.00029,81765,23.88038,342394
10693,pipelineburst,1,0.00029,81766,23.88068,342394
10694,pipeworks-asmith,1,0.00029,81767,23.88097,342394
10695,pipocadr,1,0.00029,81768,23.88126,342394
10696,pipoe2h,1,0.00029,81769,23.88155,342394
10697,PiQuer,1,0.00029,81770,23.88184,342394
10698,piratf,1,0.00029,81771,23.88214,342394
10699,Pitson3,1,0.00029,81772,23.88243,342394
10700,pivotal-david-osullivan,1,0.00029,81773,23.88272,342394
10701,pixelsoccupied,1,0.00029,81774,23.88301,342394
10702,PiyushBhatewara,1,0.00029,81775,23.88330,342394
10703,pjaak,1,0.00029,81776,23.88360,342394
10704,pjaudiomv,1,0.00029,81777,23.88389,342394
10705,pjgg,1,0.00029,81778,23.88418,342394
10706,Pkanjai,1,0.00029,81779,23.88447,342394
10707,pkwestm,1,0.00029,81780,23.88476,342394
10708,platogabriel,1,0.00029,81781,23.88506,342394
10709,plnordquist,1,0.00029,81782,23.88535,342394
10710,plucked,1,0.00029,81783,23.88564,342394
10711,Plus3IT-Azure,1,0.00029,81784,23.88593,342394
10712,pmarschik,1,0.00029,81785,23.88622,342394
10713,pmmalinov01,1,0.00029,81786,23.88652,342394
10714,pmoogi-redhat,1,0.00029,81787,23.88681,342394
10715,pnorth1,1,0.00029,81788,23.88710,342394
10716,pnquest,1,0.00029,81789,23.88739,342394
10717,poblish,1,0.00029,81790,23.88768,342394
10718,PoeBlu,1,0.00029,81791,23.88798,342394
10719,poksiala,1,0.00029,81792,23.88827,342394
10720,polatsinan,1,0.00029,81793,23.88856,342394
10721,pom11,1,0.00029,81794,23.88885,342394
10722,p-o-nch,1,0.00029,81795,23.88915,342394
10723,ponner-github,1,0.00029,81796,23.88944,342394
10724,poojaghumre,1,0.00029,81797,23.88973,342394
10725,PopChicken,1,0.00029,81798,23.89002,342394
10726,porfirion,1,0.00029,81799,23.89031,342394
10727,Porthorian,1,0.00029,81800,23.89061,342394
10728,poteat,1,0.00029,81801,23.89090,342394
10729,pothitos,1,0.00029,81802,23.89119,342394
10730,Poweranimal,1,0.00029,81803,23.89148,342394
10731,powertim,1,0.00029,81804,23.89177,342394
10732,p-palanis,1,0.00029,81805,23.89207,342394
10733,ppbrown,1,0.00029,81806,23.89236,342394
10734,ppieprzycki,1,0.00029,81807,23.89265,342394
10735,pporee,1,0.00029,81808,23.89294,342394
10736,pr0PM,1,0.00029,81809,23.89323,342394
10737,pradeep288,1,0.00029,81810,23.89353,342394
10738,prajithp13,1,0.00029,81811,23.89382,342394
10739,pranav-shah294,1,0.00029,81812,23.89411,342394
10740,pranv-sonawane,1,0.00029,81813,23.89440,342394
10741,prapakaransp,1,0.00029,81814,23.89469,342394
10742,prasad-1210,1,0.00029,81815,23.89499,342394
10743,Prashanth684,1,0.00029,81816,23.89528,342394
10744,prashant-warrier-echelonvi,1,0.00029,81817,23.89557,342394
10745,prashi2202,1,0.00029,81818,23.89586,342394
10746,Prateeknandle,1,0.00029,81819,23.89615,342394
10747,pratik-pagade,1,0.00029,81820,23.89645,342394
10748,pratikthorve90,1,0.00029,81821,23.89674,342394
10749,praveenmak,1,0.00029,81822,23.89703,342394
10750,preciousonyekwere,1,0.00029,81823,23.89732,342394
10751,precurse,1,0.00029,81824,23.89762,342394
10752,Preetham777,1,0.00029,81825,23.89791,342394
10753,premGE,1,0.00029,81826,23.89820,342394
10754,preslavmihaylov,1,0.00029,81827,23.89849,342394
10755,prigio,1,0.00029,81828,23.89878,342394
10756,prithakur,1,0.00029,81829,23.89908,342394
10757,prithvi1307,1,0.00029,81830,23.89937,342394
10758,privx-de,1,0.00029,81831,23.89966,342394
10759,priyanka-ravi,1,0.00029,81832,23.89995,342394
10760,PriyanshuAhlawat,1,0.00029,81833,23.90024,342394
10761,priyavj08,1,0.00029,81834,23.90054,342394
10762,pro100guy,1,0.00029,81835,23.90083,342394
10763,protoz,1,0.00029,81836,23.90112,342394
10764,prudentcircle,1,0.00029,81837,23.90141,342394
10765,PrymalInstynct,1,0.00029,81838,23.90170,342394
10766,przwojtkow,1,0.00029,81839,23.90200,342394
10767,pshen,1,0.00029,81840,23.90229,342394
10768,psilohanf,1,0.00029,81841,23.90258,342394
10769,psiso,1,0.00029,81842,23.90287,342394
10770,pslq,1,0.00029,81843,23.90316,342394
10771,pstackle,1,0.00029,81844,23.90346,342394
10772,pstray,1,0.00029,81845,23.90375,342394
10773,psturc,1,0.00029,81846,23.90404,342394
10774,psuet,1,0.00029,81847,23.90433,342394
10775,psychomelet,1,0.00029,81848,23.90462,342394
10776,Psycopg6,1,0.00029,81849,23.90492,342394
10777,psyhomb,1,0.00029,81850,23.90521,342394
10778,pteroctopus,1,0.00029,81851,23.90550,342394
10779,pthatchinamoorthy,1,0.00029,81852,23.90579,342394
10780,ptrf,1,0.00029,81853,23.90608,342394
10781,pukanszkypeter,1,0.00029,81854,23.90638,342394
10782,PulapakuraBros,1,0.00029,81855,23.90667,342394
10783,PuneeshMotwani,1,0.00029,81856,23.90696,342394
10784,punkstarman,1,0.00029,81857,23.90725,342394
10785,purkhusid,1,0.00029,81858,23.90755,342394
10786,putnam120,1,0.00029,81859,23.90784,342394
10787,PV-giri,1,0.00029,81860,23.90813,342394
10788,pvinis,1,0.00029,81861,23.90842,342394
10789,pviraj59,1,0.00029,81862,23.90871,342394
10790,pvlg,1,0.00029,81863,23.90901,342394
10791,pvnghia123,1,0.00029,81864,23.90930,342394
10792,pvsone,1,0.00029,81865,23.90959,342394
10793,pvsune,1,0.00029,81866,23.90988,342394
10794,pyfs,1,0.00029,81867,23.91017,342394
10795,pyrl247,1,0.00029,81868,23.91047,342394
10796,pysen,1,0.00029,81869,23.91076,342394
10797,pytlesk4,1,0.00029,81870,23.91105,342394
10798,pywangwwei,1,0.00029,81871,23.91134,342394
10799,pzdouglas,1,0.00029,81872,23.91163,342394
10800,pzhangch,1,0.00029,81873,23.91193,342394
10801,QBens,1,0.00029,81874,23.91222,342394
10802,qbx2,1,0.00029,81875,23.91251,342394
10803,qdm12,1,0.00029,81876,23.91280,342394
10804,qdupuy,1,0.00029,81877,23.91309,342394
10805,QGB,1,0.00029,81878,23.91339,342394
10806,qhua948,1,0.00029,81879,23.91368,342394
10807,qiaqiatic,1,0.00029,81880,23.91397,342394
10808,qingwave,1,0.00029,81881,23.91426,342394
10809,qingyunha,1,0.00029,81882,23.91455,342394
10810,qinL-cdy,1,0.00029,81883,23.91485,342394
10811,qiyin777,1,0.00029,81884,23.91514,342394
10812,Qmeriaux,1,0.00029,81885,23.91543,342394
10813,qoricode,1,0.00029,81886,23.91572,342394
10814,qqovopp,1,0.00029,81887,23.91601,342394
10815,quanjun5428,1,0.00029,81888,23.91631,342394
10816,quanquangduc,1,0.00029,81889,23.91660,342394
10817,Queeq,1,0.00029,81890,23.91689,342394
10818,Queetinliu,1,0.00029,81891,23.91718,342394
10819,quentingodeau,1,0.00029,81892,23.91748,342394
10820,quinn,1,0.00029,81893,23.91777,342394
10821,QuinnBast,1,0.00029,81894,23.91806,342394
10822,quorak,1,0.00029,81895,23.91835,342394
10823,qxmips,1,0.00029,81896,23.91864,342394
10824,r6bot,1,0.00029,81897,23.91894,342394
10825,RaananHadar,1,0.00029,81898,23.91923,342394
10826,raballew,1,0.00029,81899,23.91952,342394
10827,rabidscorpio,1,0.00029,81900,23.91981,342394
10828,racheljpg,1,0.00029,81901,23.92010,342394
10829,radoslav-tomov,1,0.00029,81902,23.92040,342394
10830,radouani1984,1,0.00029,81903,23.92069,342394
10831,rafaelmagalhaes,1,0.00029,81904,23.92098,342394
10832,Rafaesp,1,0.00029,81905,23.92127,342394
10833,rafedramzi,1,0.00029,81906,23.92156,342394
10834,RafPe,1,0.00029,81907,23.92186,342394
10835,rageebm,1,0.00029,81908,23.92215,342394
10836,rage-shadowman,1,0.00029,81909,23.92244,342394
10837,Raghavendrasp123,1,0.00029,81910,23.92273,342394
10838,rahilsh,1,0.00029,81911,23.92302,342394
10839,rahmataw,1,0.00029,81912,23.92332,342394
10840,rahulait,1,0.00029,81913,23.92361,342394
10841,rahuldhir,1,0.00029,81914,23.92390,342394
10842,Rahulsharma0810,1,0.00029,81915,23.92419,342394
10843,Rahuly360,1,0.00029,81916,23.92448,342394
10844,rajar0201,1,0.00029,81917,23.92478,342394
10845,rajata07,1,0.00029,81918,23.92507,342394
10846,Rajendraladkat1919,1,0.00029,81919,23.92536,342394
10847,rajeshnair,1,0.00029,81920,23.92565,342394
10848,rajivml,1,0.00029,81921,23.92594,342394
10849,Raju-kf,1,0.00029,81922,23.92624,342394
10850,rakesh-garimella,1,0.00029,81923,23.92653,342394
10851,rakhigandhi,1,0.00029,81924,23.92682,342394
10852,rakshith91,1,0.00029,81925,23.92711,342394
10853,ralight,1,0.00029,81926,23.92741,342394
10854,ramalingamvarkala,1,0.00029,81927,23.92770,342394
10855,RamBNarayanan,1,0.00029,81928,23.92799,342394
10856,rameshkumar5155,1,0.00029,81929,23.92828,342394
10857,ramiyengar,1,0.00029,81930,23.92857,342394
10858,Ramkumar-Murugesan,1,0.00029,81931,23.92887,342394
10859,ramondeklein,1,0.00029,81932,23.92916,342394
10860,rampatnaik,1,0.00029,81933,23.92945,342394
10861,ramuyesupogu,1,0.00029,81934,23.92974,342394
10862,Ramya1507,1,0.00029,81935,23.93003,342394
10863,randywatson1979,1,0.00029,81936,23.93033,342394
10864,ransoor2,1,0.00029,81937,23.93062,342394
10865,raphminkyu,1,0.00029,81938,23.93091,342394
10866,raptium,1,0.00029,81939,23.93120,342394
10867,raptorsun,1,0.00029,81940,23.93149,342394
10868,raresserban,1,0.00029,81941,23.93179,342394
10869,rarick,1,0.00029,81942,23.93208,342394
10870,rashmichandrashekar,1,0.00029,81943,23.93237,342394
10871,rasvi24,1,0.00029,81944,23.93266,342394
10872,raulsaeztapia,1,0.00029,81945,23.93295,342394
10873,raunakkumar,1,0.00029,81946,23.93325,342394
10874,raunyoliveira-hotmart,1,0.00029,81947,23.93354,342394
10875,ravensorb,1,0.00029,81948,23.93383,342394
10876,ravi-cldcvr,1,0.00029,81949,23.93412,342394
10877,RaviKishoreKota,1,0.00029,81950,23.93441,342394
10878,ray2211,1,0.00029,81951,23.93471,342394
10879,RayHuangCN,1,0.00029,81952,23.93500,342394
10880,raymonddejong,1,0.00029,81953,23.93529,342394
10881,raynix,1,0.00029,81954,23.93558,342394
10882,raz-co-n,1,0.00029,81955,23.93588,342394
10883,razorxster,1,0.00029,81956,23.93617,342394
10884,rbakhtaraev,1,0.00029,81957,23.93646,342394
10885,rbn2357,1,0.00029,81958,23.93675,342394
10886,rbounds,1,0.00029,81959,23.93704,342394
10887,rbs-cloud,1,0.00029,81960,23.93734,342394
10888,rchrd,1,0.00029,81961,23.93763,342394
10889,rchunping,1,0.00029,81962,23.93792,342394
10890,rcmonitor,1,0.00029,81963,23.93821,342394
10891,rcrowe,1,0.00029,81964,23.93850,342394
10892,rdcm,1,0.00029,81965,23.93880,342394
10893,rdenchev,1,0.00029,81966,23.93909,342394
10894,rdesgroppes,1,0.00029,81967,23.93938,342394
10895,rdonkin-attest,1,0.00029,81968,23.93967,342394
10896,readonlyuser1,1,0.00029,81969,23.93996,342394
10897,reborn-go,1,0.00029,81970,23.94026,342394
10898,Recognizeyourself,1,0.00029,81971,23.94055,342394
10899,red55,1,0.00029,81972,23.94084,342394
10900,redblade,1,0.00029,81973,23.94113,342394
10901,RedlineTriad,1,0.00029,81974,23.94142,342394
10902,redmictian,1,0.00029,81975,23.94172,342394
10903,reecefenwick,1,0.00029,81976,23.94201,342394
10904,reg0bs,1,0.00029,81977,23.94230,342394
10905,ReggieCarey,1,0.00029,81978,23.94259,342394
10906,regiszanandrea,1,0.00029,81979,23.94288,342394
10907,regnaio,1,0.00029,81980,23.94318,342394
10908,REHICode,1,0.00029,81981,23.94347,342394
10909,reimda,1,0.00029,81982,23.94376,342394
10910,reinaldoleon,1,0.00029,81983,23.94405,342394
10911,RemiWoler,1,0.00029,81984,23.94434,342394
10912,remko,1,0.00029,81985,23.94464,342394
10913,remotenode,1,0.00029,81986,23.94493,342394
10914,remytoma-xolver,1,0.00029,81987,23.94522,342394
10915,ren2881971,1,0.00029,81988,23.94551,342394
10916,renannprado,1,0.00029,81989,23.94581,342394
10917,renekt,1,0.00029,81990,23.94610,342394
10918,renkei,1,0.00029,81991,23.94639,342394
10919,reno1979,1,0.00029,81992,23.94668,342394
10920,r-erema,1,0.00029,81993,23.94697,342394
10921,resaisguvenligi,1,0.00029,81994,23.94727,342394
10922,retskcud,1,0.00029,81995,23.94756,342394
10923,Revanthchowdary9,1,0.00029,81996,23.94785,342394
10924,Revolyssup,1,0.00029,81997,23.94814,342394
10925,rezonant,1,0.00029,81998,23.94843,342394
10926,rfakit,1,0.00029,81999,23.94873,342394
10927,r-farrell,1,0.00029,82000,23.94902,342394
10928,rforberger,1,0.00029,82001,23.94931,342394
10929,rg13567,1,0.00029,82002,23.94960,342394
10930,rgardelein,1,0.00029,82003,23.94989,342394
10931,rgeraskin,1,0.00029,82004,23.95019,342394
10932,rgomez-casa,1,0.00029,82005,23.95048,342394
10933,rgrebski,1,0.00029,82006,23.95077,342394
10934,rgroemmer,1,0.00029,82007,23.95106,342394
10935,rhjensen79,1,0.00029,82008,23.95135,342394
10936,riandyrn,1,0.00029,82009,23.95165,342394
10937,riaz7se,1,0.00029,82010,23.95194,342394
10938,ribasnath,1,0.00029,82011,23.95223,342394
10939,ricardf,1,0.00029,82012,23.95252,342394
10940,richard-9000,1,0.00029,82013,23.95281,342394
10941,richardFontaine,1,0.00029,82014,23.95311,342394
10942,RichardVogelij,1,0.00029,82015,23.95340,342394
10943,RichardWright,1,0.00029,82016,23.95369,342394
10944,richkuz,1,0.00029,82017,23.95398,342394
10945,richmolumby,1,0.00029,82018,23.95427,342394
10946,richvdh,1,0.00029,82019,23.95457,342394
10947,RicoToothless,1,0.00029,82020,23.95486,342394
10948,rijos,1,0.00029,82021,23.95515,342394
10949,rikkuness,1,0.00029,82022,23.95544,342394
10950,rille111,1,0.00029,82023,23.95574,342394
10951,ritheshgm,1,0.00029,82024,23.95603,342394
10952,ritikbheda,1,0.00029,82025,23.95632,342394
10953,RiversLee,1,0.00029,82026,23.95661,342394
10954,rizkyramadhanch,1,0.00029,82027,23.95690,342394
10955,rizzza,1,0.00029,82028,23.95720,342394
10956,rjackoby-r7,1,0.00029,82029,23.95749,342394
10957,rjeczkow,1,0.00029,82030,23.95778,342394
10958,rjminchuk,1,0.00029,82031,23.95807,342394
10959,RJvH,1,0.00029,82032,23.95836,342394
10960,rkalkani,1,0.00029,82033,23.95866,342394
10961,Rkapoor1707,1,0.00029,82034,23.95895,342394
10962,rkatti,1,0.00029,82035,23.95924,342394
10963,r-kells,1,0.00029,82036,23.95953,342394
10964,rkennedy-tpl,1,0.00029,82037,23.95982,342394
10965,rkr-kununu,1,0.00029,82038,23.96012,342394
10966,rlaveycal,1,0.00029,82039,23.96041,342394
10967,rlugmania,1,0.00029,82040,23.96070,342394
10968,rmetzger,1,0.00029,82041,23.96099,342394
10969,rmoreas,1,0.00029,82042,23.96128,342394
10970,rms1000watt,1,0.00029,82043,23.96158,342394
10971,rmtobin,1,0.00029,82044,23.96187,342394
10972,rnjudge,1,0.00029,82045,23.96216,342394
10973,rnsc,1,0.00029,82046,23.96245,342394
10974,roadSurfer,1,0.00029,82047,23.96274,342394
10975,robd003,1,0.00029,82048,23.96304,342394
10976,RobDolin,1,0.00029,82049,23.96333,342394
10977,RobertBoyd,1,0.00029,82050,23.96362,342394
10978,robertbublik,1,0.00029,82051,23.96391,342394
10979,RobertFischer,1,0.00029,82052,23.96420,342394
10980,robert-hermanson,1,0.00029,82053,23.96450,342394
10981,robertkaelin,1,0.00029,82054,23.96479,342394
10982,robertogyn19,1,0.00029,82055,23.96508,342394
10983,robertprast,1,0.00029,82056,23.96537,342394
10984,robertsben,1,0.00029,82057,23.96567,342394
10985,robigne,1,0.00029,82058,23.96596,342394
10986,robin850,1,0.00029,82059,23.96625,342394
10987,robinfoe,1,0.00029,82060,23.96654,342394
10988,robinhood018,1,0.00029,82061,23.96683,342394
10989,robinhuiser,1,0.00029,82062,23.96713,342394
10990,robinwolny,1,0.00029,82063,23.96742,342394
10991,robisoh88,1,0.00029,82064,23.96771,342394
10992,robselway,1,0.00029,82065,23.96800,342394
10993,rodrigoaraujo1,1,0.00029,82066,23.96829,342394
10994,rodriguesg,1,0.00029,82067,23.96859,342394
10995,roeera,1,0.00029,82068,23.96888,342394
10996,rohanagarwal36,1,0.00029,82069,23.96917,342394
10997,Rohan-cod,1,0.00029,82070,23.96946,342394
10998,rohan-palo,1,0.00029,82071,23.96975,342394
10999,RohinBhargava,1,0.00029,82072,23.97005,342394
11000,rohitss912,1,0.00029,82073,23.97034,342394
11001,roivaz,1,0.00029,82074,23.97063,342394
11002,rokkarinn,1,0.00029,82075,23.97092,342394
11003,RolandOtta,1,0.00029,82076,23.97121,342394
11004,RomainPhil,1,0.00029,82077,23.97151,342394
11005,RomanBadiornyi,1,0.00029,82078,23.97180,342394
11006,Roman-Bober,1,0.00029,82079,23.97209,342394
11007,RomanGrekov,1,0.00029,82080,23.97238,342394
11008,romanimm,1,0.00029,82081,23.97267,342394
11009,romanowski,1,0.00029,82082,23.97297,342394
11010,romansky,1,0.00029,82083,23.97326,342394
11011,romerve,1,0.00029,82084,23.97355,342394
11012,romilpunetha,1,0.00029,82085,23.97384,342394
11013,RommelLayco,1,0.00029,82086,23.97414,342394
11014,ronakce,1,0.00029,82087,23.97443,342394
11015,ronaldmiranda,1,0.00029,82088,23.97472,342394
11016,roquesao,1,0.00029,82089,23.97501,342394
11017,RorisangSitoboli,1,0.00029,82090,23.97530,342394
11018,Roronoa-Z3r0,1,0.00029,82091,23.97560,342394
11019,Rosalieww,1,0.00029,82092,23.97589,342394
11020,rosaLux161,1,0.00029,82093,23.97618,342394
11021,rosie-gao-awx,1,0.00029,82094,23.97647,342394
11022,rosscado,1,0.00029,82095,23.97676,342394
11023,Rossiar,1,0.00029,82096,23.97706,342394
11024,rost5000,1,0.00029,82097,23.97735,342394
11025,rotem-cider,1,0.00029,82098,23.97764,342394
11026,rotring05,1,0.00029,82099,23.97793,342394
11027,rotty3000,1,0.00029,82100,23.97822,342394
11028,RouHim,1,0.00029,82101,23.97852,342394
11029,rounaksarda,1,0.00029,82102,23.97881,342394
11030,Routhinator,1,0.00029,82103,23.97910,342394
11031,rowanhwilliams,1,0.00029,82104,23.97939,342394
11032,royeo,1,0.00029,82105,23.97968,342394
11033,Roytjoo,1,0.00029,82106,23.97998,342394
11034,rparwani16,1,0.00029,82107,23.98027,342394
11035,rpenha,1,0.00029,82108,23.98056,342394
11036,rpuppo,1,0.00029,82109,23.98085,342394
11037,rra,1,0.00029,82110,23.98114,342394
11038,rradecki-migo,1,0.00029,82111,23.98144,342394
11039,rrimc69,1,0.00029,82112,23.98173,342394
11040,rronneburger,1,0.00029,82113,23.98202,342394
11041,rr-sarvesh-padia,1,0.00029,82114,23.98231,342394
11042,rsacct54,1,0.00029,82115,23.98260,342394
11043,RSAlderman,1,0.00029,82116,23.98290,342394
11044,rseasta,1,0.00029,82117,23.98319,342394
11045,rsmets,1,0.00029,82118,23.98348,342394
11046,rsmoorthy,1,0.00029,82119,23.98377,342394
11047,rsumukha,1,0.00029,82120,23.98407,342394
11048,rsysanishsharma,1,0.00029,82121,23.98436,342394
11049,rt711,1,0.00029,82122,23.98465,342394
11050,Rtoax,1,0.00029,82123,23.98494,342394
11051,rtrindvg,1,0.00029,82124,23.98523,342394
11052,rtttech,1,0.00029,82125,23.98553,342394
11053,rubentsirunyan,1,0.00029,82126,23.98582,342394
11054,rudymccomb,1,0.00029,82127,23.98611,342394
11055,ruibinghao,1,0.00029,82128,23.98640,342394
11056,ruijzhan,1,0.00029,82129,23.98669,342394
11057,rui-randolph,1,0.00029,82130,23.98699,342394
11058,RunFox,1,0.00029,82131,23.98728,342394
11059,runner112,1,0.00029,82132,23.98757,342394
11060,ruppincs28,1,0.00029,82133,23.98786,342394
11061,RuriRyan,1,0.00029,82134,23.98815,342394
11062,ruslanloman,1,0.00029,82135,23.98845,342394
11063,ruslansuprun,1,0.00029,82136,23.98874,342394
11064,ruslanzelinskyy,1,0.00029,82137,23.98903,342394
11065,rusnasonov,1,0.00029,82138,23.98932,342394
11066,russelldias98,1,0.00029,82139,23.98961,342394
11067,russss,1,0.00029,82140,23.98991,342394
11068,ruxandramarasescu,1,0.00029,82141,23.99020,342394
11069,rwkarg,1,0.00029,82142,23.99049,342394
11070,ryanaross,1,0.00029,82143,23.99078,342394
11071,ryanbrigden,1,0.00029,82144,23.99107,342394
11072,ryan-dyer-sp,1,0.00029,82145,23.99137,342394
11073,ryanemerson,1,0.00029,82146,23.99166,342394
11074,RyanMillerC,1,0.00029,82147,23.99195,342394
11075,ryanzzff,1,0.00029,82148,23.99224,342394
11076,Rybue,1,0.00029,82149,23.99253,342394
11077,ryharrin,1,0.00029,82150,23.99283,342394
11078,Ryn12,1,0.00029,82151,23.99312,342394
11079,ryota2425,1,0.00029,82152,23.99341,342394
11080,ryoung75,1,0.00029,82153,23.99370,342394
11081,rzk,1,0.00029,82154,23.99400,342394
11082,RZRCDR,1,0.00029,82155,23.99429,342394
11083,rzseattle,1,0.00029,82156,23.99458,342394
11084,s0mb3x,1,0.00029,82157,23.99487,342394
11085,saaryehudai,1,0.00029,82158,23.99516,342394
11086,saasglue,1,0.00029,82159,23.99546,342394
11087,saba-bakhshi,1,0.00029,82160,23.99575,342394
11088,SabariArunkumarP,1,0.00029,82161,23.99604,342394
11089,sabder,1,0.00029,82162,23.99633,342394
11090,Sac-BRONGA,1,0.00029,82163,23.99662,342394
11091,sacesare,1,0.00029,82164,23.99692,342394
11092,saeeda,1,0.00029,82165,23.99721,342394
11093,safaalai,1,0.00029,82166,23.99750,342394
11094,safejob,1,0.00029,82167,23.99779,342394
11095,sahajavidya,1,0.00029,82168,23.99808,342394
11096,Sahaquielxo,1,0.00029,82169,23.99838,342394
11097,saharhagbi,1,0.00029,82170,23.99867,342394
11098,Sahilbhawke,1,0.00029,82171,23.99896,342394
11099,SahilKr24,1,0.00029,82172,23.99925,342394
11100,Sahithijalagam,1,0.00029,82173,23.99954,342394
11101,saibug,1,0.00029,82174,23.99984,342394
11102,saikarthikp9,1,0.00029,82175,24.00013,342394
11103,sailorgallifrey,1,0.00029,82176,24.00042,342394
11104,sainoba,1,0.00029,82177,24.00071,342394
11105,saintwang007,1,0.00029,82178,24.00100,342394
11106,saitoy1,1,0.00029,82179,24.00130,342394
11107,saksham189,1,0.00029,82180,24.00159,342394
11108,sakshigupta3,1,0.00029,82181,24.00188,342394
11109,salemmohammed,1,0.00029,82182,24.00217,342394
11110,sali98,1,0.00029,82183,24.00246,342394
11111,Samba73,1,0.00029,82184,24.00276,342394
11112,samcday,1,0.00029,82185,24.00305,342394
11113,sameer106,1,0.00029,82186,24.00334,342394
11114,samelie,1,0.00029,82187,24.00363,342394
11115,samene,1,0.00029,82188,24.00393,342394
11116,samholton,1,0.00029,82189,24.00422,342394
11117,samiramkr,1,0.00029,82190,24.00451,342394
11118,sammagnum,1,0.00029,82191,24.00480,342394
11119,samox73,1,0.00029,82192,24.00509,342394
11120,sampx,1,0.00029,82193,24.00539,342394
11121,sam-sre,1,0.00029,82194,24.00568,342394
11122,SamuelBagattin,1,0.00029,82195,24.00597,342394
11123,SamuelStuchly,1,0.00029,82196,24.00626,342394
11124,Samuron,1,0.00029,82197,24.00655,342394
11125,sanasz91mdev,1,0.00029,82198,24.00685,342394
11126,sandeepdigicraft,1,0.00029,82199,24.00714,342394
11127,sanderdescamps,1,0.00029,82200,24.00743,342394
11128,sanderobdeijn,1,0.00029,82201,24.00772,342394
11129,sandeshkg,1,0.00029,82202,24.00801,342394
11130,SandipGorde-TomTom,1,0.00029,82203,24.00831,342394
11131,sandrobonazzola,1,0.00029,82204,24.00860,342394
11132,Sandy7894,1,0.00029,82205,24.00889,342394
11133,sanjayankur31,1,0.00029,82206,24.00918,342394
11134,SanjayDatta,1,0.00029,82207,24.00947,342394
11135,SanjaySinghRajpoot,1,0.00029,82208,24.00977,342394
11136,sanjeloo,1,0.00029,82209,24.01006,342394
11137,sankalp-r,1,0.00029,82210,24.01035,342394
11138,sanketsudake,1,0.00029,82211,24.01064,342394
11139,santhoshparepu,1,0.00029,82212,24.01093,342394
11140,SantiMunoz,1,0.00029,82213,24.01123,342394
11141,sapconsultantbc,1,0.00029,82214,24.01152,342394
11142,SapnaGirdhani1,1,0.00029,82215,24.01181,342394
11143,sappier,1,0.00029,82216,24.01210,342394
11144,saquibmian,1,0.00029,82217,24.01240,342394
11145,sarahpmedeiros,1,0.00029,82218,24.01269,342394
11146,saran-kumaar,1,0.00029,82219,24.01298,342394
11147,Sarathgiggso,1,0.00029,82220,24.01327,342394
11148,sarathsprakash,1,0.00029,82221,24.01356,342394
11149,sarbajitc,1,0.00029,82222,24.01386,342394
11150,sarcasticadmin,1,0.00029,82223,24.01415,342394
11151,sarmad-abualkaz,1,0.00029,82224,24.01444,342394
11152,sarunachalam1,1,0.00029,82225,24.01473,342394
11153,sarvan24,1,0.00029,82226,24.01502,342394
11154,sashankavrn,1,0.00029,82227,24.01532,342394
11155,sateekot,1,0.00029,82228,24.01561,342394
11156,sathiralamal,1,0.00029,82229,24.01590,342394
11157,sathya0803,1,0.00029,82230,24.01619,342394
11158,satishbabariya,1,0.00029,82231,24.01648,342394
11159,Saty248,1,0.00029,82232,24.01678,342394
11160,SatyKrish,1,0.00029,82233,24.01707,342394
11161,sauber,1,0.00029,82234,24.01736,342394
11162,saulobejo,1,0.00029,82235,24.01765,342394
11163,saumya2700,1,0.00029,82236,24.01794,342394
11164,saumyaborwankar,1,0.00029,82237,24.01824,342394
11165,saurabh3460,1,0.00029,82238,24.01853,342394
11166,SauravMaheshkar,1,0.00029,82239,24.01882,342394
11167,savez,1,0.00029,82240,24.01911,342394
11168,sav-work,1,0.00029,82241,24.01940,342394
11169,SayaliAsh,1,0.00029,82242,24.01970,342394
11170,SayHelloGsx,1,0.00029,82243,24.01999,342394
11171,sbasu31,1,0.00029,82244,24.02028,342394
11172,sbkg0002,1,0.00029,82245,24.02057,342394
11173,sbng,1,0.00029,82246,24.02086,342394
11174,sbollap1,1,0.00029,82247,24.02116,342394
11175,sbrinkerhoff,1,0.00029,82248,24.02145,342394
11176,sbriskin,1,0.00029,82249,24.02174,342394
11177,SButterfly,1,0.00029,82250,24.02203,342394
11178,scalen,1,0.00029,82251,24.02233,342394
11179,scardozos,1,0.00029,82252,24.02262,342394
11180,schecterdamien,1,0.00029,82253,24.02291,342394
11181,scheying,1,0.00029,82254,24.02320,342394
11182,schirevko,1,0.00029,82255,24.02349,342394
11183,schizo99,1,0.00029,82256,24.02379,342394
11184,schlitzered,1,0.00029,82257,24.02408,342394
11185,schmist,1,0.00029,82258,24.02437,342394
11186,schneefisch,1,0.00029,82259,24.02466,342394
11187,schneif2,1,0.00029,82260,24.02495,342394
11188,scibol,1,0.00029,82261,24.02525,342394
11189,Scorito-Dev,1,0.00029,82262,24.02554,342394
11190,scottd018,1,0.00029,82263,24.02583,342394
11191,ScottGuymer,1,0.00029,82264,24.02612,342394
11192,ScrumpyJack,1,0.00029,82265,24.02641,342394
11193,scubakiz,1,0.00029,82266,24.02671,342394
11194,sczhh,1,0.00029,82267,24.02700,342394
11195,sd2020bs,1,0.00029,82268,24.02729,342394
11196,sdickhoven,1,0.00029,82269,24.02758,342394
11197,sdmichelini,1,0.00029,82270,24.02787,342394
11198,seabass-labrax,1,0.00029,82271,24.02817,342394
11199,sean-d,1,0.00029,82272,24.02846,342394
11200,SeanKnight,1,0.00029,82273,24.02875,342394
11201,sean-redmond,1,0.00029,82274,24.02904,342394
11202,seanschade,1,0.00029,82275,24.02933,342394
11203,searKing,1,0.00029,82276,24.02963,342394
11204,sebastianblunt,1,0.00029,82277,24.02992,342394
11205,sebastian-dyroff,1,0.00029,82278,24.03021,342394
11206,SebastianSchuetze,1,0.00029,82279,24.03050,342394
11207,sebedh,1,0.00029,82280,24.03079,342394
11208,sebkraemer,1,0.00029,82281,24.03109,342394
11209,secrashi,1,0.00029,82282,24.03138,342394
11210,sedan07,1,0.00029,82283,24.03167,342394
11211,sedovandrew,1,0.00029,82284,24.03196,342394
11212,seeker,1,0.00029,82285,24.03226,342394
11213,seesharper,1,0.00029,82286,24.03255,342394
11214,Segflow,1,0.00029,82287,24.03284,342394
11215,seishinsha,1,0.00029,82288,24.03313,342394
11216,sekthor,1,0.00029,82289,24.03342,342394
11217,Selin-PDQ,1,0.00029,82290,24.03372,342394
11218,semihokur,1,0.00029,82291,24.03401,342394
11219,semistone,1,0.00029,82292,24.03430,342394
11220,Semmix,1,0.00029,82293,24.03459,342394
11221,semyongera,1,0.00029,82294,24.03488,342394
11222,senpaiSubby,1,0.00029,82295,24.03518,342394
11223,sense-amid-madness,1,0.00029,82296,24.03547,342394
11224,senvardarsemih,1,0.00029,82297,24.03576,342394
11225,serainville,1,0.00029,82298,24.03605,342394
11226,serg-bs,1,0.00029,82299,24.03634,342394
11227,sergeplatonov,1,0.00029,82300,24.03664,342394
11228,sergevs,1,0.00029,82301,24.03693,342394
11229,sergey-shuyskiy,1,0.00029,82302,24.03722,342394
11230,sergioarmgpl,1,0.00029,82303,24.03751,342394
11231,sergiodj,1,0.00029,82304,24.03780,342394
11232,serp777,1,0.00029,82305,24.03810,342394
11233,Servet3131,1,0.00029,82306,24.03839,342394
11234,setchy,1,0.00029,82307,24.03868,342394
11235,Setheck,1,0.00029,82308,24.03897,342394
11236,seungdols,1,0.00029,82309,24.03926,342394
11237,sevennt,1,0.00029,82310,24.03956,342394
11238,sfc-gh-adlee,1,0.00029,82311,24.03985,342394
11239,sgarlick987,1,0.00029,82312,24.04014,342394
11240,sgendrot,1,0.00029,82313,24.04043,342394
11241,sgof1d,1,0.00029,82314,24.04073,342394
11242,sgsh-gh,1,0.00029,82315,24.04102,342394
11243,SGudbrandsson,1,0.00029,82316,24.04131,342394
11244,sguidos,1,0.00029,82317,24.04160,342394
11245,sguillen18,1,0.00029,82318,24.04189,342394
11246,shaaraddalvi,1,0.00029,82319,24.04219,342394
11247,Shabirmean,1,0.00029,82320,24.04248,342394
11248,shadle10,1,0.00029,82321,24.04277,342394
11249,shafanaS,1,0.00029,82322,24.04306,342394
11250,shaggykp,1,0.00029,82323,24.04335,342394
11251,ShaharTrasmitSecurity,1,0.00029,82324,24.04365,342394
11252,shahin-2020,1,0.00029,82325,24.04394,342394
11253,shaj13,1,0.00029,82326,24.04423,342394
11254,shakaib-arif,1,0.00029,82327,24.04452,342394
11255,ShakeelHussain,1,0.00029,82328,24.04481,342394
11256,shalberd,1,0.00029,82329,24.04511,342394
11257,shalver,1,0.00029,82330,24.04540,342394
11258,shameer-vismaya,1,0.00029,82331,24.04569,342394
11259,shane-axiom,1,0.00029,82332,24.04598,342394
11260,shanemcd,1,0.00029,82333,24.04627,342394
11261,Shane-Williamson,1,0.00029,82334,24.04657,342394
11262,shankar524,1,0.00029,82335,24.04686,342394
11263,ShanshLai,1,0.00029,82336,24.04715,342394
11264,shantanugadgil,1,0.00029,82337,24.04744,342394
11265,shantanu-nvidia,1,0.00029,82338,24.04773,342394
11266,shanyuxiyun,1,0.00029,82339,24.04803,342394
11267,shaofeng66,1,0.00029,82340,24.04832,342394
11268,ShaoNianyr,1,0.00029,82341,24.04861,342394
11269,shaoshigood,1,0.00029,82342,24.04890,342394
11270,sharathbana,1,0.00029,82343,24.04919,342394
11271,sharathfeb12,1,0.00029,82344,24.04949,342394
11272,sharkymcdongles,1,0.00029,82345,24.04978,342394
11273,sharma-abhishek2023,1,0.00029,82346,24.05007,342394
11274,sharmakhushboo,1,0.00029,82347,24.05036,342394
11275,sharms,1,0.00029,82348,24.05066,342394
11276,sharon-codefresh,1,0.00029,82349,24.05095,342394
11277,sharpjs,1,0.00029,82350,24.05124,342394
11278,SHarrySeldon,1,0.00029,82351,24.05153,342394
11279,shashankbarsin,1,0.00029,82352,24.05182,342394
11280,ShaunMWallace,1,0.00029,82353,24.05212,342394
11281,shawn-canva,1,0.00029,82354,24.05241,342394
11282,shawnz,1,0.00029,82355,24.05270,342394
11283,Shaybs,1,0.00029,82356,24.05299,342394
11284,shbatm,1,0.00029,82357,24.05328,342394
11285,sheena1537,1,0.00029,82358,24.05358,342394
11286,shenyang1007,1,0.00029,82359,24.05387,342394
11287,shenyyi,1,0.00029,82360,24.05416,342394
11288,sherifabdlnaby,1,0.00029,82361,24.05445,342394
11289,shibataka000,1,0.00029,82362,24.05474,342394
11290,shikeno,1,0.00029,82363,24.05504,342394
11291,Shiko1st,1,0.00029,82364,24.05533,342394
11292,ShineSmile,1,0.00029,82365,24.05562,342394
11293,ShiranAvidov,1,0.00029,82366,24.05591,342394
11294,shivaburade,1,0.00029,82367,24.05620,342394
11295,shivjm,1,0.00029,82368,24.05650,342394
11296,shiyugreat111,1,0.00029,82369,24.05679,342394
11297,shousper,1,0.00029,82370,24.05708,342394
11298,shrac,1,0.00029,82371,24.05737,342394
11299,shreemaan-abhishek,1,0.00029,82372,24.05766,342394
11300,shreep007,1,0.00029,82373,24.05796,342394
11301,shreyasshivakumara,1,0.00029,82374,24.05825,342394
11302,Shrizo,1,0.00029,82375,24.05854,342394
11303,shubb30,1,0.00029,82376,24.05883,342394
11304,shubham-mandhare,1,0.00029,82377,24.05912,342394
11305,shubinmi,1,0.00029,82378,24.05942,342394
11306,shuklaritvik06,1,0.00029,82379,24.05971,342394
11307,shuosiw,1,0.00029,82380,24.06000,342394
11308,shurikg,1,0.00029,82381,24.06029,342394
11309,shwetasahuit,1,0.00029,82382,24.06059,342394
11310,shyam-ks,1,0.00029,82383,24.06088,342394
11311,sibucan,1,0.00029,82384,24.06117,342394
11312,sickboy93,1,0.00029,82385,24.06146,342394
11313,SidAceJog,1,0.00029,82386,24.06175,342394
11314,Sid-Bhatia-0,1,0.00029,82387,24.06205,342394
11315,siddhant-tripathy1,1,0.00029,82388,24.06234,342394
11316,siddharthlal25,1,0.00029,82389,24.06263,342394
11317,SidduAngadi,1,0.00029,82390,24.06292,342394
11318,sid-habu,1,0.00029,82391,24.06321,342394
11319,sidju,1,0.00029,82392,24.06351,342394
11320,sidkris77,1,0.00029,82393,24.06380,342394
11321,sietchcode,1,0.00029,82394,24.06409,342394
11322,sigfridh,1,0.00029,82395,24.06438,342394
11323,sikhlaqu,1,0.00029,82396,24.06467,342394
11324,siku4,1,0.00029,82397,24.06497,342394
11325,silence8013,1,0.00029,82398,24.06526,342394
11326,silverraven691,1,0.00029,82399,24.06555,342394
11327,silvez-dh,1,0.00029,82400,24.06584,342394
11328,SiminMu,1,0.00029,82401,24.06613,342394
11329,simon-an,1,0.00029,82402,24.06643,342394
11330,SimoneLazzaris,1,0.00029,82403,24.06672,342394
11331,Simon-Janos,1,0.00029,82404,24.06701,342394
11332,simonlsk,1,0.00029,82405,24.06730,342394
11333,SimonPrague,1,0.00029,82406,24.06759,342394
11334,SimplyAmuthan,1,0.00029,82407,24.06789,342394
11335,simplylizz,1,0.00029,82408,24.06818,342394
11336,singgel,1,0.00029,82409,24.06847,342394
11337,singhalok00188,1,0.00029,82410,24.06876,342394
11338,singh-skyflow,1,0.00029,82411,24.06905,342394
11339,SinisterLight,1,0.00029,82412,24.06935,342394
11340,sirockin-f3,1,0.00029,82413,24.06964,342394
11341,SITARAM-LAB,1,0.00029,82414,24.06993,342394
11342,sivakolisetti,1,0.00029,82415,24.07022,342394
11343,siwang2011,1,0.00029,82416,24.07052,342394
11344,sixinyiyu,1,0.00029,82417,24.07081,342394
11345,siying,1,0.00029,82418,24.07110,342394
11346,sjakubek,1,0.00029,82419,24.07139,342394
11347,sjamidar,1,0.00029,82420,24.07168,342394
11348,sjkeerthi,1,0.00029,82421,24.07198,342394
11349,skahwaji,1,0.00029,82422,24.07227,342394
11350,Skaronator,1,0.00029,82423,24.07256,342394
11351,skhalidgh,1,0.00029,82424,24.07285,342394
11352,skillcoder,1,0.00029,82425,24.07314,342394
11353,skippetr,1,0.00029,82426,24.07344,342394
11354,skluthe,1,0.00029,82427,24.07373,342394
11355,skogta,1,0.00029,82428,24.07402,342394
11356,skrbug,1,0.00029,82429,24.07431,342394
11357,skumarp7,1,0.00029,82430,24.07460,342394
11358,Skyross,1,0.00029,82431,24.07490,342394
11359,skyzzk,1,0.00029,82432,24.07519,342394
11360,sladg,1,0.00029,82433,24.07548,342394
11361,slapula,1,0.00029,82434,24.07577,342394
11362,slargo,1,0.00029,82435,24.07606,342394
11363,SlashTeen,1,0.00029,82436,24.07636,342394
11364,slaterjon,1,0.00029,82437,24.07665,342394
11365,slaterx,1,0.00029,82438,24.07694,342394
11366,SleepyBrett,1,0.00029,82439,24.07723,342394
11367,slidoooor,1,0.00029,82440,24.07752,342394
11368,Slids,1,0.00029,82441,24.07782,342394
11369,slienard,1,0.00029,82442,24.07811,342394
11370,slnt,1,0.00029,82443,24.07840,342394
11371,slomo28,1,0.00029,82444,24.07869,342394
11372,slonopotamus,1,0.00029,82445,24.07899,342394
11373,slothjun,1,0.00029,82446,24.07928,342394
11374,SlothLazybones,1,0.00029,82447,24.07957,342394
11375,slovdahl,1,0.00029,82448,24.07986,342394
11376,slushysnowman,1,0.00029,82449,24.08015,342394
11377,smallc2009,1,0.00029,82450,24.08045,342394
11378,smaruni-BRONGA,1,0.00029,82451,24.08074,342394
11379,s-matyukevich,1,0.00029,82452,24.08103,342394
11380,Smaug123,1,0.00029,82453,24.08132,342394
11381,Smerity,1,0.00029,82454,24.08161,342394
11382,smills24,1,0.00029,82455,24.08191,342394
11383,smitphilip,1,0.00029,82456,24.08220,342394
11384,smsohan,1,0.00029,82457,24.08249,342394
11385,smyrman,1,0.00029,82458,24.08278,342394
11386,snag9032,1,0.00029,82459,24.08307,342394
11387,snagasawa,1,0.00029,82460,24.08337,342394
11388,snehalgawade23,1,0.00029,82461,24.08366,342394
11389,snnsnn,1,0.00029,82462,24.08395,342394
11390,snoord,1,0.00029,82463,24.08424,342394
11391,SnowyTerror,1,0.00029,82464,24.08453,342394
11392,so2liu,1,0.00029,82465,24.08483,342394
11393,soanni,1,0.00029,82466,24.08512,342394
11394,sober-wang,1,0.00029,82467,24.08541,342394
11395,Sobuno,1,0.00029,82468,24.08570,342394
11396,sochoaAtMulesoft,1,0.00029,82469,24.08599,342394
11397,socketwench,1,0.00029,82470,24.08629,342394
11398,SoerenHenning,1,0.00029,82471,24.08658,342394
11399,sogos,1,0.00029,82472,24.08687,342394
11400,soham117,1,0.00029,82473,24.08716,342394
11401,soharang,1,0.00029,82474,24.08745,342394
11402,sohrabkhan,1,0.00029,82475,24.08775,342394
11403,Sokal21,1,0.00029,82476,24.08804,342394
11404,Sokratis1904,1,0.00029,82477,24.08833,342394
11405,solarist,1,0.00029,82478,24.08862,342394
11406,sol-lee,1,0.00029,82479,24.08892,342394
11407,solms,1,0.00029,82480,24.08921,342394
11408,solohsu,1,0.00029,82481,24.08950,342394
11409,solomax,1,0.00029,82482,24.08979,342394
11410,solo-yolo,1,0.00029,82483,24.09008,342394
11411,somejavadev,1,0.00029,82484,24.09038,342394
11412,somematon,1,0.00029,82485,24.09067,342394
11413,sonalkr132,1,0.00029,82486,24.09096,342394
11414,sonic-martin,1,0.00029,82487,24.09125,342394
11415,soniyaprasad77,1,0.00029,82488,24.09154,342394
11416,son-la,1,0.00029,82489,24.09184,342394
11417,sonujose,1,0.00029,82490,24.09213,342394
11418,sooranatesh,1,0.00029,82491,24.09242,342394
11419,soosap,1,0.00029,82492,24.09271,342394
11420,sophalHong,1,0.00029,82493,24.09300,342394
11421,sophia0898,1,0.00029,82494,24.09330,342394
11422,Sophia60,1,0.00029,82495,24.09359,342394
11423,sophiewigmore,1,0.00029,82496,24.09388,342394
11424,sopos,1,0.00029,82497,24.09417,342394
11425,sora-kashiwagi,1,0.00029,82498,24.09446,342394
11426,sorushsaghari,1,0.00029,82499,24.09476,342394
11427,sotiriougeorge,1,0.00029,82500,24.09505,342394
11428,souchprod,1,0.00029,82501,24.09534,342394
11429,soulfy,1,0.00029,82502,24.09563,342394
11430,soumeng09,1,0.00029,82503,24.09592,342394
11431,soumiksamanta,1,0.00029,82504,24.09622,342394
11432,SoumithKumarMudugonda,1,0.00029,82505,24.09651,342394
11433,souris-dev,1,0.00029,82506,24.09680,342394
11434,sowmiya1005,1,0.00029,82507,24.09709,342394
11435,Spareo,1,0.00029,82508,24.09738,342394
11436,sparkpool,1,0.00029,82509,24.09768,342394
11437,spectro30,1,0.00029,82510,24.09797,342394
11438,Speedkore,1,0.00029,82511,24.09826,342394
11439,spencerdillard,1,0.00029,82512,24.09855,342394
11440,Spenhouet,1,0.00029,82513,24.09885,342394
11441,spiliopoulos,1,0.00029,82514,24.09914,342394
11442,spiritman1990,1,0.00029,82515,24.09943,342394
11443,Spiroman,1,0.00029,82516,24.09972,342394
11444,spjspjspj,1,0.00029,82517,24.10001,342394
11445,spoonysnail,1,0.00029,82518,24.10031,342394
11446,sprezzarete,1,0.00029,82519,24.10060,342394
11447,Spybull,1,0.00029,82520,24.10089,342394
11448,sqqqrly,1,0.00029,82521,24.10118,342394
11449,Squadrick,1,0.00029,82522,24.10147,342394
11450,sravimohan,1,0.00029,82523,24.10177,342394
11451,srd90,1,0.00029,82524,24.10206,342394
11452,Sreddy-gs,1,0.00029,82525,24.10235,342394
11453,sremp,1,0.00029,82526,24.10264,342394
11454,SridharRamamoorthy,1,0.00029,82527,24.10293,342394
11455,srinandan,1,0.00029,82528,24.10323,342394
11456,Srinivas-Karre,1,0.00029,82529,24.10352,342394
11457,srnbckr,1,0.00029,82530,24.10381,342394
11458,Srsnik,1,0.00029,82531,24.10410,342394
11459,srstack,1,0.00029,82532,24.10439,342394
11460,srvRoy,1,0.00029,82533,24.10469,342394
11461,ssathasivan,1,0.00029,82534,24.10498,342394
11462,sseetharaman6,1,0.00029,82535,24.10527,342394
11463,ssidhu-apm,1,0.00029,82536,24.10556,342394
11464,s-silvius,1,0.00029,82537,24.10585,342394
11465,ssm3ll,1,0.00029,82538,24.10615,342394
11466,ssnijik,1,0.00029,82539,24.10644,342394
11467,ssplatt,1,0.00029,82540,24.10673,342394
11468,s-takehana,1,0.00029,82541,24.10702,342394
11469,stalb,1,0.00029,82542,24.10731,342394
11470,stalkerg,1,0.00029,82543,24.10761,342394
11471,Stalkker,1,0.00029,82544,24.10790,342394
11472,stanguturi,1,0.00029,82545,24.10819,342394
11473,staniondaniel,1,0.00029,82546,24.10848,342394
11474,stanvit,1,0.00029,82547,24.10878,342394
11475,StarAurryon,1,0.00029,82548,24.10907,342394
11476,starkmatt,1,0.00029,82549,24.10936,342394
11477,Starrah,1,0.00029,82550,24.10965,342394
11478,Startouf,1,0.00029,82551,24.10994,342394
11479,staticfinal,1,0.00029,82552,24.11024,342394
11480,ST-DDT,1,0.00029,82553,24.11053,342394
11481,steeling,1,0.00029,82554,24.11082,342394
11482,steepestascent,1,0.00029,82555,24.11111,342394
11483,steephan-s1,1,0.00029,82556,24.11140,342394
11484,stefanandres,1,0.00029,82557,24.11170,342394
11485,stefanJ-hub,1,0.00029,82558,24.11199,342394
11486,steffan-westcott,1,0.00029,82559,24.11228,342394
11487,StefH,1,0.00029,82560,24.11257,342394
11488,steijgeler,1,0.00029,82561,24.11286,342394
11489,steinmb,1,0.00029,82562,24.11316,342394
11490,stempher,1,0.00029,82563,24.11345,342394
11491,stenwolf,1,0.00029,82564,24.11374,342394
11492,StepanKuksenko,1,0.00029,82565,24.11403,342394
11493,stephanmiehe,1,0.00029,82566,24.11432,342394
11494,stephencoe,1,0.00029,82567,24.11462,342394
11495,StephenHodgson,1,0.00029,82568,24.11491,342394
11496,stephenpope,1,0.00029,82569,24.11520,342394
11497,Steuf,1,0.00029,82570,24.11549,342394
11498,StevenBarre,1,0.00029,82571,24.11578,342394
11499,stevenbressey,1,0.00029,82572,24.11608,342394
11500,StevenCaswellVR,1,0.00029,82573,24.11637,342394
11501,StevenTCramer,1,0.00029,82574,24.11666,342394
11502,stevenwang1,1,0.00029,82575,24.11695,342394
11503,stevyn81,1,0.00029,82576,24.11725,342394
11504,StiviiK,1,0.00029,82577,24.11754,342394
11505,stliu,1,0.00029,82578,24.11783,342394
11506,stl-victor-sudakov,1,0.00029,82579,24.11812,342394
11507,stonepd,1,0.00029,82580,24.11841,342394
11508,stone-z,1,0.00029,82581,24.11871,342394
11509,stowel,1,0.00029,82582,24.11900,342394
11510,StoyanStAtanasov,1,0.00029,82583,24.11929,342394
11511,str4d,1,0.00029,82584,24.11958,342394
11512,strh5523,1,0.00029,82585,24.11987,342394
11513,stromnet,1,0.00029,82586,24.12017,342394
11514,strudelPi,1,0.00029,82587,24.12046,342394
11515,stuart-blackler-cko,1,0.00029,82588,24.12075,342394
11516,sturfee-petrl,1,0.00029,82589,24.12104,342394
11517,Stuxend,1,0.00029,82590,24.12133,342394
11518,stvnwrgs,1,0.00029,82591,24.12163,342394
11519,sudeep-ib,1,0.00029,82592,24.12192,342394
11520,sudheerpodila,1,0.00029,82593,24.12221,342394
11521,sudip004,1,0.00029,82594,24.12250,342394
11522,sudipju,1,0.00029,82595,24.12279,342394
11523,sudopablosilva,1,0.00029,82596,24.12309,342394
11524,sujairamprasathc,1,0.00029,82597,24.12338,342394
11525,sukumarp2020,1,0.00029,82598,24.12367,342394
11526,SumanthDatta-Kony,1,0.00029,82599,24.12396,342394
11527,sumantripuraneni,1,0.00029,82600,24.12425,342394
11528,sumitaneja,1,0.00029,82601,24.12455,342394
11529,summylight,1,0.00029,82602,24.12484,342394
11530,sunidhi121,1,0.00029,82603,24.12513,342394
11531,sunielm7,1,0.00029,82604,24.12542,342394
11532,Sunil-Jacob,1,0.00029,82605,24.12571,342394
11533,sunilkumar789,1,0.00029,82606,24.12601,342394
11534,suning2012,1,0.00029,82607,24.12630,342394
11535,sunkadavar,1,0.00029,82608,24.12659,342394
11536,SunnyFenng,1,0.00029,82609,24.12688,342394
11537,sunqb,1,0.00029,82610,24.12718,342394
11538,super1t,1,0.00029,82611,24.12747,342394
11539,superff,1,0.00029,82612,24.12776,342394
11540,superma58,1,0.00029,82613,24.12805,342394
11541,supermanhuyu,1,0.00029,82614,24.12834,342394
11542,SupornoChaudhury,1,0.00029,82615,24.12864,342394
11543,SupRenekton,1,0.00029,82616,24.12893,342394
11544,surajmachamasi,1,0.00029,82617,24.12922,342394
11545,suryatech27-cloud,1,0.00029,82618,24.12951,342394
11546,sushilalert,1,0.00029,82619,24.12980,342394
11547,susnux,1,0.00029,82620,24.13010,342394
11548,SvenMW,1,0.00029,82621,24.13039,342394
11549,sversienti,1,0.00029,82622,24.13068,342394
11550,SwadhinMangaraj,1,0.00029,82623,24.13097,342394
11551,swananddh,1,0.00029,82624,24.13126,342394
11552,swapkh91,1,0.00029,82625,24.13156,342394
11553,swapnilpotnis,1,0.00029,82626,24.13185,342394
11554,SwarajShekhar,1,0.00029,82627,24.13214,342394
11555,SWDevAngel,1,0.00029,82628,24.13243,342394
11556,swetharavichandran03,1,0.00029,82629,24.13272,342394
11557,swetharnaik,1,0.00029,82630,24.13302,342394
11558,SWilliamsOteemo,1,0.00029,82631,24.13331,342394
11559,swjun69,1,0.00029,82632,24.13360,342394
11560,swoop-admin,1,0.00029,82633,24.13389,342394
11561,sxt26,1,0.00029,82634,24.13418,342394
11562,sxyandapp,1,0.00029,82635,24.13448,342394
11563,Symbianx,1,0.00029,82636,24.13477,342394
11564,SymbioticKilla,1,0.00029,82637,24.13506,342394
11565,SympleSynz,1,0.00029,82638,24.13535,342394
11566,Syntax3rror404,1,0.00029,82639,24.13564,342394
11567,systemtrap,1,0.00029,82640,24.13594,342394
11568,szediktam,1,0.00029,82641,24.13623,342394
11569,szy441687879,1,0.00029,82642,24.13652,342394
11570,t00350320,1,0.00029,82643,24.13681,342394
11571,T0T4R4,1,0.00029,82644,24.13711,342394
11572,ta924,1,0.00029,82645,24.13740,342394
11573,tacf,1,0.00029,82646,24.13769,342394
11574,TachunLin,1,0.00029,82647,24.13798,342394
11575,TacoNaco47,1,0.00029,82648,24.13827,342394
11576,taehioum,1,0.00029,82649,24.13857,342394
11577,tafkam,1,0.00029,82650,24.13886,342394
11578,tahacodes,1,0.00029,82651,24.13915,342394
11579,tain198127,1,0.00029,82652,24.13944,342394
11580,taislapta,1,0.00029,82653,24.13973,342394
11581,takotakot,1,0.00029,82654,24.14003,342394
11582,taku333,1,0.00029,82655,24.14032,342394
11583,talcoh2x,1,0.00029,82656,24.14061,342394
11584,talentrydev,1,0.00029,82657,24.14090,342394
11585,taliesins,1,0.00029,82658,24.14119,342394
11586,Talkapon,1,0.00029,82659,24.14149,342394
11587,talshmuli,1,0.00029,82660,24.14178,342394
11588,TalZiv,1,0.00029,82661,24.14207,342394
11589,tamirhad,1,0.00029,82662,24.14236,342394
11590,Tammy-kunyu,1,0.00029,82663,24.14265,342394
11591,tanguyantoine,1,0.00029,82664,24.14295,342394
11592,tang-william,1,0.00029,82665,24.14324,342394
11593,tangxueming,1,0.00029,82666,24.14353,342394
11594,tan-i-ham,1,0.00029,82667,24.14382,342394
11595,tantweiler,1,0.00029,82668,24.14411,342394
11596,tanwarsatya,1,0.00029,82669,24.14441,342394
11597,tarasbsbr,1,0.00029,82670,24.14470,342394
11598,tara-superapplets,1,0.00029,82671,24.14499,342394
11599,TaroSunn,1,0.00029,82672,24.14528,342394
11600,tarreislam,1,0.00029,82673,24.14557,342394
11601,tarrenj,1,0.00029,82674,24.14587,342394
11602,tarun4279,1,0.00029,82675,24.14616,342394
11603,TattdCodeMonkey,1,0.00029,82676,24.14645,342394
11604,tavin,1,0.00029,82677,24.14674,342394
11605,TBurda,1,0.00029,82678,24.14704,342394
11606,t-cas,1,0.00029,82679,24.14733,342394
11607,tcassaert,1,0.00029,82680,24.14762,342394
11608,tcellucci,1,0.00029,82681,24.14791,342394
11609,tcheronneau,1,0.00029,82682,24.14820,342394
11610,tclarke,1,0.00029,82683,24.14850,342394
11611,tcoatale,1,0.00029,82684,24.14879,342394
11612,tdashton,1,0.00029,82685,24.14908,342394
11613,TDavid2509,1,0.00029,82686,24.14937,342394
11614,tdewin,1,0.00029,82687,24.14966,342394
11615,tdm4,1,0.00029,82688,24.14996,342394
11616,tdyas,1,0.00029,82689,24.15025,342394
11617,teamzz111,1,0.00029,82690,24.15054,342394
11618,techjacker,1,0.00029,82691,24.15083,342394
11619,techknowlogick,1,0.00029,82692,24.15112,342394
11620,techmunk,1,0.00029,82693,24.15142,342394
11621,technotaff-nbs,1,0.00029,82694,24.15171,342394
11622,techpavan,1,0.00029,82695,24.15200,342394
11623,tedlean,1,0.00029,82696,24.15229,342394
11624,tehho,1,0.00029,82697,24.15258,342394
11625,tehKapa,1,0.00029,82698,24.15288,342394
11626,tehmoth,1,0.00029,82699,24.15317,342394
11627,TeHSiGGi,1,0.00029,82700,24.15346,342394
11628,tejunior,1,0.00029,82701,24.15375,342394
11629,Temikus,1,0.00029,82702,24.15404,342394
11630,Tendo-Jukkudo,1,0.00029,82703,24.15434,342394
11631,Tendrun101,1,0.00029,82704,24.15463,342394
11632,tengfeisun,1,0.00029,82705,24.15492,342394
11633,TeodoraBoros,1,0.00029,82706,24.15521,342394
11634,teodora-sandu,1,0.00029,82707,24.15551,342394
11635,terrafying,1,0.00029,82708,24.15580,342394
11636,teru01,1,0.00029,82709,24.15609,342394
11637,test-test-max,1,0.00029,82710,24.15638,342394
11638,tetienne,1,0.00029,82711,24.15667,342394
11639,tewner,1,0.00029,82712,24.15697,342394
11640,texasbobs,1,0.00029,82713,24.15726,342394
11641,tfenster,1,0.00029,82714,24.15755,342394
11642,tguenneguez,1,0.00029,82715,24.15784,342394
11643,TGuimbert,1,0.00029,82716,24.15813,342394
11644,tgwallenborg,1,0.00029,82717,24.15843,342394
11645,thalesfsp,1,0.00029,82718,24.15872,342394
11646,thangdinh1298,1,0.00029,82719,24.15901,342394
11647,thannaske,1,0.00029,82720,24.15930,342394
11648,thanosd,1,0.00029,82721,24.15959,342394
11649,Tharun-Sabbu,1,0.00029,82722,24.15989,342394
11650,ThatAIXGuy,1,0.00029,82723,24.16018,342394
11651,theadisoni,1,0.00029,82724,24.16047,342394
11652,theag3nt,1,0.00029,82725,24.16076,342394
11653,theartusz,1,0.00029,82726,24.16105,342394
11654,TheDiveO,1,0.00029,82727,24.16135,342394
11655,TheFlase,1,0.00029,82728,24.16164,342394
11656,thegalah,1,0.00029,82729,24.16193,342394
11657,thegreymatter,1,0.00029,82730,24.16222,342394
11658,TheHett,1,0.00029,82731,24.16251,342394
11659,thehh1974,1,0.00029,82732,24.16281,342394
11660,thejacer87,1,0.00029,82733,24.16310,342394
11661,TheJohny,1,0.00029,82734,24.16339,342394
11662,TheLunaticScripter,1,0.00029,82735,24.16368,342394
11663,therapy-lf,1,0.00029,82736,24.16397,342394
11664,therzv,1,0.00029,82737,24.16427,342394
11665,TheSaw,1,0.00029,82738,24.16456,342394
11666,thetruechar,1,0.00029,82739,24.16485,342394
11667,thg-adamdean,1,0.00029,82740,24.16514,342394
11668,Thiago-Dantas,1,0.00029,82741,24.16544,342394
11669,thiagooqueiroz86,1,0.00029,82742,24.16573,342394
11670,thiguetta,1,0.00029,82743,24.16602,342394
11671,thimasan,1,0.00029,82744,24.16631,342394
11672,thinkbeforecoding,1,0.00029,82745,24.16660,342394
11673,ThisIsNotTheUserYouAreLookingFor,1,0.00029,82746,24.16690,342394
11674,thislyc,1,0.00029,82747,24.16719,342394
11675,thiwatx33,1,0.00029,82748,24.16748,342394
11676,thomasAtSNCF,1,0.00029,82749,24.16777,342394
11677,ThomasP1988,1,0.00029,82750,24.16806,342394
11678,thomaspaulin,1,0.00029,82751,24.16836,342394
11679,ThomasSteinbach,1,0.00029,82752,24.16865,342394
11680,ThomasVitale,1,0.00029,82753,24.16894,342394
11681,thomathom,1,0.00029,82754,24.16923,342394
11682,Thor77,1,0.00029,82755,24.16952,342394
11683,thoraxe,1,0.00029,82756,24.16982,342394
11684,thorenled,1,0.00029,82757,24.17011,342394
11685,ThSchrad,1,0.00029,82758,24.17040,342394
11686,Thumbiceq,1,0.00029,82759,24.17069,342394
11687,tiagokrebs,1,0.00029,82760,24.17098,342394
11688,tianjie1168,1,0.00029,82761,24.17128,342394
11689,tianlala,1,0.00029,82762,24.17157,342394
11690,tianzichenone,1,0.00029,82763,24.17186,342394
11691,tiarly,1,0.00029,82764,24.17215,342394
11692,tibz-enex,1,0.00029,82765,24.17244,342394
11693,tien1214,1,0.00029,82766,24.17274,342394
11694,tienle,1,0.00029,82767,24.17303,342394
11695,TigerC10,1,0.00029,82768,24.17332,342394
11696,tillig,1,0.00029,82769,24.17361,342394
11697,tim37021,1,0.00029,82770,24.17390,342394
11698,timcosta,1,0.00029,82771,24.17420,342394
11699,timeswind,1,0.00029,82772,24.17449,342394
11700,timmilesdw,1,0.00029,82773,24.17478,342394
11701,timmyers,1,0.00029,82774,24.17507,342394
11702,timofey-barmin,1,0.00029,82775,24.17537,342394
11703,timsanwald,1,0.00029,82776,24.17566,342394
11704,timw8890,1,0.00029,82777,24.17595,342394
11705,tinder-yukisawa,1,0.00029,82778,24.17624,342394
11706,Tinkesh-Kumar,1,0.00029,82779,24.17653,342394
11707,tinomthomas,1,0.00029,82780,24.17683,342394
11708,tiny-x,1,0.00029,82781,24.17712,342394
11709,tinyzimmer,1,0.00029,82782,24.17741,342394
11710,tippl,1,0.00029,82783,24.17770,342394
11711,TiraTom,1,0.00029,82784,24.17799,342394
11712,tirkarthi,1,0.00029,82785,24.17829,342394
11713,Tishka17,1,0.00029,82786,24.17858,342394
11714,titansmc,1,0.00029,82787,24.17887,342394
11715,tiwarisuraj9,1,0.00029,82788,24.17916,342394
11716,tjchambers,1,0.00029,82789,24.17945,342394
11717,tjconcept,1,0.00029,82790,24.17975,342394
11718,TJDjchao,1,0.00029,82791,24.18004,342394
11719,Tjhayhay,1,0.00029,82792,24.18033,342394
11720,tjkirch,1,0.00029,82793,24.18062,342394
11721,tkatkov,1,0.00029,82794,24.18091,342394
11722,tkmdenis,1,0.00029,82795,24.18121,342394
11723,tk-xiong,1,0.00029,82796,24.18150,342394
11724,tlitke5,1,0.00029,82797,24.18179,342394
11725,tlmcphillips,1,0.00029,82798,24.18208,342394
11726,tmihalac,1,0.00029,82799,24.18237,342394
11727,tmorin,1,0.00029,82800,24.18267,342394
11728,tmorrisonsfx,1,0.00029,82801,24.18296,342394
11729,tmotley,1,0.00029,82802,24.18325,342394
11730,tmpbook,1,0.00029,82803,24.18354,342394
11731,tmrekk121,1,0.00029,82804,24.18383,342394
11732,tnet-ag,1,0.00029,82805,24.18413,342394
11733,tnevolin,1,0.00029,82806,24.18442,342394
11734,to266,1,0.00029,82807,24.18471,342394
11735,tobiasf88,1,0.00029,82808,24.18500,342394
11736,TobiasGoerke,1,0.00029,82809,24.18530,342394
11737,TobiMichael96,1,0.00029,82810,24.18559,342394
11738,toddtomkinson,1,0.00029,82811,24.18588,342394
11739,todeb,1,0.00029,82812,24.18617,342394
11740,tof1a,1,0.00029,82813,24.18646,342394
11741,tokt,1,0.00029,82814,24.18676,342394
11742,tolik505,1,0.00029,82815,24.18705,342394
11743,Tolsto,1,0.00029,82816,24.18734,342394
11744,tomalexander,1,0.00029,82817,24.18763,342394
11745,TomA-R,1,0.00029,82818,24.18792,342394
11746,tomasbasham,1,0.00029,82819,24.18822,342394
11747,tomasholicky,1,0.00029,82820,24.18851,342394
11748,tomas-k-mall,1,0.00029,82821,24.18880,342394
11749,TomasLongo,1,0.00029,82822,24.18909,342394
11750,tomaso,1,0.00029,82823,24.18938,342394
11751,tomasol,1,0.00029,82824,24.18968,342394
11752,tomaswarynyca,1,0.00029,82825,24.18997,342394
11753,tomasz-polgrabia,1,0.00029,82826,24.19026,342394
11754,tomer1983,1,0.00029,82827,24.19055,342394
11755,TomerFi,1,0.00029,82828,24.19084,342394
11756,tomes92,1,0.00029,82829,24.19114,342394
11757,tomhobson,1,0.00029,82830,24.19143,342394
11758,tomkcpr,1,0.00029,82831,24.19172,342394
11759,TomKrauss,1,0.00029,82832,24.19201,342394
11760,tom-mayer,1,0.00029,82833,24.19230,342394
11761,TomMD,1,0.00029,82834,24.19260,342394
11762,Tommy74,1,0.00029,82835,24.19289,342394
11763,Tommy95271,1,0.00029,82836,24.19318,342394
11764,tommyang,1,0.00029,82837,24.19347,342394
11765,tommylindgren-plejd,1,0.00029,82838,24.19377,342394
11766,tommyo,1,0.00029,82839,24.19406,342394
11767,tomoyamachi,1,0.00029,82840,24.19435,342394
11768,tomqwpl,1,0.00029,82841,24.19464,342394
11769,tomruttle,1,0.00029,82842,24.19493,342394
11770,tomtrapp,1,0.00029,82843,24.19523,342394
11771,TongX123,1,0.00029,82844,24.19552,342394
11772,tonyaw,1,0.00029,82845,24.19581,342394
11773,toomone,1,0.00029,82846,24.19610,342394
11774,topsterde,1,0.00029,82847,24.19639,342394
11775,torbendury,1,0.00029,82848,24.19669,342394
11776,torgeirl,1,0.00029,82849,24.19698,342394
11777,tormath1,1,0.00029,82850,24.19727,342394
11778,toroy,1,0.00029,82851,24.19756,342394
11779,torsrex,1,0.00029,82852,24.19785,342394
11780,totemofwolf,1,0.00029,82853,24.19815,342394
11781,towasz,1,0.00029,82854,24.19844,342394
11782,toyaser,1,0.00029,82855,24.19873,342394
11783,tporeba,1,0.00029,82856,24.19902,342394
11784,tracypholmes,1,0.00029,82857,24.19931,342394
11785,tradcliffe-expediagroup,1,0.00029,82858,24.19961,342394
11786,trajakovic,1,0.00029,82859,24.19990,342394
11787,trallnag,1,0.00029,82860,24.20019,342394
11788,TrAnn3l,1,0.00029,82861,24.20048,342394
11789,TrashCoder96,1,0.00029,82862,24.20077,342394
11790,travnewmatic,1,0.00029,82863,24.20107,342394
11791,Treiblesschorle,1,0.00029,82864,24.20136,342394
11792,treid314,1,0.00029,82865,24.20165,342394
11793,trevorboydsmith,1,0.00029,82866,24.20194,342394
11794,trevor-dialpad,1,0.00029,82867,24.20223,342394
11795,trevrosen,1,0.00029,82868,24.20253,342394
11796,trey03,1,0.00029,82869,24.20282,342394
11797,trissanen,1,0.00029,82870,24.20311,342394
11798,TrooperT,1,0.00029,82871,24.20340,342394
11799,trotyoung,1,0.00029,82872,24.20370,342394
11800,trysetnull,1,0.00029,82873,24.20399,342394
11801,tsalzinger,1,0.00029,82874,24.20428,342394
11802,TSASM,1,0.00029,82875,24.20457,342394
11803,tschirmer,1,0.00029,82876,24.20486,342394
11804,tsjk,1,0.00029,82877,24.20516,342394
11805,tsjohns9,1,0.00029,82878,24.20545,342394
11806,tskiridomova,1,0.00029,82879,24.20574,342394
11807,tsurog,1,0.00029,82880,24.20603,342394
11808,tszysong,1,0.00029,82881,24.20632,342394
11809,ttanay,1,0.00029,82882,24.20662,342394
11810,ttonyh,1,0.00029,82883,24.20691,342394
11811,ttpp123,1,0.00029,82884,24.20720,342394
11812,ttsakpc,1,0.00029,82885,24.20749,342394
11813,ttsokov,1,0.00029,82886,24.20778,342394
11814,tttoad,1,0.00029,82887,24.20808,342394
11815,tuatara73,1,0.00029,82888,24.20837,342394
11816,tulanian,1,0.00029,82889,24.20866,342394
11817,tumbl3w33d,1,0.00029,82890,24.20895,342394
11818,tunoi,1,0.00029,82891,24.20924,342394
11819,turtlesoupy,1,0.00029,82892,24.20954,342394
11820,Tusharbeginner,1,0.00029,82893,24.20983,342394
11821,tutububug,1,0.00029,82894,24.21012,342394
11822,tuvikene,1,0.00029,82895,24.21041,342394
11823,tuxdevnow,1,0.00029,82896,24.21070,342394
11824,tvaintrob,1,0.00029,82897,24.21100,342394
11825,twix14,1,0.00029,82898,24.21129,342394
11826,TwoStone,1,0.00029,82899,24.21158,342394
11827,tycooon,1,0.00029,82900,24.21187,342394
11828,tyen-brex,1,0.00029,82901,24.21216,342394
11829,tylerforaie,1,0.00029,82902,24.21246,342394
11830,tynril,1,0.00029,82903,24.21275,342394
11831,tyxia,1,0.00029,82904,24.21304,342394
11832,tzakrajs,1,0.00029,82905,24.21333,342394
11833,tzneal,1,0.00029,82906,24.21363,342394
11834,u8sand,1,0.00029,82907,24.21392,342394
11835,uberspot,1,0.00029,82908,24.21421,342394
11836,ubhide,1,0.00029,82909,24.21450,342394
11837,uchiha-itachi95,1,0.00029,82910,24.21479,342394
11838,UchihaVeha,1,0.00029,82911,24.21509,342394
11839,ucloudhsl,1,0.00029,82912,24.21538,342394
11840,uderik,1,0.00029,82913,24.21567,342394
11841,uGiFarukh,1,0.00029,82914,24.21596,342394
11842,uglthinx,1,0.00029,82915,24.21625,342394
11843,ugurarpaci,1,0.00029,82916,24.21655,342394
11844,ugurcemozturk,1,0.00029,82917,24.21684,342394
11845,ukpbz,1,0.00029,82918,24.21713,342394
11846,Ulicong,1,0.00029,82919,24.21742,342394
11847,ultra-baba,1,0.00029,82920,24.21771,342394
11848,um3ggh1u,1,0.00029,82921,24.21801,342394
11849,umarkhan17,1,0.00029,82922,24.21830,342394
11850,unb9rn,1,0.00029,82923,24.21859,342394
11851,unbyte,1,0.00029,82924,24.21888,342394
11852,Unix4ever,1,0.00029,82925,24.21917,342394
11853,unkn0wnnnnnn,1,0.00029,82926,24.21947,342394
11854,unleashed,1,0.00029,82927,24.21976,342394
11855,Uranium2,1,0.00029,82928,24.22005,342394
11856,urashidmalik,1,0.00029,82929,24.22034,342394
11857,urpyLLIKa,1,0.00029,82930,24.22063,342394
11858,urwah1996,1,0.00029,82931,24.22093,342394
11859,usernamehw,1,0.00029,82932,24.22122,342394
11860,ushuz,1,0.00029,82933,24.22151,342394
11861,usrlocalang,1,0.00029,82934,24.22180,342394
11862,ustaerk,1,0.00029,82935,24.22210,342394
11863,utkarsh-devops,1,0.00029,82936,24.22239,342394
11864,uttamanand-whs,1,0.00029,82937,24.22268,342394
11865,v3n,1,0.00029,82938,24.22297,342394
11866,v4nRutt3n,1,0.00029,82939,24.22326,342394
11867,vadimzharov,1,0.00029,82940,24.22356,342394
11868,vaibsharma,1,0.00029,82941,24.22385,342394
11869,vainu-lauri,1,0.00029,82942,24.22414,342394
11870,valdisiljuconoks,1,0.00029,82943,24.22443,342394
11871,valentinschabschneideratdw,1,0.00029,82944,24.22472,342394
11872,valiaga,1,0.00029,82945,24.22502,342394
11873,vallamost,1,0.00029,82946,24.22531,342394
11874,valumar,1,0.00029,82947,24.22560,342394
11875,valxv,1,0.00029,82948,24.22589,342394
11876,vamshi-aruru,1,0.00029,82949,24.22618,342394
11877,vanko1987,1,0.00029,82950,24.22648,342394
11878,VanyoMihaylov,1,0.00029,82951,24.22677,342394
11879,varesa,1,0.00029,82952,24.22706,342394
11880,Varindaa,1,0.00029,82953,24.22735,342394
11881,varunrsystems,1,0.00029,82954,24.22764,342394
11882,varunsh-xilinx,1,0.00029,82955,24.22794,342394
11883,varun-vyas,1,0.00029,82956,24.22823,342394
11884,vashisthabhinav,1,0.00029,82957,24.22852,342394
11885,vasily-v-ryabov,1,0.00029,82958,24.22881,342394
11886,vasim38,1,0.00029,82959,24.22910,342394
11887,vatine,1,0.00029,82960,24.22940,342394
11888,vauchok,1,0.00029,82961,24.22969,342394
11889,vbasem,1,0.00029,82962,24.22998,342394
11890,v-byte-cpu,1,0.00029,82963,24.23027,342394
11891,vdellaglio,1,0.00029,82964,24.23056,342394
11892,vdwees,1,0.00029,82965,24.23086,342394
11893,veezhang,1,0.00029,82966,24.23115,342394
11894,vegazmaoning,1,0.00029,82967,24.23144,342394
11895,velann21,1,0.00029,82968,24.23173,342394
11896,velizmiguel,1,0.00029,82969,24.23203,342394
11897,Velociraptor85,1,0.00029,82970,24.23232,342394
11898,velothump,1,0.00029,82971,24.23261,342394
11899,velykanov,1,0.00029,82972,24.23290,342394
11900,vemireddy-vaibhav,1,0.00029,82973,24.23319,342394
11901,VengefulAncient,1,0.00029,82974,24.23349,342394
11902,veonua,1,0.00029,82975,24.23378,342394
11903,vepo,1,0.00029,82976,24.23407,342394
11904,verbotenj,1,0.00029,82977,24.23436,342394
11905,verdinjoshua1982,1,0.00029,82978,24.23465,342394
11906,veromos,1,0.00029,82979,24.23495,342394
11907,vetalslepak,1,0.00029,82980,24.23524,342394
11908,vgjm,1,0.00029,82981,24.23553,342394
11909,vguaglione,1,0.00029,82982,24.23582,342394
11910,vicky-liu,1,0.00029,82983,24.23611,342394
11911,victordiezvera,1,0.00029,82984,24.23641,342394
11912,victorgomes,1,0.00029,82985,24.23670,342394
11913,victorpalmeida,1,0.00029,82986,24.23699,342394
11914,victorvw,1,0.00029,82987,24.23728,342394
11915,vidhem-indeed,1,0.00029,82988,24.23757,342394
11916,vidhyasagar7,1,0.00029,82989,24.23787,342394
11917,vignesh-goutham,1,0.00029,82990,24.23816,342394
11918,Vijay-git-kub,1,0.00029,82991,24.23845,342394
11919,vij-code,1,0.00029,82992,24.23874,342394
11920,Vikas-Tamboli,1,0.00029,82993,24.23903,342394
11921,vikomte,1,0.00029,82994,24.23933,342394
11922,Vikramk780,1,0.00029,82995,24.23962,342394
11923,vikramsh2002,1,0.00029,82996,24.23991,342394
11924,vikulaggarwal,1,0.00029,82997,24.24020,342394
11925,villesau,1,0.00029,82998,24.24049,342394
11926,villevaltonen,1,0.00029,82999,24.24079,342394
11927,vin4v,1,0.00029,83000,24.24108,342394
11928,vinaya-devopsnow,1,0.00029,83001,24.24137,342394
11929,vinayan3,1,0.00029,83002,24.24166,342394
11930,vincenlee,1,0.00029,83003,24.24196,342394
11931,vincentbesanceney,1,0.00029,83004,24.24225,342394
11932,vineetsingh5,1,0.00029,83005,24.24254,342394
11933,vinitaaher,1,0.00029,83006,24.24283,342394
11934,vinodjujaray,1,0.00029,83007,24.24312,342394
11935,vipulJain05,1,0.00029,83008,24.24342,342394
11936,Vireche,1,0.00029,83009,24.24371,342394
11937,virtualdxs,1,0.00029,83010,24.24400,342394
11938,virullius,1,0.00029,83011,24.24429,342394
11939,vishalk2203,1,0.00029,83012,24.24458,342394
11940,vishalsharmaeic,1,0.00029,83013,24.24488,342394
11941,vishaltripathi24,1,0.00029,83014,24.24517,342394
11942,vishveshv,1,0.00029,83015,24.24546,342394
11943,vitalik,1,0.00029,83016,24.24575,342394
11944,vitaliy-zinchenko,1,0.00029,83017,24.24604,342394
11945,VitalyArt,1,0.00029,83018,24.24634,342394
11946,vitalyrychkov,1,0.00029,83019,24.24663,342394
11947,vitoorgomes,1,0.00029,83020,24.24692,342394
11948,vitsensei,1,0.00029,83021,24.24721,342394
11949,vit-zikmund,1,0.00029,83022,24.24750,342394
11950,Vivekdjango,1,0.00029,83023,24.24780,342394
11951,vivek-infracloud,1,0.00029,83024,24.24809,342394
11952,VivekSubr,1,0.00029,83025,24.24838,342394
11953,vivid392845427,1,0.00029,83026,24.24867,342394
11954,vixns,1,0.00029,83027,24.24896,342394
11955,vizcay,1,0.00029,83028,24.24926,342394
11956,vkodalibp,1,0.00029,83029,24.24955,342394
11957,vkuzniet,1,0.00029,83030,24.24984,342394
11958,vladget,1,0.00029,83031,24.25013,342394
11959,vladimir259,1,0.00029,83032,24.25042,342394
11960,vladimirjk,1,0.00029,83033,24.25072,342394
11961,VladimirKorzh,1,0.00029,83034,24.25101,342394
11962,vladimiroff,1,0.00029,83035,24.25130,342394
11963,vladislav-prishchepa,1,0.00029,83036,24.25159,342394
11964,vlad-ivanov-name,1,0.00029,83037,24.25189,342394
11965,vladloskut,1,0.00029,83038,24.25218,342394
11966,vladsf,1,0.00029,83039,24.25247,342394
11967,vlinux,1,0.00029,83040,24.25276,342394
11968,vlushn,1,0.00029,83041,24.25305,342394
11969,vmathpal,1,0.00029,83042,24.25335,342394
11970,vmax,1,0.00029,83043,24.25364,342394
11971,vnaikwad-conga,1,0.00029,83044,24.25393,342394
11972,Vodkav,1,0.00029,83045,24.25422,342394
11973,vogre,1,0.00029,83046,24.25451,342394
11974,Voigtus,1,0.00029,83047,24.25481,342394
11975,volaka,1,0.00029,83048,24.25510,342394
11976,volehuy1998,1,0.00029,83049,24.25539,342394
11977,vooon,1,0.00029,83050,24.25568,342394
11978,vorotech,1,0.00029,83051,24.25597,342394
11979,vovasoft,1,0.00029,83052,24.25627,342394
11980,vpharabot,1,0.00029,83053,24.25656,342394
11981,vpnachev,1,0.00029,83054,24.25685,342394
11982,vrathore18,1,0.00029,83055,24.25714,342394
11983,vreamer,1,0.00029,83056,24.25743,342394
11984,VRECO,1,0.00029,83057,24.25773,342394
11985,vrusinov,1,0.00029,83058,24.25802,342394
11986,vrvs,1,0.00029,83059,24.25831,342394
11987,vsabella,1,0.00029,83060,24.25860,342394
11988,vsevel,1,0.00029,83061,24.25889,342394
11989,vsrnth,1,0.00029,83062,24.25919,342394
11990,vsynesael-unity,1,0.00029,83063,24.25948,342394
11991,vterdunov,1,0.00029,83064,24.25977,342394
11992,vuna261,1,0.00029,83065,24.26006,342394
11993,vvvggg,1,0.00029,83066,24.26036,342394
11994,vweckerle,1,0.00029,83067,24.26065,342394
11995,vyvyt,1,0.00029,83068,24.26094,342394
11996,w41ter-l,1,0.00029,83069,24.26123,342394
11997,w4rgrum,1,0.00029,83070,24.26152,342394
11998,w7089,1,0.00029,83071,24.26182,342394
11999,wagfeliz,1,0.00029,83072,24.26211,342394
12000,wahern-splunk,1,0.00029,83073,24.26240,342394
12001,wahmedswl,1,0.00029,83074,24.26269,342394
12002,waipeng,1,0.00029,83075,24.26298,342394
12003,waldo2188,1,0.00029,83076,24.26328,342394
12004,walirt,1,0.00029,83077,24.26357,342394
12005,Walnux,1,0.00029,83078,24.26386,342394
12006,WalterKhumalo,1,0.00029,83079,24.26415,342394
12007,wanderer163,1,0.00029,83080,24.26444,342394
12008,wanfranck,1,0.00029,83081,24.26474,342394
12009,wangdexin0825,1,0.00029,83082,24.26503,342394
12010,wangfakang,1,0.00029,83083,24.26532,342394
12011,wangfan0524,1,0.00029,83084,24.26561,342394
12012,wangggong,1,0.00029,83085,24.26590,342394
12013,wanghaoyang1995,1,0.00029,83086,24.26620,342394
12014,wangmeng99,1,0.00029,83087,24.26649,342394
12015,wangsheng1986,1,0.00029,83088,24.26678,342394
12016,wangshiyang,1,0.00029,83089,24.26707,342394
12017,wangsijia1985,1,0.00029,83090,24.26736,342394
12018,wangwalton,1,0.00029,83091,24.26766,342394
12019,wangyanyan66,1,0.00029,83092,24.26795,342394
12020,wangyijie7,1,0.00029,83093,24.26824,342394
12021,wanyaland,1,0.00029,83094,24.26853,342394
12022,wapson,1,0.00029,83095,24.26882,342394
12023,warroyo,1,0.00029,83096,24.26912,342394
12024,wasd171,1,0.00029,83097,24.26941,342394
12025,wasker,1,0.00029,83098,24.26970,342394
12026,waynesi,1,0.00029,83099,24.26999,342394
12027,waynexia,1,0.00029,83100,24.27029,342394
12028,waza-ari,1,0.00029,83101,24.27058,342394
12029,wbzdssm,1,0.00029,83102,24.27087,342394
12030,wcmitchell,1,0.00029,83103,24.27116,342394
12031,wdhanhuan,1,0.00029,83104,24.27145,342394
12032,wdullaer,1,0.00029,83105,24.27175,342394
12033,weakcamel,1,0.00029,83106,24.27204,342394
12034,webadmininc,1,0.00029,83107,24.27233,342394
12035,WebbingXu,1,0.00029,83108,24.27262,342394
12036,webees,1,0.00029,83109,24.27291,342394
12037,webermax,1,0.00029,83110,24.27321,342394
12038,webger3,1,0.00029,83111,24.27350,342394
12039,webmagiconline1,1,0.00029,83112,24.27379,342394
12040,weideguo,1,0.00029,83113,24.27408,342394
12041,Weilbyte,1,0.00029,83114,24.27437,342394
12042,weiqiangt,1,0.00029,83115,24.27467,342394
12043,weiwu-sre,1,0.00029,83116,24.27496,342394
12044,weixing-dev,1,0.00029,83117,24.27525,342394
12045,weltonrodrigo,1,0.00029,83118,24.27554,342394
12046,wenwugu,1,0.00029,83119,24.27583,342394
12047,wenyurush,1,0.00029,83120,24.27613,342394
12048,WenzelZ,1,0.00029,83121,24.27642,342394
12049,werebear73,1,0.00029,83122,24.27671,342394
12050,weskiller,1,0.00029,83123,24.27700,342394
12051,westandy,1,0.00029,83124,24.27729,342394
12052,westernspion,1,0.00029,83125,24.27759,342394
12053,wfchair,1,0.00029,83126,24.27788,342394
12054,wfrsilva,1,0.00029,83127,24.27817,342394
12055,wgkingk,1,0.00029,83128,24.27846,342394
12056,wheatevo,1,0.00029,83129,24.27875,342394
12057,whilelie,1,0.00029,83130,24.27905,342394
12058,whisp1986,1,0.00029,83131,24.27934,342394
12059,wHiteeeeeeeee,1,0.00029,83132,24.27963,342394
12060,whysi,1,0.00029,83133,24.27992,342394
12061,wikilele,1,0.00029,83134,24.28022,342394
12062,Wikiwix,1,0.00029,83135,24.28051,342394
12063,WilhelmJP,1,0.00029,83136,24.28080,342394
12064,willemm,1,0.00029,83137,24.28109,342394
12065,willgo-cn,1,0.00029,83138,24.28138,342394
12066,WilliamsDL,1,0.00029,83139,24.28168,342394
12067,williamwang97,1,0.00029,83140,24.28197,342394
12068,willin,1,0.00029,83141,24.28226,342394
12069,willmostly,1,0.00029,83142,24.28255,342394
12070,will-wang-jx,1,0.00029,83143,24.28284,342394
12071,wilsondonizetti,1,0.00029,83144,24.28314,342394
12072,Winael,1,0.00029,83145,24.28343,342394
12073,windghoul,1,0.00029,83146,24.28372,342394
12074,windniw,1,0.00029,83147,24.28401,342394
12075,wingzzzz,1,0.00029,83148,24.28430,342394
12076,Win-Man,1,0.00029,83149,24.28460,342394
12077,winterhalder,1,0.00029,83150,24.28489,342394
12078,wips,1,0.00029,83151,24.28518,342394
12079,wittenjing,1,0.00029,83152,24.28547,342394
12080,wizard2318,1,0.00029,83153,24.28576,342394
12081,wjentner,1,0.00029,83154,24.28606,342394
12082,wjrbetts,1,0.00029,83155,24.28635,342394
12083,wkicior,1,0.00029,83156,24.28664,342394
12084,wkrause13,1,0.00029,83157,24.28693,342394
12085,WockaFlockaRist,1,0.00029,83158,24.28722,342394
12086,WojciechThomas,1,0.00029,83159,24.28752,342394
12087,wolfedale,1,0.00029,83160,24.28781,342394
12088,Wolftousen,1,0.00029,83161,24.28810,342394
12089,wooden-worm,1,0.00029,83162,24.28839,342394
12090,worldwideward,1,0.00029,83163,24.28868,342394
12091,wouldgo,1,0.00029,83164,24.28898,342394
12092,wpjagdeep,1,0.00029,83165,24.28927,342394
12093,wrflemin,1,0.00029,83166,24.28956,342394
12094,wscheep,1,0.00029,83167,24.28985,342394
12095,wsj0000,1,0.00029,83168,24.29015,342394
12096,wswind,1,0.00029,83169,24.29044,342394
12097,wsxiaozhang,1,0.00029,83170,24.29073,342394
12098,wsywsya119,1,0.00029,83171,24.29102,342394
12099,wtchangdm,1,0.00029,83172,24.29131,342394
12100,wuxingro,1,0.00029,83173,24.29161,342394
12101,wuyuhang18325533531,1,0.00029,83174,24.29190,342394
12102,wvboy31216,1,0.00029,83175,24.29219,342394
12103,wwc13485375003,1,0.00029,83176,24.29248,342394
12104,wwdz,1,0.00029,83177,24.29277,342394
12105,wwyhy,1,0.00029,83178,24.29307,342394
12106,wxq851685279,1,0.00029,83179,24.29336,342394
12107,wybaron,1,0.00029,83180,24.29365,342394
12108,Xairoo,1,0.00029,83181,24.29394,342394
12109,xakepp35,1,0.00029,83182,24.29423,342394
12110,xavierxjj,1,0.00029,83183,24.29453,342394
12111,xbuzz,1,0.00029,83184,24.29482,342394
12112,xchan,1,0.00029,83185,24.29511,342394
12113,xcorail,1,0.00029,83186,24.29540,342394
12114,XDavidT,1,0.00029,83187,24.29569,342394
12115,xdorro,1,0.00029,83188,24.29599,342394
12116,xeivieni,1,0.00029,83189,24.29628,342394
12117,xeres,1,0.00029,83190,24.29657,342394
12118,xhh1989,1,0.00029,83191,24.29686,342394
12119,xiang17,1,0.00029,83192,24.29715,342394
12120,xiaobeiyang,1,0.00029,83193,24.29745,342394
12121,XiaoBoya,1,0.00029,83194,24.29774,342394
12122,xiaohuanxiong3,1,0.00029,83195,24.29803,342394
12123,xiaojueguan,1,0.00029,83196,24.29832,342394
12124,xiaolin8,1,0.00029,83197,24.29862,342394
12125,XIAOYUELIN,1,0.00029,83198,24.29891,342394
12126,xiazhan,1,0.00029,83199,24.29920,342394
12127,Xia-Zhao-rh,1,0.00029,83200,24.29949,342394
12128,xicond,1,0.00029,83201,24.29978,342394
12129,xiewendan,1,0.00029,83202,24.30008,342394
12130,xificurC,1,0.00029,83203,24.30037,342394
12131,xiliangMa,1,0.00029,83204,24.30066,342394
12132,xincuni,1,0.00029,83205,24.30095,342394
12133,xinfa1024,1,0.00029,83206,24.30124,342394
12134,xinghui,1,0.00029,83207,24.30154,342394
12135,xinglan500,1,0.00029,83208,24.30183,342394
12136,xinyanzh97,1,0.00029,83209,24.30212,342394
12137,xinydev,1,0.00029,83210,24.30241,342394
12138,xinyii,1,0.00029,83211,24.30270,342394
12139,xionglihdfs,1,0.00029,83212,24.30300,342394
12140,xjzyy,1,0.00029,83213,24.30329,342394
12141,xkrt,1,0.00029,83214,24.30358,342394
12142,xLitil,1,0.00029,83215,24.30387,342394
12143,xmartinez,1,0.00029,83216,24.30416,342394
12144,xmath279,1,0.00029,83217,24.30446,342394
12145,xmcqueen,1,0.00029,83218,24.30475,342394
12146,xmsanchez,1,0.00029,83219,24.30504,342394
12147,XMTT,1,0.00029,83220,24.30533,342394
12148,xom4ek,1,0.00029,83221,24.30562,342394
12149,Xphobia,1,0.00029,83222,24.30592,342394
12150,Xplouder,1,0.00029,83223,24.30621,342394
12151,xpofei,1,0.00029,83224,24.30650,342394
12152,xr0n1ck,1,0.00029,83225,24.30679,342394
12153,xtfer,1,0.00029,83226,24.30708,342394
12154,xtreme-nitin-ravindran,1,0.00029,83227,24.30738,342394
12155,xuchenCN,1,0.00029,83228,24.30767,342394
12156,XuehaiPan,1,0.00029,83229,24.30796,342394
12157,xuesongbj,1,0.00029,83230,24.30825,342394
12158,XUJiahua,1,0.00029,83231,24.30855,342394
12159,xujianhai666,1,0.00029,83232,24.30884,342394
12160,xuwenjj,1,0.00029,83233,24.30913,342394
12161,xuz10,1,0.00029,83234,24.30942,342394
12162,xxtanisxx,1,0.00029,83235,24.30971,342394
12163,xyslion,1,0.00029,83236,24.31001,342394
12164,yackushevas,1,0.00029,83237,24.31030,342394
12165,Yagyansh,1,0.00029,83238,24.31059,342394
12166,yah01,1,0.00029,83239,24.31088,342394
12167,yahel2410,1,0.00029,83240,24.31117,342394
12168,yaliqin,1,0.00029,83241,24.31147,342394
12169,Yambottle,1,0.00029,83242,24.31176,342394
12170,Yamunaindiran,1,0.00029,83243,24.31205,342394
12171,yang1992,1,0.00029,83244,24.31234,342394
12172,yanguwan,1,0.00029,83245,24.31263,342394
12173,yangxiaoliang,1,0.00029,83246,24.31293,342394
12174,yangxiuchengv5,1,0.00029,83247,24.31322,342394
12175,yanji09,1,0.00029,83248,24.31351,342394
12176,YaoC,1,0.00029,83249,24.31380,342394
12177,yar2001,1,0.00029,83250,24.31409,342394
12178,yash97,1,0.00029,83251,24.31439,342394
12179,YashJainSC,1,0.00029,83252,24.31468,342394
12180,yashpotu,1,0.00029,83253,24.31497,342394
12181,YasienDwieb,1,0.00029,83254,24.31526,342394
12182,yasselavila,1,0.00029,83255,24.31555,342394
12183,yatakoi,1,0.00029,83256,24.31585,342394
12184,yauh-ask,1,0.00029,83257,24.31614,342394
12185,yavuztor,1,0.00029,83258,24.31643,342394
12186,yaxin-cn,1,0.00029,83259,24.31672,342394
12187,ycaihua,1,0.00029,83260,24.31701,342394
12188,YChen-1998,1,0.00029,83261,24.31731,342394
12189,yeganeahmadnejad,1,0.00029,83262,24.31760,342394
12190,Yejing0609,1,0.00029,83263,24.31789,342394
12191,yerinu2019,1,0.00029,83264,24.31818,342394
12192,yevsh,1,0.00029,83265,24.31848,342394
12193,ygalblum,1,0.00029,83266,24.31877,342394
12194,yiga2,1,0.00029,83267,24.31906,342394
12195,yiippee,1,0.00029,83268,24.31935,342394
12196,yilmi,1,0.00029,83269,24.31964,342394
12197,yiya1989,1,0.00029,83270,24.31994,342394
12198,yizhang-zen,1,0.00029,83271,24.32023,342394
12199,yjbdsky,1,0.00029,83272,24.32052,342394
12200,ykcilborw,1,0.00029,83273,24.32081,342394
12201,ykostsik,1,0.00029,83274,24.32110,342394
12202,yktd26,1,0.00029,83275,24.32140,342394
12203,ykumthekar4929,1,0.00029,83276,24.32169,342394
12204,ylallemant,1,0.00029,83277,24.32198,342394
12205,yleiymei,1,0.00029,83278,24.32227,342394
12206,yllekz,1,0.00029,83279,24.32256,342394
12207,yndo97,1,0.00029,83280,24.32286,342394
12208,yngwiewang,1,0.00029,83281,24.32315,342394
12209,yntelectual,1,0.00029,83282,24.32344,342394
12210,yoave23,1,0.00029,83283,24.32373,342394
12211,yolossn,1,0.00029,83284,24.32402,342394
12212,YongBig,1,0.00029,83285,24.32432,342394
12213,yongkangzhao,1,0.00029,83286,24.32461,342394
12214,yongpan0709,1,0.00029,83287,24.32490,342394
12215,yongw5,1,0.00029,83288,24.32519,342394
12216,yonigibbs,1,0.00029,83289,24.32548,342394
12217,yooakim,1,0.00029,83290,24.32578,342394
12218,yordanovagabriela,1,0.00029,83291,24.32607,342394
12219,yoshigev,1,0.00029,83292,24.32636,342394
12220,yoshina9a,1,0.00029,83293,24.32665,342394
12221,yossicohn-hs,1,0.00029,83294,24.32694,342394
12222,youguanxinqing,1,0.00029,83295,24.32724,342394
12223,youssefbouzaine,1,0.00029,83296,24.32753,342394
12224,YoussefHmidiSesame,1,0.00029,83297,24.32782,342394
12225,youtaqiu,1,0.00029,83298,24.32811,342394
12226,yp201,1,0.00029,83299,24.32841,342394
12227,ypatent,1,0.00029,83300,24.32870,342394
12228,ypl-coffee,1,0.00029,83301,24.32899,342394
12229,YPNico,1,0.00029,83302,24.32928,342394
12230,yshu2017,1,0.00029,83303,24.32957,342394
12231,ysong6,1,0.00029,83304,24.32987,342394
12232,ysongshan,1,0.00029,83305,24.33016,342394
12233,ytfrank,1,0.00029,83306,24.33045,342394
12234,ytzlax,1,0.00029,83307,24.33074,342394
12235,yuchanns,1,0.00029,83308,24.33103,342394
12236,yuezhu,1,0.00029,83309,24.33133,342394
12237,yufengjinsong,1,0.00029,83310,24.33162,342394
12238,yule-sun,1,0.00029,83311,24.33191,342394
12239,Yunak,1,0.00029,83312,24.33220,342394
12240,yungyili,1,0.00029,83313,24.33249,342394
12241,YurasovDV,1,0.00029,83314,24.33279,342394
12242,yuraxdrumz,1,0.00029,83315,24.33308,342394
12243,YuriiVarvynets,1,0.00029,83316,24.33337,342394
12244,yuri-tceretian,1,0.00029,83317,24.33366,342394
12245,yurivict,1,0.00029,83318,24.33395,342394
12246,yurykabanov,1,0.00029,83319,24.33425,342394
12247,yuswitayudi,1,0.00029,83320,24.33454,342394
12248,yutachaos,1,0.00029,83321,24.33483,342394
12249,yuvalavidor,1,0.00029,83322,24.33512,342394
12250,yvespp,1,0.00029,83323,24.33541,342394
12251,yvoilee,1,0.00029,83324,24.33571,342394
12252,ywattenberg,1,0.00029,83325,24.33600,342394
12253,yws-ss,1,0.00029,83326,24.33629,342394
12254,ywyt738,1,0.00029,83327,24.33658,342394
12255,yxiang92128,1,0.00029,83328,24.33688,342394
12256,yxz312,1,0.00029,83329,24.33717,342394
12257,yym506,1,0.00029,83330,24.33746,342394
12258,yzhang559,1,0.00029,83331,24.33775,342394
12259,yzhao244,1,0.00029,83332,24.33804,342394
12260,Z3po,1,0.00029,83333,24.33834,342394
12261,zach-robinson,1,0.00029,83334,24.33863,342394
12262,ZackHollander,1,0.00029,83335,24.33892,342394
12263,Zak-Anderson,1,0.00029,83336,24.33921,342394
12264,zakiharis,1,0.00029,83337,24.33950,342394
12265,zakkra,1,0.00029,83338,24.33980,342394
12266,zalegrala,1,0.00029,83339,24.34009,342394
12267,zaoying,1,0.00029,83340,24.34038,342394
12268,zarafree,1,0.00029,83341,24.34067,342394
12269,zaunist,1,0.00029,83342,24.34096,342394
12270,zayomeng,1,0.00029,83343,24.34126,342394
12271,zbioe,1,0.00029,83344,24.34155,342394
12272,zdkhan,1,0.00029,83345,24.34184,342394
12273,ZdravkoGyurov,1,0.00029,83346,24.34213,342394
12274,zdxn,1,0.00029,83347,24.34242,342394
12275,zdz1715,1,0.00029,83348,24.34272,342394
12276,zeevogels,1,0.00029,83349,24.34301,342394
12277,zelin-l,1,0.00029,83350,24.34330,342394
12278,zenbones,1,0.00029,83351,24.34359,342394
12279,zengguofei,1,0.00029,83352,24.34388,342394
12280,zengxu87,1,0.00029,83353,24.34418,342394
12281,zenomri,1,0.00029,83354,24.34447,342394
12282,zenovich,1,0.00029,83355,24.34476,342394
12283,zenyui,1,0.00029,83356,24.34505,342394
12284,Zeouterlimits,1,0.00029,83357,24.34534,342394
12285,zer0def,1,0.00029,83358,24.34564,342394
12286,zer0stars,1,0.00029,83359,24.34593,342394
12287,zerodayyy,1,0.00029,83360,24.34622,342394
12288,zeropanzx,1,0.00029,83361,24.34651,342394
12289,zfrhv,1,0.00029,83362,24.34681,342394
12290,zfy3000163,1,0.00029,83363,24.34710,342394
12291,Zh1Cheung,1,0.00029,83364,24.34739,342394
12292,zhang10609,1,0.00029,83365,24.34768,342394
12293,zhang14725804,1,0.00029,83366,24.34797,342394
12294,Zhang-Aoqi,1,0.00029,83367,24.34827,342394
12295,zhangmuhua2013,1,0.00029,83368,24.34856,342394
12296,zhangwenkal,1,0.00029,83369,24.34885,342394
12297,zhangwenlong8911,1,0.00029,83370,24.34914,342394
12298,zhangxingdeppon,1,0.00029,83371,24.34943,342394
12299,zhaobei,1,0.00029,83372,24.34973,342394
12300,zhaojkun,1,0.00029,83373,24.35002,342394
12301,zhaorendong,1,0.00029,83374,24.35031,342394
12302,zhaosonghai,1,0.00029,83375,24.35060,342394
12303,zhaow-de,1,0.00029,83376,24.35089,342394
12304,zhb1207,1,0.00029,83377,24.35119,342394
12305,zhdanov,1,0.00029,83378,24.35148,342394
12306,zhengyanhui01,1,0.00029,83379,24.35177,342394
12307,zhijiay,1,0.00029,83380,24.35206,342394
12308,zhilyaev,1,0.00029,83381,24.35235,342394
12309,zhonghaochen,1,0.00029,83382,24.35265,342394
12310,zhongpengqun,1,0.00029,83383,24.35294,342394
12311,zhouyu123666,1,0.00029,83384,24.35323,342394
12312,zhubby,1,0.00029,83385,24.35352,342394
12313,zhufanqin,1,0.00029,83386,24.35381,342394
12314,zhuizhuhaomeng,1,0.00029,83387,24.35411,342394
12315,zhulingbiezhi,1,0.00029,83388,24.35440,342394
12316,zhulixiang,1,0.00029,83389,24.35469,342394
12317,zhuyaguang,1,0.00029,83390,24.35498,342394
12318,zhuzhiyang,1,0.00029,83391,24.35527,342394
12319,zhx828,1,0.00029,83392,24.35557,342394
12320,ZidCode,1,0.00029,83393,24.35586,342394
12321,zilmarr,1,0.00029,83394,24.35615,342394
12322,ziollek,1,0.00029,83395,24.35644,342394
12323,zitudu,1,0.00029,83396,24.35674,342394
12324,zjeffer,1,0.00029,83397,24.35703,342394
12325,zjj1002,1,0.00029,83398,24.35732,342394
12326,Zjmainstay,1,0.00029,83399,24.35761,342394
12327,zkb-cisupport,1,0.00029,83400,24.35790,342394
12328,zkfopen,1,0.00029,83401,24.35820,342394
12329,zkryakgul,1,0.00029,83402,24.35849,342394
12330,ZLEternity,1,0.00029,83403,24.35878,342394
12331,zlubsen,1,0.00029,83404,24.35907,342394
12332,zlwandlily,1,0.00029,83405,24.35936,342394
12333,zmanion,1,0.00029,83406,24.35966,342394
12334,zmeggyesi,1,0.00029,83407,24.35995,342394
12335,znmeb,1,0.00029,83408,24.36024,342394
12336,zoftdev,1,0.00029,83409,24.36053,342394
12337,zolech,1,0.00029,83410,24.36082,342394
12338,Zombie123456,1,0.00029,83411,24.36112,342394
12339,zonybob,1,0.00029,83412,24.36141,342394
12340,ZQHcode,1,0.00029,83413,24.36170,342394
12341,zrc210,1,0.00029,83414,24.36199,342394
12342,zroof-credible,1,0.00029,83415,24.36228,342394
12343,zsping1989,1,0.00029,83416,24.36258,342394
12344,zvier,1,0.00029,83417,24.36287,342394
12345,ZviMints,1,0.00029,83418,24.36316,342394
12346,zx8,1,0.00029,83419,24.36345,342394
12347,zxh326,1,0.00029,83420,24.36374,342394
12348,zy286938348,1,0.00029,83421,24.36404,342394
12349,zyguan,1,0.00029,83422,24.36433,342394
12350,zyxue,1,0.00029,83423,24.36462,342394
12351,zzbennett,1,0.00029,83424,24.36491,342394
12352,zzjcool,1,0.00029,83425,24.36520,342394
12353,zzorica,1,0.00029,83426,24.36550,342394
12354,zzx769394358,1,0.00029,83427,24.36579,342394
