rank_number,actor,contributions,percent,cumulative_sum,cumulative_percent,all_contributions
1,phlax,1780,0.40949,1780,0.40949,434688
2,mowies,1039,0.23902,2819,0.64851,434688
3,gaius-qi,976,0.22453,3795,0.87304,434688
4,cdk8s-automation,785,0.18059,4580,1.05363,434688
5,realshuting,742,0.17070,5322,1.22433,434688
6,anubha-v-ardhan,591,0.13596,5913,1.36029,434688
7,copybaranaut,579,0.13320,6492,1.49348,434688
8,jsuereth,548,0.12607,7040,1.61955,434688
9,Pallavi-PH,482,0.11088,7522,1.73044,434688
10,mfelsche,452,0.10398,7974,1.83442,434688
11,jim3ma,418,0.09616,8392,1.93058,434688
12,Chriscbr,375,0.08627,8767,2.01685,434688
13,Thor-wl,374,0.08604,9141,2.10289,434688
14,whynowy,371,0.08535,9512,2.18824,434688
15,llhuii,368,0.08466,9880,2.27289,434688
16,kuritka,362,0.08328,10242,2.35617,434688
17,anishakj,351,0.08075,10593,2.43692,434688
18,mboukhalfa,338,0.07776,10931,2.51468,434688
19,satyapriyamishra222,333,0.07661,11264,2.59128,434688
20,tylerferrara,331,0.07615,11595,2.66743,434688
21,andylokandy,330,0.07592,11925,2.74335,434688
22,tomaszwylezek,317,0.07293,12242,2.81627,434688
23,kishorj,308,0.07086,12550,2.88713,434688
24,mattcary,308,0.07086,12858,2.95798,434688
25,zasweq,301,0.06925,13159,3.02723,434688
26,rakeshPRaghu,297,0.06832,13456,3.09555,434688
27,LeviHarrison,291,0.06694,13747,3.16250,434688
28,cynthia-sg,280,0.06441,14027,3.22691,434688
29,244372610,275,0.06326,14302,3.29018,434688
30,shrids,271,0.06234,14573,3.35252,434688
31,sayantani11,268,0.06165,14841,3.41417,434688
32,anodelman,266,0.06119,15107,3.47537,434688
33,camilaibs,261,0.06004,15368,3.53541,434688
34,Garrybest,255,0.05866,15623,3.59407,434688
35,ormergi,254,0.05843,15877,3.65250,434688
36,Fox32,252,0.05797,16129,3.71048,434688
37,brybacki,251,0.05774,16380,3.76822,434688
38,xpivarc,238,0.05475,16618,3.82297,434688
39,zmberg,235,0.05406,16853,3.87703,434688
40,mvalarh,231,0.05314,17084,3.93018,434688
41,Poorunga,230,0.05291,17314,3.98309,434688
42,dereknola,228,0.05245,17542,4.03554,434688
43,sifmelcara,226,0.05199,17768,4.08753,434688
44,yangjunmyfm192085,225,0.05176,17993,4.13929,434688
45,JoeyHwong-gk,224,0.05153,18217,4.19082,434688
46,lonewolf3739,223,0.05130,18440,4.24212,434688
47,wenqiq,222,0.05107,18662,4.29319,434688
48,XiShanYongYe-Chang,221,0.05084,18883,4.34404,434688
49,bartavelle,215,0.04946,19098,4.39350,434688
50,TaWeiTu,215,0.04946,19313,4.44296,434688
51,JorTurFer,213,0.04900,19526,4.49196,434688
52,jgwest,208,0.04785,19734,4.53981,434688
53,vihangm,208,0.04785,19942,4.58766,434688
54,sashrith,204,0.04693,20146,4.63459,434688
55,zhelongp,204,0.04693,20350,4.68152,434688
56,leejanee,201,0.04624,20551,4.72776,434688
57,ShuzZzle,201,0.04624,20752,4.77400,434688
58,wbpcode,201,0.04624,20953,4.82024,434688
59,framework-automation,200,0.04601,21153,4.86625,434688
60,niladrih,198,0.04555,21351,4.91180,434688
61,aimichelle,197,0.04532,21548,4.95712,434688
62,im-konge,196,0.04509,21744,5.00221,434688
63,champtar,194,0.04463,21938,5.04684,434688
64,yangsoon,194,0.04463,22132,5.09147,434688
65,aidanhahn,191,0.04394,22323,5.13541,434688
66,htroisi,189,0.04348,22512,5.17889,434688
67,qiancai,188,0.04325,22700,5.22214,434688
68,robertlaurin,186,0.04279,22886,5.26493,434688
69,HashNuke,183,0.04210,23069,5.30702,434688
70,rpanduranga,182,0.04187,23251,5.34889,434688
71,akalenyu,179,0.04118,23430,5.39007,434688
72,JimmyYang20,177,0.04072,23607,5.43079,434688
73,haosanzi,170,0.03911,23777,5.46990,434688
74,mattlord,170,0.03911,23947,5.50901,434688
75,allenlsy,169,0.03888,24116,5.54789,434688
76,nshankar13,169,0.03888,24285,5.58677,434688
77,TomShawn,165,0.03796,24450,5.62472,434688
78,lhy1024,164,0.03773,24614,5.66245,434688
79,thbishop-intuit,161,0.03704,24775,5.69949,434688
80,viveksahu26,160,0.03681,24935,5.73630,434688
81,rhdxmr,156,0.03589,25091,5.77219,434688
82,agrawroh,155,0.03566,25246,5.80784,434688
83,Somefive,155,0.03566,25401,5.84350,434688
84,iamNoah1,152,0.03497,25553,5.87847,434688
85,neelanjan00,145,0.03336,25698,5.91183,434688
86,cndoit18,144,0.03313,25842,5.94495,434688
87,jyz0309,144,0.03313,25986,5.97808,434688
88,abvaidya,143,0.03290,26129,6.01098,434688
89,parkanzky,142,0.03267,26271,6.04365,434688
90,shivanshu1333,141,0.03244,26412,6.07608,434688
91,mtlewis,140,0.03221,26552,6.10829,434688
92,ZBoIsHere,139,0.03198,26691,6.14027,434688
93,verma-kunal,137,0.03152,26828,6.17178,434688
94,leiyiz,136,0.03129,26964,6.20307,434688
95,lfpino,135,0.03106,27099,6.23413,434688
96,rubenLindstrom,132,0.03037,27231,6.26449,434688
97,wangyikewxgm,131,0.03014,27362,6.29463,434688
98,kuangp,129,0.02968,27491,6.32431,434688
99,simonjbeaumont,127,0.02922,27618,6.35352,434688
100,lfbear,126,0.02899,27744,6.38251,434688
101,manugupt1,124,0.02853,27868,6.41104,434688
102,skoech,124,0.02853,27992,6.43956,434688
103,d-uzlov,123,0.02830,28115,6.46786,434688
104,M00nF1sh,123,0.02830,28238,6.49615,434688
105,dennycd,117,0.02692,28355,6.52307,434688
106,Little-Wallace,117,0.02692,28472,6.54999,434688
107,boenn,116,0.02669,28588,6.57667,434688
108,pasha-codefresh,116,0.02669,28704,6.60336,434688
109,chivalryq,115,0.02646,28819,6.62981,434688
110,en-jin19,115,0.02646,28934,6.65627,434688
111,MattDavis00,115,0.02646,29049,6.68272,434688
112,MrCroxx,114,0.02623,29163,6.70895,434688
113,YangLiang3,113,0.02600,29276,6.73495,434688
114,fewdan,112,0.02577,29388,6.76071,434688
115,Saber-W,112,0.02577,29500,6.78648,434688
116,oazizi000,110,0.02531,29610,6.81178,434688
117,treydock,110,0.02531,29720,6.83709,434688
118,importhuman,109,0.02508,29829,6.86216,434688
119,Lily2025,109,0.02508,29938,6.88724,434688
120,xinydev,109,0.02508,30047,6.91231,434688
121,CLAassistant,107,0.02462,30154,6.93693,434688
122,itsemmanuelfrancis,107,0.02462,30261,6.96154,434688
123,marunachalam,107,0.02462,30368,6.98616,434688
124,tyxia,106,0.02439,30474,7.01055,434688
125,ccfishk,103,0.02370,30577,7.03424,434688
126,domderen,102,0.02347,30679,7.05771,434688
127,OferLevi85,102,0.02347,30781,7.08117,434688
128,rittneje,102,0.02347,30883,7.10464,434688
129,antmendoza,101,0.02324,30984,7.12787,434688
130,Liuxiaozhen12,101,0.02324,31085,7.15111,434688
131,THS-on,101,0.02324,31186,7.17434,434688
132,YuviGold,101,0.02324,31287,7.19758,434688
133,zasgar,101,0.02324,31388,7.22081,434688
134,nserrino,100,0.02301,31488,7.24382,434688
135,n4j,99,0.02277,31587,7.26659,434688
136,yanushg,99,0.02277,31686,7.28937,434688
137,eduser25,98,0.02254,31784,7.31191,434688
138,awanlin,97,0.02231,31881,7.33423,434688
139,ciiay,97,0.02231,31978,7.35654,434688
140,njayp,97,0.02231,32075,7.37886,434688
141,astraw99,95,0.02185,32170,7.40071,434688
142,chenxuc,95,0.02185,32265,7.42257,434688
143,mmiranda96,95,0.02185,32360,7.44442,434688
144,niteshseram,95,0.02185,32455,7.46627,434688
145,njuptlzf,95,0.02185,32550,7.48813,434688
146,ShivamTyagi12345,95,0.02185,32645,7.50998,434688
147,adriangb,94,0.02162,32739,7.53161,434688
148,mic-max,94,0.02162,32833,7.55323,434688
149,wangyuan249,94,0.02162,32927,7.57486,434688
150,Blacksmoke16,93,0.02139,33020,7.59625,434688
151,denis-reblaze,93,0.02139,33113,7.61765,434688
152,vikramcse,93,0.02139,33206,7.63904,434688
153,whitetiger1399,93,0.02139,33299,7.66044,434688
154,5kbpers,92,0.02116,33391,7.68160,434688
155,jnmoyne,92,0.02116,33483,7.70277,434688
156,vedant-kakde,91,0.02093,33574,7.72370,434688
157,kaxing,90,0.02070,33664,7.74441,434688
158,zhongzc,89,0.02047,33753,7.76488,434688
159,jalseth,88,0.02024,33841,7.78512,434688
160,XinYao1994,88,0.02024,33929,7.80537,434688
161,avaakash,87,0.02001,34016,7.82538,434688
162,jayonlau,87,0.02001,34103,7.84540,434688
163,ambiknai,86,0.01978,34189,7.86518,434688
164,donnadionne,86,0.01978,34275,7.88497,434688
165,fyang86,86,0.01978,34361,7.90475,434688
166,harikrongali,86,0.01978,34447,7.92453,434688
167,kavyashree-r,86,0.01978,34533,7.94432,434688
168,tier-cap,86,0.01978,34619,7.96410,434688
169,pmmalinov01,85,0.01955,34704,7.98366,434688
170,alan-kut,84,0.01932,34788,8.00298,434688
171,raptorsun,84,0.01932,34872,8.02231,434688
172,ahayworth,83,0.01909,34955,8.04140,434688
173,imeoer,83,0.01909,35038,8.06049,434688
174,conqerAtapple,82,0.01886,35120,8.07936,434688
175,liangzhou121,82,0.01886,35202,8.09822,434688
176,qidi1,82,0.01886,35284,8.11709,434688
177,YangJiao0817,82,0.01886,35366,8.13595,434688
178,CIPHERTron,81,0.01863,35447,8.15458,434688
179,haliliceylan,81,0.01863,35528,8.17322,434688
180,yuchen-sun,80,0.01840,35608,8.19162,434688
181,zzy987,79,0.01817,35687,8.20980,434688
182,annakhm,78,0.01794,35765,8.22774,434688
183,hosseinsia,78,0.01794,35843,8.24568,434688
184,ianbillett,78,0.01794,35921,8.26363,434688
185,Jexf,78,0.01794,35999,8.28157,434688
186,kasium,77,0.01771,36076,8.29929,434688
187,JaneLiuL,76,0.01748,36152,8.31677,434688
188,kotlasaicharanreddy,76,0.01748,36228,8.33425,434688
189,legendecas,76,0.01748,36304,8.35174,434688
190,SAtacker,76,0.01748,36380,8.36922,434688
191,zeenix,76,0.01748,36456,8.38670,434688
192,AaronME,75,0.01725,36531,8.40396,434688
193,qianjun1993,75,0.01725,36606,8.42121,434688
194,Atharva-Shinde,74,0.01702,36680,8.43824,434688
195,juliusl,74,0.01702,36754,8.45526,434688
196,wangyysde,74,0.01702,36828,8.47228,434688
197,efunk,73,0.01679,36901,8.48908,434688
198,jayesh-srivastava,73,0.01679,36974,8.50587,434688
199,mjb3279,73,0.01679,37047,8.52266,434688
200,sandipanpanda,73,0.01679,37120,8.53946,434688
201,Vr00mm,73,0.01679,37193,8.55625,434688
202,Freakachoo,72,0.01656,37265,8.57282,434688
203,ks2211,72,0.01656,37337,8.58938,434688
204,willie-yao,72,0.01656,37409,8.60594,434688
205,akshitgrover,71,0.01633,37480,8.62228,434688
206,bishtsaurabh5,71,0.01633,37551,8.63861,434688
207,Rozzii,71,0.01633,37622,8.65494,434688
208,warunicorn19,71,0.01633,37693,8.67128,434688
209,xliuxu,71,0.01633,37764,8.68761,434688
210,Enkelian,70,0.01610,37834,8.70371,434688
211,codefromthecrypt,69,0.01587,37903,8.71959,434688
212,peng1999,69,0.01587,37972,8.73546,434688
213,sampajano,69,0.01587,38041,8.75133,434688
214,wiktor-k,69,0.01587,38110,8.76721,434688
215,haarchri,68,0.01564,38178,8.78285,434688
216,thekingofcity,68,0.01564,38246,8.79849,434688
217,carr123,67,0.01541,38313,8.81391,434688
218,getporterbot,67,0.01541,38380,8.82932,434688
219,richardchen331,67,0.01541,38447,8.84473,434688
220,alexperez52,66,0.01518,38513,8.85992,434688
221,EinKrebs,66,0.01518,38579,8.87510,434688
222,iguoyr,66,0.01518,38645,8.89028,434688
223,RenjieTang,66,0.01518,38711,8.90547,434688
224,deepakkinni,65,0.01495,38776,8.92042,434688
225,leonardo-albertovich,65,0.01495,38841,8.93537,434688
226,ahmedyarub,64,0.01472,38905,8.95010,434688
227,allenporter,64,0.01472,38969,8.96482,434688
228,hrishavjha,64,0.01472,39033,8.97954,434688
229,navendu-pottekkat,64,0.01472,39097,8.99427,434688
230,BoltsLei,63,0.01449,39160,9.00876,434688
231,StephenLeeY,63,0.01449,39223,9.02325,434688
232,yz271544,63,0.01449,39286,9.03775,434688
233,ZhangHanDong,63,0.01449,39349,9.05224,434688
234,Anita-ihuman,62,0.01426,39411,9.06650,434688
235,keithalucas,62,0.01426,39473,9.08077,434688
236,AdamKorcz,61,0.01403,39534,9.09480,434688
237,s-matyukevich,61,0.01403,39595,9.10883,434688
238,SomalianIvan,61,0.01403,39656,9.12287,434688
239,joaopgrassi,60,0.01380,39716,9.13667,434688
240,maugustosilva,60,0.01380,39776,9.15047,434688
241,mrlihanbo,60,0.01380,39836,9.16427,434688
242,Raul9595,60,0.01380,39896,9.17808,434688
243,Vignesh2208,60,0.01380,39956,9.19188,434688
244,lut777,59,0.01357,40015,9.20545,434688
245,sathieu,59,0.01357,40074,9.21903,434688
246,h4ghhh,58,0.01334,40132,9.23237,434688
247,dhoard,57,0.01311,40189,9.24548,434688
248,dvic,57,0.01311,40246,9.25859,434688
249,eggiter,57,0.01311,40303,9.27171,434688
250,vkuzniet,57,0.01311,40360,9.28482,434688
251,NickLanam,56,0.01288,40416,9.29770,434688
252,nirmalaagash,56,0.01288,40472,9.31059,434688
253,ohamuy,56,0.01288,40528,9.32347,434688
254,philkuz,56,0.01288,40584,9.33635,434688
255,aceamarco,55,0.01265,40639,9.34900,434688
256,FingerLeader,55,0.01265,40694,9.36166,434688
257,lintongj,55,0.01265,40749,9.37431,434688
258,sejr,55,0.01265,40804,9.38696,434688
259,yuqi1129,55,0.01265,40859,9.39962,434688
260,alisabzevari,54,0.01242,40913,9.41204,434688
261,anushkamittal20,54,0.01242,40967,9.42446,434688
262,FriedrichWilken,54,0.01242,41021,9.43688,434688
263,khalid-jobs,54,0.01242,41075,9.44931,434688
264,siredmar,54,0.01242,41129,9.46173,434688
265,juozasg,53,0.01219,41182,9.47392,434688
266,lengrongfu,53,0.01219,41235,9.48611,434688
267,wanlin31,53,0.01219,41288,9.49831,434688
268,aaryanporwal,52,0.01196,41340,9.51027,434688
269,jimdaga,52,0.01196,41392,9.52223,434688
270,nearora-msft,52,0.01196,41444,9.53419,434688
271,shshashwat,52,0.01196,41496,9.54616,434688
272,stanleywbwong,52,0.01196,41548,9.55812,434688
273,andydiwenzhu,51,0.01173,41599,9.56985,434688
274,CodingPoeta,51,0.01173,41650,9.58158,434688
275,EnfangCui,51,0.01173,41701,9.59332,434688
276,MandssS,51,0.01173,41752,9.60505,434688
277,00pf00,50,0.01150,41802,9.61655,434688
278,bhumijgupta,50,0.01150,41852,9.62806,434688
279,capoferro,50,0.01150,41902,9.63956,434688
280,Acepie,49,0.01127,41951,9.65083,434688
281,artificial-aidan,49,0.01127,42000,9.66210,434688
282,fvaleri,49,0.01127,42049,9.67337,434688
283,HaloFour,49,0.01127,42098,9.68465,434688
284,krispraws,49,0.01127,42147,9.69592,434688
285,rajatgupta24,49,0.01127,42196,9.70719,434688
286,steven-my,49,0.01127,42245,9.71846,434688
287,TejasQ,49,0.01127,42294,9.72974,434688
288,howieyuen,48,0.01104,42342,9.74078,434688
289,jrkeen,48,0.01104,42390,9.75182,434688
290,mayjiang0203,48,0.01104,42438,9.76286,434688
291,NeverRaR,48,0.01104,42486,9.77391,434688
292,ngranander,48,0.01104,42534,9.78495,434688
293,regicsolutions,48,0.01104,42582,9.79599,434688
294,SahilKr24,48,0.01104,42630,9.80703,434688
295,skyduo,48,0.01104,42678,9.81808,434688
296,tydhot,48,0.01104,42726,9.82912,434688
297,CharLotteiu,47,0.01081,42773,9.83993,434688
298,matthewfala,47,0.01081,42820,9.85074,434688
299,ShubhamPalriwala,47,0.01081,42867,9.86156,434688
300,Tantalor93,47,0.01081,42914,9.87237,434688
301,yzhao1012,47,0.01081,42961,9.88318,434688
302,zhonghui12,47,0.01081,43008,9.89399,434688
303,almas33,46,0.01058,43054,9.90458,434688
304,chaseajen,46,0.01058,43100,9.91516,434688
305,dddddai,46,0.01058,43146,9.92574,434688
306,praveenghuge,46,0.01058,43192,9.93632,434688
307,samiramkr,46,0.01058,43238,9.94690,434688
308,13567436138,45,0.01035,43283,9.95726,434688
309,arajkumar,45,0.01035,43328,9.96761,434688
310,johann1000,45,0.01035,43373,9.97796,434688
311,michaelb990,45,0.01035,43418,9.98831,434688
312,pradeepcrao,45,0.01035,43463,9.99867,434688
313,rdpsin,45,0.01035,43508,10.00902,434688
314,Xynnn007,45,0.01035,43553,10.01937,434688
315,AvineshTripathi,44,0.01012,43597,10.02949,434688
316,captainsafia,44,0.01012,43641,10.03961,434688
317,RyanAoh,44,0.01012,43685,10.04974,434688
318,slayer321,44,0.01012,43729,10.05986,434688
319,chrisxrepo,43,0.00989,43772,10.06975,434688
320,colega,43,0.00989,43815,10.07964,434688
321,cwayne18,43,0.00989,43858,10.08954,434688
322,dimakow,43,0.00989,43901,10.09943,434688
323,divyansh-gupta,43,0.00989,43944,10.10932,434688
324,jaudiger,43,0.00989,43987,10.11921,434688
325,mgutierrez98,43,0.00989,44030,10.12910,434688
326,ottosichert,43,0.00989,44073,10.13900,434688
327,arthurpitman,42,0.00966,44115,10.14866,434688
328,CptSchnitz,42,0.00966,44157,10.15832,434688
329,fanriming,42,0.00966,44199,10.16798,434688
330,mamy-CS,42,0.00966,44241,10.17764,434688
331,mkjpryor,42,0.00966,44283,10.18731,434688
332,pwhelan,42,0.00966,44325,10.19697,434688
333,Aditya-Gollapudi,41,0.00943,44366,10.20640,434688
334,chengtangzheng2021,41,0.00943,44407,10.21583,434688
335,jackwener,41,0.00943,44448,10.22527,434688
336,kaiwalyakoparkar,41,0.00943,44489,10.23470,434688
337,manick02,41,0.00943,44530,10.24413,434688
338,utam0k,41,0.00943,44571,10.25356,434688
339,armsnyder,40,0.00920,44611,10.26276,434688
340,bodilb,40,0.00920,44651,10.27197,434688
341,calvin0327,40,0.00920,44691,10.28117,434688
342,JatinSanghvi,40,0.00920,44731,10.29037,434688
343,khalid-davis,40,0.00920,44771,10.29957,434688
344,mahalrs,40,0.00920,44811,10.30877,434688
345,perezjasonr,40,0.00920,44851,10.31798,434688
346,qinggniq,40,0.00920,44891,10.32718,434688
347,vangork,40,0.00920,44931,10.33638,434688
348,yanjunz97,40,0.00920,44971,10.34558,434688
349,fblgit,39,0.00897,45010,10.35455,434688
350,keshavcodex,39,0.00897,45049,10.36353,434688
351,lonelyCZ,39,0.00897,45088,10.37250,434688
352,lucy-cl,39,0.00897,45127,10.38147,434688
353,MSNev,39,0.00897,45166,10.39044,434688
354,suvadityamuk,39,0.00897,45205,10.39941,434688
355,tiancaiamao,39,0.00897,45244,10.40838,434688
356,VirrageS,39,0.00897,45283,10.41736,434688
357,yaocw2020,39,0.00897,45322,10.42633,434688
358,zonggen,39,0.00897,45361,10.43530,434688
359,HHogg,38,0.00874,45399,10.44404,434688
360,ipochi,38,0.00874,45437,10.45278,434688
361,jdmaguire,38,0.00874,45475,10.46153,434688
362,joeporpeglia,38,0.00874,45513,10.47027,434688
363,metonymic-smokey,38,0.00874,45551,10.47901,434688
364,oliviassss,38,0.00874,45589,10.48775,434688
365,stevesg,38,0.00874,45627,10.49649,434688
366,chandrasekhar1996,37,0.00851,45664,10.50501,434688
367,emaderer,37,0.00851,45701,10.51352,434688
368,EricWvi,37,0.00851,45738,10.52203,434688
369,jiangliu,37,0.00851,45775,10.53054,434688
370,livetocode,37,0.00851,45812,10.53905,434688
371,spiros-p,37,0.00851,45849,10.54757,434688
372,tobiasstadler,37,0.00851,45886,10.55608,434688
373,voigt,37,0.00851,45923,10.56459,434688
374,dilyanpalauzov,36,0.00828,45959,10.57287,434688
375,eminugurkenar,36,0.00828,45995,10.58115,434688
376,jaypume,36,0.00828,46031,10.58943,434688
377,mmorel-35,36,0.00828,46067,10.59772,434688
378,mrsabath,36,0.00828,46103,10.60600,434688
379,Patrick0308,36,0.00828,46139,10.61428,434688
380,rgl,36,0.00828,46175,10.62256,434688
381,saumeya,36,0.00828,46211,10.63084,434688
382,ulfjack,36,0.00828,46247,10.63913,434688
383,ddieruf,35,0.00805,46282,10.64718,434688
384,Elbehery,35,0.00805,46317,10.65523,434688
385,kirk-patton,35,0.00805,46352,10.66328,434688
386,ME-ON1,35,0.00805,46387,10.67133,434688
387,Mini256,35,0.00805,46422,10.67938,434688
388,niko-achilles,35,0.00805,46457,10.68744,434688
389,raphaelgavache,35,0.00805,46492,10.69549,434688
390,weyert,35,0.00805,46527,10.70354,434688
391,aviral26,34,0.00782,46561,10.71136,434688
392,chlins,34,0.00782,46595,10.71918,434688
393,jamesmoessis,34,0.00782,46629,10.72700,434688
394,prithvi1307,34,0.00782,46663,10.73483,434688
395,qdupuy,34,0.00782,46697,10.74265,434688
396,soham4abc,34,0.00782,46731,10.75047,434688
397,Sunnatillo,34,0.00782,46765,10.75829,434688
398,Tal-or,34,0.00782,46799,10.76611,434688
399,timmy59100,34,0.00782,46833,10.77393,434688
400,chengruizhe,33,0.00759,46866,10.78153,434688
401,fabianfett,33,0.00759,46899,10.78912,434688
402,kgh475926,33,0.00759,46932,10.79671,434688
403,LeoYang90,33,0.00759,46965,10.80430,434688
404,pirgeo,33,0.00759,46998,10.81189,434688
405,PratikBorhade302,33,0.00759,47031,10.81948,434688
406,scoof,33,0.00759,47064,10.82708,434688
407,seant-splunk,33,0.00759,47097,10.83467,434688
408,seishinsha,33,0.00759,47130,10.84226,434688
409,toelke,33,0.00759,47163,10.84985,434688
410,tokers,33,0.00759,47196,10.85744,434688
411,wanghong230,33,0.00759,47229,10.86503,434688
412,wangjsty,33,0.00759,47262,10.87263,434688
413,Yuggupta27,33,0.00759,47295,10.88022,434688
414,algebra2k,32,0.00736,47327,10.88758,434688
415,amino19,32,0.00736,47359,10.89494,434688
416,aplanas,32,0.00736,47391,10.90230,434688
417,cleveritcz,32,0.00736,47423,10.90966,434688
418,dellThejas,32,0.00736,47455,10.91703,434688
419,gary-tai,32,0.00736,47487,10.92439,434688
420,gebn,32,0.00736,47519,10.93175,434688
421,jtmalinowski,32,0.00736,47551,10.93911,434688
422,kelvinguo0210,32,0.00736,47583,10.94647,434688
423,kirbyquerby,32,0.00736,47615,10.95383,434688
424,luyou86,32,0.00736,47647,10.96120,434688
425,moredure,32,0.00736,47679,10.96856,434688
426,morgwai,32,0.00736,47711,10.97592,434688
427,oertl,32,0.00736,47743,10.98328,434688
428,qiuax,32,0.00736,47775,10.99064,434688
429,Rohan-cod,32,0.00736,47807,10.99800,434688
430,ueno,32,0.00736,47839,11.00536,434688
431,vigith,32,0.00736,47871,11.01273,434688
432,coolamiy,31,0.00713,47902,11.01986,434688
433,dirien,31,0.00713,47933,11.02699,434688
434,first-sight12,31,0.00713,47964,11.03412,434688
435,gooney152,31,0.00713,47995,11.04125,434688
436,JamesMBartlett,31,0.00713,48026,11.04838,434688
437,JCzz,31,0.00713,48057,11.05552,434688
438,marianabocoi,31,0.00713,48088,11.06265,434688
439,merryzhou,31,0.00713,48119,11.06978,434688
440,nakamasato,31,0.00713,48150,11.07691,434688
441,nhynes,31,0.00713,48181,11.08404,434688
442,pawelmitka,31,0.00713,48212,11.09117,434688
443,pragmaticivan,31,0.00713,48243,11.09830,434688
444,Somoshree,31,0.00713,48274,11.10544,434688
445,t00350320,31,0.00713,48305,11.11257,434688
446,temawi,31,0.00713,48336,11.11970,434688
447,yotamloe,31,0.00713,48367,11.12683,434688
448,zyyw,31,0.00713,48398,11.13396,434688
449,amoore877,30,0.00690,48428,11.14086,434688
450,ChristianCiach,30,0.00690,48458,11.14777,434688
451,FedeDP,30,0.00690,48488,11.15467,434688
452,GrahamCampbell,30,0.00690,48518,11.16157,434688
453,hprajapati-splunk,30,0.00690,48548,11.16847,434688
454,ikepolinsky,30,0.00690,48578,11.17537,434688
455,Kakemone,30,0.00690,48608,11.18227,434688
456,LDawns,30,0.00690,48638,11.18917,434688
457,mardim91,30,0.00690,48668,11.19608,434688
458,Pike,30,0.00690,48698,11.20298,434688
459,samip5,30,0.00690,48728,11.20988,434688
460,sdghchj,30,0.00690,48758,11.21678,434688
461,sotoiwa,30,0.00690,48788,11.22368,434688
462,tiny-x,30,0.00690,48818,11.23058,434688
463,aamirqs,29,0.00667,48847,11.23726,434688
464,aiyijing,29,0.00667,48876,11.24393,434688
465,ajanth97,29,0.00667,48905,11.25060,434688
466,ammmze,29,0.00667,48934,11.25727,434688
467,dee0,29,0.00667,48963,11.26394,434688
468,garrettwegan,29,0.00667,48992,11.27061,434688
469,henryZrncik,29,0.00667,49021,11.27728,434688
470,ish-xyz,29,0.00667,49050,11.28396,434688
471,jasondellaluce,29,0.00667,49079,11.29063,434688
472,josephsawaya,29,0.00667,49108,11.29730,434688
473,mra-ruiz,29,0.00667,49137,11.30397,434688
474,nick5616,29,0.00667,49166,11.31064,434688
475,niteshkumarniranjan,29,0.00667,49195,11.31731,434688
476,rscampos,29,0.00667,49224,11.32398,434688
477,shichun-0415,29,0.00667,49253,11.33066,434688
478,suhaniii,29,0.00667,49282,11.33733,434688
479,tech-geek29,29,0.00667,49311,11.34400,434688
480,tonyxuqqi,29,0.00667,49340,11.35067,434688
481,vcozzolino,29,0.00667,49369,11.35734,434688
482,chenmudu,28,0.00644,49397,11.36378,434688
483,daimashusheng,28,0.00644,49425,11.37022,434688
484,dubious90,28,0.00644,49453,11.37667,434688
485,gnunu,28,0.00644,49481,11.38311,434688
486,hyunuk,28,0.00644,49509,11.38955,434688
487,ikarldasan,28,0.00644,49537,11.39599,434688
488,jjackson-s,28,0.00644,49565,11.40243,434688
489,jonathansp,28,0.00644,49593,11.40887,434688
490,Karthik-K-N,28,0.00644,49621,11.41531,434688
491,NikhilSharmaWe,28,0.00644,49649,11.42176,434688
492,ojhaarjun1,28,0.00644,49677,11.42820,434688
493,prasaria,28,0.00644,49705,11.43464,434688
494,Shatakshi0805,28,0.00644,49733,11.44108,434688
495,tangsaidi,28,0.00644,49761,11.44752,434688
496,YaseenAlk,28,0.00644,49789,11.45396,434688
497,aaron-ai,27,0.00621,49816,11.46017,434688
498,afzal442,27,0.00621,49843,11.46639,434688
499,chrismetz09,27,0.00621,49870,11.47260,434688
500,deepak-bhardwaj-ps,27,0.00621,49897,11.47881,434688
501,EririSawamura,27,0.00621,49924,11.48502,434688
502,fapatel1,27,0.00621,49951,11.49123,434688
503,IcePigZDB,27,0.00621,49978,11.49744,434688
504,lambdanis,27,0.00621,50005,11.50365,434688
505,liangyouze,27,0.00621,50032,11.50986,434688
506,Mrod1598,27,0.00621,50059,11.51608,434688
507,phillipsj,27,0.00621,50086,11.52229,434688
508,rtsp,27,0.00621,50113,11.52850,434688
509,shhdgit,27,0.00621,50140,11.53471,434688
510,windowsrefund,27,0.00621,50167,11.54092,434688
511,xavier-rbz,27,0.00621,50194,11.54713,434688
512,andreafalzetti,26,0.00598,50220,11.55311,434688
513,Anubhavjoshi040,26,0.00598,50246,11.55910,434688
514,arturgspb,26,0.00598,50272,11.56508,434688
515,chaitravi-ce,26,0.00598,50298,11.57106,434688
516,chicoribas,26,0.00598,50324,11.57704,434688
517,chirangaalwis,26,0.00598,50350,11.58302,434688
518,chuliang014,26,0.00598,50376,11.58900,434688
519,ESonata,26,0.00598,50402,11.59498,434688
520,joyliu-q,26,0.00598,50428,11.60096,434688
521,just1900,26,0.00598,50454,11.60695,434688
522,kenvifire,26,0.00598,50480,11.61293,434688
523,KuberDriver,26,0.00598,50506,11.61891,434688
524,kvrhdn,26,0.00598,50532,11.62489,434688
525,lakshya8066,26,0.00598,50558,11.63087,434688
526,MarcosNBJ,26,0.00598,50584,11.63685,434688
527,MooreZheng,26,0.00598,50610,11.64283,434688
528,r03942139,26,0.00598,50636,11.64881,434688
529,raisaat,26,0.00598,50662,11.65480,434688
530,romberli,26,0.00598,50688,11.66078,434688
531,rypdal,26,0.00598,50714,11.66676,434688
532,thisisommore,26,0.00598,50740,11.67274,434688
533,TomHellier,26,0.00598,50766,11.67872,434688
534,vvvprabhakar,26,0.00598,50792,11.68470,434688
535,1995parham,25,0.00575,50817,11.69045,434688
536,banothurameshnaik,25,0.00575,50842,11.69621,434688
537,danibachar,25,0.00575,50867,11.70196,434688
538,hrittikhere,25,0.00575,50892,11.70771,434688
539,marshall007,25,0.00575,50917,11.71346,434688
540,MisterMX,25,0.00575,50942,11.71921,434688
541,msamad,25,0.00575,50967,11.72496,434688
542,Raj-Dharwadkar,25,0.00575,50992,11.73071,434688
543,tnthornton,25,0.00575,51017,11.73646,434688
544,zmapleshine,25,0.00575,51042,11.74222,434688
545,ajwock,24,0.00552,51066,11.74774,434688
546,bojand,24,0.00552,51090,11.75326,434688
547,dlapcevic,24,0.00552,51114,11.75878,434688
548,faraktingi,24,0.00552,51138,11.76430,434688
549,Haimantika,24,0.00552,51162,11.76982,434688
550,larivierec,24,0.00552,51186,11.77534,434688
551,lowang-bh,24,0.00552,51210,11.78086,434688
552,lquerel,24,0.00552,51234,11.78638,434688
553,lucklypse,24,0.00552,51258,11.79191,434688
554,neilalexander,24,0.00552,51282,11.79743,434688
555,NikhilSharma03,24,0.00552,51306,11.80295,434688
556,prashanth-volvocars,24,0.00552,51330,11.80847,434688
557,purelind,24,0.00552,51354,11.81399,434688
558,RealAnna,24,0.00552,51378,11.81951,434688
559,siforster,24,0.00552,51402,11.82503,434688
560,Tingtal,24,0.00552,51426,11.83055,434688
561,vaspahomov,24,0.00552,51450,11.83608,434688
562,wanjunlei,24,0.00552,51474,11.84160,434688
563,YanivD,24,0.00552,51498,11.84712,434688
564,zhxie,24,0.00552,51522,11.85264,434688
565,able8,23,0.00529,51545,11.85793,434688
566,AliMD,23,0.00529,51568,11.86322,434688
567,Alos,23,0.00529,51591,11.86851,434688
568,aureliosaraiva,23,0.00529,51614,11.87380,434688
569,brunojcm,23,0.00529,51637,11.87909,434688
570,CooperLi,23,0.00529,51660,11.88439,434688
571,DrewZhang13,23,0.00529,51683,11.88968,434688
572,Ed87,23,0.00529,51706,11.89497,434688
573,EmilienM,23,0.00529,51729,11.90026,434688
574,flokli,23,0.00529,51752,11.90555,434688
575,hlee95,23,0.00529,51775,11.91084,434688
576,hustliyilin,23,0.00529,51798,11.91613,434688
577,ikeeip,23,0.00529,51821,11.92142,434688
578,itustanic,23,0.00529,51844,11.92672,434688
579,jamesdbloom,23,0.00529,51867,11.93201,434688
580,jeffzhu503,23,0.00529,51890,11.93730,434688
581,Lakshya8066,23,0.00529,51913,11.94259,434688
582,LeoLiuYan,23,0.00529,51936,11.94788,434688
583,liuminjian,23,0.00529,51959,11.95317,434688
584,liz-acosta,23,0.00529,51982,11.95846,434688
585,mikemrm,23,0.00529,52005,11.96375,434688
586,moraesjeremias,23,0.00529,52028,11.96904,434688
587,nicolasarnold12321,23,0.00529,52051,11.97434,434688
588,rosskirkpat,23,0.00529,52074,11.97963,434688
589,tylerslaton,23,0.00529,52097,11.98492,434688
590,wujiangfa-xlauncher,23,0.00529,52120,11.99021,434688
591,56quarters,22,0.00506,52142,11.99527,434688
592,ad22,22,0.00506,52164,12.00033,434688
593,burntcarrot,22,0.00506,52186,12.00539,434688
594,candlerb,22,0.00506,52208,12.01045,434688
595,CaoDonghui123,22,0.00506,52230,12.01551,434688
596,chriswldenyer,22,0.00506,52252,12.02058,434688
597,cris-he,22,0.00506,52274,12.02564,434688
598,darshanhs09,22,0.00506,52296,12.03070,434688
599,deepsm007,22,0.00506,52318,12.03576,434688
600,huchen2021,22,0.00506,52340,12.04082,434688
601,jaikratsinghtariyal,22,0.00506,52362,12.04588,434688
602,ke-jobs,22,0.00506,52384,12.05094,434688
603,lastchiliarch,22,0.00506,52406,12.05600,434688
604,mattxwang,22,0.00506,52428,12.06106,434688
605,mshalmanov,22,0.00506,52450,12.06613,434688
606,musicinmybrain,22,0.00506,52472,12.07119,434688
607,nadworny,22,0.00506,52494,12.07625,434688
608,pydctw,22,0.00506,52516,12.08131,434688
609,RobberPhex,22,0.00506,52538,12.08637,434688
610,sakateka,22,0.00506,52560,12.09143,434688
611,sharkymcdongles,22,0.00506,52582,12.09649,434688
612,sunstonesecure-robert,22,0.00506,52604,12.10155,434688
613,TAODEI,22,0.00506,52626,12.10661,434688
614,tremorbot,22,0.00506,52648,12.11168,434688
615,vanugrah,22,0.00506,52670,12.11674,434688
616,Abirdcfly,21,0.00483,52691,12.12157,434688
617,antoineozenne,21,0.00483,52712,12.12640,434688
618,AugustinasS,21,0.00483,52733,12.13123,434688
619,bpinske,21,0.00483,52754,12.13606,434688
620,cospotato,21,0.00483,52775,12.14089,434688
621,daniel-codefresh,21,0.00483,52796,12.14572,434688
622,dpeer6,21,0.00483,52817,12.15055,434688
623,DrAuYueng,21,0.00483,52838,12.15539,434688
624,DysphoricUnicorn,21,0.00483,52859,12.16022,434688
625,GabrielLasso,21,0.00483,52880,12.16505,434688
626,gionapaolini,21,0.00483,52901,12.16988,434688
627,GreyBalloonYU,21,0.00483,52922,12.17471,434688
628,Grunet,21,0.00483,52943,12.17954,434688
629,hanamantagoudvk,21,0.00483,52964,12.18437,434688
630,HannahShiSFB,21,0.00483,52985,12.18920,434688
631,haslersn,21,0.00483,53006,12.19403,434688
632,irizzant,21,0.00483,53027,12.19886,434688
633,jdcormie,21,0.00483,53048,12.20370,434688
634,jeffmaury,21,0.00483,53069,12.20853,434688
635,JohnRusk,21,0.00483,53090,12.21336,434688
636,Kiddinglife,21,0.00483,53111,12.21819,434688
637,kiranpatel11,21,0.00483,53132,12.22302,434688
638,kishaningithub,21,0.00483,53153,12.22785,434688
639,KSerrania,21,0.00483,53174,12.23268,434688
640,LanceEa,21,0.00483,53195,12.23751,434688
641,lancoLiu,21,0.00483,53216,12.24234,434688
642,luosiqi,21,0.00483,53237,12.24717,434688
643,luoyunhe,21,0.00483,53258,12.25201,434688
644,mamil,21,0.00483,53279,12.25684,434688
645,MMerzinger,21,0.00483,53300,12.26167,434688
646,Rakshith-R,21,0.00483,53321,12.26650,434688
647,reddymahendra52,21,0.00483,53342,12.27133,434688
648,royeo,21,0.00483,53363,12.27616,434688
649,skyguard1,21,0.00483,53384,12.28099,434688
650,stingshen,21,0.00483,53405,12.28582,434688
651,superleo,21,0.00483,53426,12.29065,434688
652,ultradio,21,0.00483,53447,12.29549,434688
653,wasker,21,0.00483,53468,12.30032,434688
654,zhan9san,21,0.00483,53489,12.30515,434688
655,AnirudhPanda,20,0.00460,53509,12.30975,434688
656,bpoland,20,0.00460,53529,12.31435,434688
657,cfz,20,0.00460,53549,12.31895,434688
658,colibie,20,0.00460,53569,12.32355,434688
659,cyclinder,20,0.00460,53589,12.32815,434688
660,danfromtitan,20,0.00460,53609,12.33275,434688
661,degorenko,20,0.00460,53629,12.33735,434688
662,elakito,20,0.00460,53649,12.34196,434688
663,hierynomus,20,0.00460,53669,12.34656,434688
664,JamesJHPark,20,0.00460,53689,12.35116,434688
665,JiaoDean,20,0.00460,53709,12.35576,434688
666,jonathino2590,20,0.00460,53729,12.36036,434688
667,julioz,20,0.00460,53749,12.36496,434688
668,NoicFank,20,0.00460,53769,12.36956,434688
669,OuesFa,20,0.00460,53789,12.37416,434688
670,paul-r-gall,20,0.00460,53809,12.37876,434688
671,ReigenDing,20,0.00460,53829,12.38336,434688
672,sahilvv,20,0.00460,53849,12.38797,434688
673,sanderson042,20,0.00460,53869,12.39257,434688
674,sushil-prasad,20,0.00460,53889,12.39717,434688
675,tylern91,20,0.00460,53909,12.40177,434688
676,vykulakov,20,0.00460,53929,12.40637,434688
677,xp-1000,20,0.00460,53949,12.41097,434688
678,yanlingsishao,20,0.00460,53969,12.41557,434688
679,YousefHaggyHeroku,20,0.00460,53989,12.42017,434688
680,zhugelianglongming,20,0.00460,54009,12.42477,434688
681,artqzn,19,0.00437,54028,12.42914,434688
682,birenroy,19,0.00437,54047,12.43352,434688
683,c0va23,19,0.00437,54066,12.43789,434688
684,catblade,19,0.00437,54085,12.44226,434688
685,defaultbr,19,0.00437,54104,12.44663,434688
686,dmeytin,19,0.00437,54123,12.45100,434688
687,gusfcarvalho,19,0.00437,54142,12.45537,434688
688,hans-d,19,0.00437,54161,12.45974,434688
689,Happy2C0de,19,0.00437,54180,12.46411,434688
690,indera-shsp,19,0.00437,54199,12.46848,434688
691,ixodie,19,0.00437,54218,12.47285,434688
692,jepio,19,0.00437,54237,12.47723,434688
693,jr0dd,19,0.00437,54256,12.48160,434688
694,karunasagark,19,0.00437,54275,12.48597,434688
695,lambneo,19,0.00437,54294,12.49034,434688
696,ljkiraly,19,0.00437,54313,12.49471,434688
697,m-Bilal,19,0.00437,54332,12.49908,434688
698,mikhailswift,19,0.00437,54351,12.50345,434688
699,owent,19,0.00437,54370,12.50782,434688
700,pchan,19,0.00437,54389,12.51219,434688
701,pianiststickman,19,0.00437,54408,12.51656,434688
702,PratikDeoghare,19,0.00437,54427,12.52093,434688
703,PredatorVI,19,0.00437,54446,12.52531,434688
704,qixiaobo,19,0.00437,54465,12.52968,434688
705,ragashreeshekar,19,0.00437,54484,12.53405,434688
706,RichardoC,19,0.00437,54503,12.53842,434688
707,robin-wayve,19,0.00437,54522,12.54279,434688
708,sergioarmgpl,19,0.00437,54541,12.54716,434688
709,spaparaju,19,0.00437,54560,12.55153,434688
710,steeling,19,0.00437,54579,12.55590,434688
711,superbigsea,19,0.00437,54598,12.56027,434688
712,tbarker25,19,0.00437,54617,12.56464,434688
713,v01dstar,19,0.00437,54636,12.56902,434688
714,WillardHu,19,0.00437,54655,12.57339,434688
715,wllenyj,19,0.00437,54674,12.57776,434688
716,yangxiaoliang,19,0.00437,54693,12.58213,434688
717,zwpaper,19,0.00437,54712,12.58650,434688
718,agilob,18,0.00414,54730,12.59064,434688
719,akharlamov,18,0.00414,54748,12.59478,434688
720,arsheelsheikh,18,0.00414,54766,12.59892,434688
721,barticus,18,0.00414,54784,12.60306,434688
722,book987,18,0.00414,54802,12.60720,434688
723,cbuto,18,0.00414,54820,12.61134,434688
724,Charley-Mann,18,0.00414,54838,12.61549,434688
725,DARK-art108,18,0.00414,54856,12.61963,434688
726,daxpedda,18,0.00414,54874,12.62377,434688
727,ethan-lowman-dd,18,0.00414,54892,12.62791,434688
728,fzhan,18,0.00414,54910,12.63205,434688
729,harsh288,18,0.00414,54928,12.63619,434688
730,iamsumee,18,0.00414,54946,12.64033,434688
731,icelynjennings,18,0.00414,54964,12.64447,434688
732,j2gg0s,18,0.00414,54982,12.64861,434688
733,js8080,18,0.00414,55000,12.65275,434688
734,lcwangchao,18,0.00414,55018,12.65689,434688
735,lining2020x,18,0.00414,55036,12.66104,434688
736,luwang-vmware,18,0.00414,55054,12.66518,434688
737,marcosdiez,18,0.00414,55072,12.66932,434688
738,mehabhalodiya,18,0.00414,55090,12.67346,434688
739,monojit18,18,0.00414,55108,12.67760,434688
740,nar3k,18,0.00414,55126,12.68174,434688
741,pabloopez,18,0.00414,55144,12.68588,434688
742,patrick-stephens,18,0.00414,55162,12.69002,434688
743,ramrodo,18,0.00414,55180,12.69416,434688
744,ritwizsinha,18,0.00414,55198,12.69830,434688
745,rmoriar1,18,0.00414,55216,12.70244,434688
746,Rocksnake,18,0.00414,55234,12.70658,434688
747,spirosoik,18,0.00414,55252,12.71073,434688
748,tymokvo,18,0.00414,55270,12.71487,434688
749,VivekThrivikraman-est,18,0.00414,55288,12.71901,434688
750,wdma,18,0.00414,55306,12.72315,434688
751,zhu733756,18,0.00414,55324,12.72729,434688
752,zjq123456,18,0.00414,55342,12.73143,434688
753,zwennesm,18,0.00414,55360,12.73557,434688
754,adrdc,17,0.00391,55377,12.73948,434688
755,amirschw,17,0.00391,55394,12.74339,434688
756,anirudhbagri,17,0.00391,55411,12.74730,434688
757,bang9211,17,0.00391,55428,12.75121,434688
758,biskit,17,0.00391,55445,12.75513,434688
759,bunniseng,17,0.00391,55462,12.75904,434688
760,cgoncalves,17,0.00391,55479,12.76295,434688
761,dak-x,17,0.00391,55496,12.76686,434688
762,darryl-sw,17,0.00391,55513,12.77077,434688
763,edithturn,17,0.00391,55530,12.77468,434688
764,EmilyShepherd,17,0.00391,55547,12.77859,434688
765,EmisonLu,17,0.00391,55564,12.78250,434688
766,fengypants,17,0.00391,55581,12.78641,434688
767,FeynmanZhou,17,0.00391,55598,12.79032,434688
768,FilipSwiatczak,17,0.00391,55615,12.79423,434688
769,fusida,17,0.00391,55632,12.79814,434688
770,Guneetconvent2002,17,0.00391,55649,12.80206,434688
771,hdf15804299051,17,0.00391,55666,12.80597,434688
772,JBBianchi,17,0.00391,55683,12.80988,434688
773,jdnurme,17,0.00391,55700,12.81379,434688
774,jibuji,17,0.00391,55717,12.81770,434688
775,JonZeolla,17,0.00391,55734,12.82161,434688
776,jpmcb,17,0.00391,55751,12.82552,434688
777,kkalin68,17,0.00391,55768,12.82943,434688
778,lipingxue,17,0.00391,55785,12.83334,434688
779,lkakarla,17,0.00391,55802,12.83725,434688
780,lucianozablocki,17,0.00391,55819,12.84116,434688
781,m-linner-ericsson,17,0.00391,55836,12.84508,434688
782,mraghu4,17,0.00391,55853,12.84899,434688
783,Muscule,17,0.00391,55870,12.85290,434688
784,nzicecool,17,0.00391,55887,12.85681,434688
785,Pan-Bubr,17,0.00391,55904,12.86072,434688
786,prashantpandey9,17,0.00391,55921,12.86463,434688
787,pxp928,17,0.00391,55938,12.86854,434688
788,rajibmitra,17,0.00391,55955,12.87245,434688
789,rudeigerc,17,0.00391,55972,12.87636,434688
790,samarara,17,0.00391,55989,12.88027,434688
791,shawkins,17,0.00391,56006,12.88418,434688
792,smile-luobin,17,0.00391,56023,12.88809,434688
793,Smita8081,17,0.00391,56040,12.89201,434688
794,sysnet4admin,17,0.00391,56057,12.89592,434688
795,talcoh2x,17,0.00391,56074,12.89983,434688
796,timchenxiaoyu,17,0.00391,56091,12.90374,434688
797,unnati914,17,0.00391,56108,12.90765,434688
798,vishjain,17,0.00391,56125,12.91156,434688
799,wenchajun,17,0.00391,56142,12.91547,434688
800,wshwsh12,17,0.00391,56159,12.91938,434688
801,xiaoxiaobaba,17,0.00391,56176,12.92329,434688
802,ydrozhdzhal,17,0.00391,56193,12.92720,434688
803,zirain,17,0.00391,56210,12.93111,434688
804,zyjhtangtang,17,0.00391,56227,12.93502,434688
805,0x6a77,16,0.00368,56243,12.93871,434688
806,844700118,16,0.00368,56259,12.94239,434688
807,aaronjheng,16,0.00368,56275,12.94607,434688
808,adrianke77,16,0.00368,56291,12.94975,434688
809,aholic,16,0.00368,56307,12.95343,434688
810,alichnewsky,16,0.00368,56323,12.95711,434688
811,AlwaySummit,16,0.00368,56339,12.96079,434688
812,amitkatyal,16,0.00368,56355,12.96447,434688
813,aparajita89,16,0.00368,56371,12.96815,434688
814,bhks,16,0.00368,56387,12.97183,434688
815,calvinpark,16,0.00368,56403,12.97551,434688
816,CatherineF-dev,16,0.00368,56419,12.97919,434688
817,chou-shun,16,0.00368,56435,12.98288,434688
818,christian-oudard,16,0.00368,56451,12.98656,434688
819,CollinShoop,16,0.00368,56467,12.99024,434688
820,danquah,16,0.00368,56483,12.99392,434688
821,dee0sap,16,0.00368,56499,12.99760,434688
822,dennis-brinley,16,0.00368,56515,13.00128,434688
823,divolgin,16,0.00368,56531,13.00496,434688
824,doujiang24,16,0.00368,56547,13.00864,434688
825,duttaANI,16,0.00368,56563,13.01232,434688
826,ethernoy,16,0.00368,56579,13.01600,434688
827,fsduser,16,0.00368,56595,13.01968,434688
828,Hangzhi,16,0.00368,56611,13.02336,434688
829,herbguo,16,0.00368,56627,13.02704,434688
830,ihgann,16,0.00368,56643,13.03073,434688
831,jamiees2,16,0.00368,56659,13.03441,434688
832,Jarema,16,0.00368,56675,13.03809,434688
833,Jessica-wang-0816,16,0.00368,56691,13.04177,434688
834,Jishun,16,0.00368,56707,13.04545,434688
835,johnlanni,16,0.00368,56723,13.04913,434688
836,jonchurch,16,0.00368,56739,13.05281,434688
837,Kate-DONG,16,0.00368,56755,13.05649,434688
838,kinsolee,16,0.00368,56771,13.06017,434688
839,lakamsani,16,0.00368,56787,13.06385,434688
840,marcportabellaclotet-mt,16,0.00368,56803,13.06753,434688
841,mattstratton,16,0.00368,56819,13.07121,434688
842,Moutix,16,0.00368,56835,13.07490,434688
843,muhamadto,16,0.00368,56851,13.07858,434688
844,nic-chen,16,0.00368,56867,13.08226,434688
845,nigupta1,16,0.00368,56883,13.08594,434688
846,peilii,16,0.00368,56899,13.08962,434688
847,pengweiqhca,16,0.00368,56915,13.09330,434688
848,rck,16,0.00368,56931,13.09698,434688
849,rockmenjack,16,0.00368,56947,13.10066,434688
850,rturner-edjuster,16,0.00368,56963,13.10434,434688
851,semharel,16,0.00368,56979,13.10802,434688
852,sgpinkus,16,0.00368,56995,13.11170,434688
853,shangma,16,0.00368,57011,13.11538,434688
854,shuker85,16,0.00368,57027,13.11906,434688
855,Submarinee,16,0.00368,57043,13.12275,434688
856,telmich,16,0.00368,57059,13.12643,434688
857,TheDiveO,16,0.00368,57075,13.13011,434688
858,vinzscam,16,0.00368,57091,13.13379,434688
859,wangyanghack,16,0.00368,57107,13.13747,434688
860,xxx0624,16,0.00368,57123,13.14115,434688
861,xyz-li,16,0.00368,57139,13.14483,434688
862,yatinmaan,16,0.00368,57155,13.14851,434688
863,Zhanxueyou,16,0.00368,57171,13.15219,434688
864,amirhadadi,15,0.00345,57186,13.15564,434688
865,Anders-PlanetScale,15,0.00345,57201,13.15909,434688
866,arash-bizcover,15,0.00345,57216,13.16254,434688
867,artifacthubio,15,0.00345,57231,13.16599,434688
868,base698,15,0.00345,57246,13.16945,434688
869,budhirajamadhav,15,0.00345,57261,13.17290,434688
870,cbwilliamsnh,15,0.00345,57276,13.17635,434688
871,ccnankai,15,0.00345,57291,13.17980,434688
872,cfzjywxk,15,0.00345,57306,13.18325,434688
873,clarck,15,0.00345,57321,13.18670,434688
874,coder543,15,0.00345,57336,13.19015,434688
875,cpapazian,15,0.00345,57351,13.19360,434688
876,cwildman,15,0.00345,57366,13.19705,434688
877,DelusionalOptimist,15,0.00345,57381,13.20050,434688
878,dimbleby,15,0.00345,57396,13.20395,434688
879,dsavitskiy,15,0.00345,57411,13.20740,434688
880,echoontheway,15,0.00345,57426,13.21085,434688
881,empath-nirvana,15,0.00345,57441,13.21431,434688
882,eric846,15,0.00345,57456,13.21776,434688
883,gsabatini2016,15,0.00345,57471,13.22121,434688
884,hbgongen,15,0.00345,57486,13.22466,434688
885,HecarimV,15,0.00345,57501,13.22811,434688
886,ichn-hu,15,0.00345,57516,13.23156,434688
887,itaispiegel,15,0.00345,57531,13.23501,434688
888,ItayGibel-heliosphere,15,0.00345,57546,13.23846,434688
889,jesusprubio,15,0.00345,57561,13.24191,434688
890,jk-intuit,15,0.00345,57576,13.24536,434688
891,js-timbirkett,15,0.00345,57591,13.24881,434688
892,kbreit,15,0.00345,57606,13.25226,434688
893,Kern--,15,0.00345,57621,13.25571,434688
894,koozz,15,0.00345,57636,13.25917,434688
895,krasimirdermendzhiev,15,0.00345,57651,13.26262,434688
896,lmajercak-wish,15,0.00345,57666,13.26607,434688
897,LuckySB,15,0.00345,57681,13.26952,434688
898,lynxcat,15,0.00345,57696,13.27297,434688
899,magnate3,15,0.00345,57711,13.27642,434688
900,mol-george,15,0.00345,57726,13.27987,434688
901,mprimeaux,15,0.00345,57741,13.28332,434688
902,MrYueQ,15,0.00345,57756,13.28677,434688
903,njnygaard,15,0.00345,57771,13.29022,434688
904,oxeye-nikolay,15,0.00345,57786,13.29367,434688
905,pkit,15,0.00345,57801,13.29712,434688
906,Rahul-D78,15,0.00345,57816,13.30057,434688
907,rashmichandrashekar,15,0.00345,57831,13.30402,434688
908,rdileep13,15,0.00345,57846,13.30748,434688
909,RedBoneZhang,15,0.00345,57861,13.31093,434688
910,rjhenry,15,0.00345,57876,13.31438,434688
911,scalen,15,0.00345,57891,13.31783,434688
912,shilpa-0,15,0.00345,57906,13.32128,434688
913,shivam-51,15,0.00345,57921,13.32473,434688
914,Shuanglu,15,0.00345,57936,13.32818,434688
915,sky-philipalmeida,15,0.00345,57951,13.33163,434688
916,sonukushwaha403,15,0.00345,57966,13.33508,434688
917,sugangli,15,0.00345,57981,13.33853,434688
918,swav,15,0.00345,57996,13.34198,434688
919,tillig,15,0.00345,58011,13.34543,434688
920,tnevolin,15,0.00345,58026,13.34888,434688
921,uds5501,15,0.00345,58041,13.35234,434688
922,ursaregina,15,0.00345,58056,13.35579,434688
923,vdwees,15,0.00345,58071,13.35924,434688
924,victor-sudakov,15,0.00345,58086,13.36269,434688
925,wangpu666,15,0.00345,58101,13.36614,434688
926,weiwenli97,15,0.00345,58116,13.36959,434688
927,yoave23,15,0.00345,58131,13.37304,434688
928,yochannah,15,0.00345,58146,13.37649,434688
929,zenbones,15,0.00345,58161,13.37994,434688
930,ZhengJuCn,15,0.00345,58176,13.38339,434688
931,ahtsan,14,0.00322,58190,13.38661,434688
932,akhramov,14,0.00322,58204,13.38983,434688
933,akuzni2,14,0.00322,58218,13.39305,434688
934,Amishakumari544,14,0.00322,58232,13.39628,434688
935,anne-eli,14,0.00322,58246,13.39950,434688
936,bhoriuchi,14,0.00322,58260,13.40272,434688
937,boukeversteegh,14,0.00322,58274,13.40594,434688
938,bpotaczek,14,0.00322,58288,13.40916,434688
939,chanow816,14,0.00322,58302,13.41238,434688
940,chirabino,14,0.00322,58316,13.41560,434688
941,Darshnadas,14,0.00322,58330,13.41882,434688
942,davidlanouette,14,0.00322,58344,13.42204,434688
943,dbgoytia,14,0.00322,58358,13.42526,434688
944,DCjanus,14,0.00322,58372,13.42848,434688
945,dlaube,14,0.00322,58386,13.43170,434688
946,eperdeme,14,0.00322,58400,13.43492,434688
947,grzn,14,0.00322,58414,13.43814,434688
948,hacker-qian,14,0.00322,58428,13.44136,434688
949,hide-in-code,14,0.00322,58442,13.44459,434688
950,izarraga,14,0.00322,58456,13.44781,434688
951,jawabuu,14,0.00322,58470,13.45103,434688
952,JensenJian,14,0.00322,58484,13.45425,434688
953,jialanli,14,0.00322,58498,13.45747,434688
954,johnxiaohe,14,0.00322,58512,13.46069,434688
955,jtgrabowski,14,0.00322,58526,13.46391,434688
956,king-jingxiang,14,0.00322,58540,13.46713,434688
957,MaazKhan711635,14,0.00322,58554,13.47035,434688
958,mfbrj,14,0.00322,58568,13.47357,434688
959,morlay,14,0.00322,58582,13.47679,434688
960,mstarostik,14,0.00322,58596,13.48001,434688
961,mstrent,14,0.00322,58610,13.48323,434688
962,mwipplinger-ftapi,14,0.00322,58624,13.48645,434688
963,natalisucks,14,0.00322,58638,13.48968,434688
964,neinkeinkaffee,14,0.00322,58652,13.49290,434688
965,nicktate,14,0.00322,58666,13.49612,434688
966,nicon89,14,0.00322,58680,13.49934,434688
967,nitinatgh,14,0.00322,58694,13.50256,434688
968,oakad,14,0.00322,58708,13.50578,434688
969,oliversalzburg,14,0.00322,58722,13.50900,434688
970,papigers,14,0.00322,58736,13.51222,434688
971,PatrickHuetter,14,0.00322,58750,13.51544,434688
972,perdasilva,14,0.00322,58764,13.51866,434688
973,ReillyBrogan,14,0.00322,58778,13.52188,434688
974,RemiGaudin,14,0.00322,58792,13.52510,434688
975,rgrupesh,14,0.00322,58806,13.52832,434688
976,rubroboletus,14,0.00322,58820,13.53154,434688
977,sanxun0325,14,0.00322,58834,13.53477,434688
978,satrox28,14,0.00322,58848,13.53799,434688
979,seveirbian,14,0.00322,58862,13.54121,434688
980,skogta,14,0.00322,58876,13.54443,434688
981,slomo28,14,0.00322,58890,13.54765,434688
982,sunkararp,14,0.00322,58904,13.55087,434688
983,syelburgi,14,0.00322,58918,13.55409,434688
984,tobiaskohlbau,14,0.00322,58932,13.55731,434688
985,ubergesundheit,14,0.00322,58946,13.56053,434688
986,we4tech,14,0.00322,58960,13.56375,434688
987,yadneshk,14,0.00322,58974,13.56697,434688
988,yangtian9999,14,0.00322,58988,13.57019,434688
989,yebyen,14,0.00322,59002,13.57341,434688
990,Yun-Ting,14,0.00322,59016,13.57663,434688
991,yylt,14,0.00322,59030,13.57985,434688
992,yzhao244,14,0.00322,59044,13.58308,434688
993,ainhoaL,13,0.00299,59057,13.58607,434688
994,alwaysastudent,13,0.00299,59070,13.58906,434688
995,Amulyam24,13,0.00299,59083,13.59205,434688
996,bchatelard,13,0.00299,59096,13.59504,434688
997,benukhanov,13,0.00299,59109,13.59803,434688
998,BinacsLee,13,0.00299,59122,13.60102,434688
999,chenyukang,13,0.00299,59135,13.60401,434688
1000,clarinette9,13,0.00299,59148,13.60700,434688
1001,Creatone,13,0.00299,59161,13.60999,434688
1002,dabaooline,13,0.00299,59174,13.61298,434688
1003,Dr-Shadow,13,0.00299,59187,13.61597,434688
1004,ellisio,13,0.00299,59200,13.61896,434688
1005,emanuelflp,13,0.00299,59213,13.62195,434688
1006,emilgelman,13,0.00299,59226,13.62494,434688
1007,Feggah,13,0.00299,59239,13.62794,434688
1008,gpsingh-1991,13,0.00299,59252,13.63093,434688
1009,GrahamLea,13,0.00299,59265,13.63392,434688
1010,Harshita-Kanal,13,0.00299,59278,13.63691,434688
1011,hezise,13,0.00299,59291,13.63990,434688
1012,jkossak,13,0.00299,59304,13.64289,434688
1013,juliohm1978,13,0.00299,59317,13.64588,434688
1014,KiranOpenSource,13,0.00299,59330,13.64887,434688
1015,kubotat,13,0.00299,59343,13.65186,434688
1016,lajiao117,13,0.00299,59356,13.65485,434688
1017,lalex,13,0.00299,59369,13.65784,434688
1018,leoskyrocker,13,0.00299,59382,13.66083,434688
1019,lhzw,13,0.00299,59395,13.66382,434688
1020,linrl3,13,0.00299,59408,13.66681,434688
1021,litmusbot,13,0.00299,59421,13.66980,434688
1022,Liu-JJ97,13,0.00299,59434,13.67280,434688
1023,lmmarsano,13,0.00299,59447,13.67579,434688
1024,lyzhang1999,13,0.00299,59460,13.67878,434688
1025,Malax,13,0.00299,59473,13.68177,434688
1026,maybe-sybr,13,0.00299,59486,13.68476,434688
1027,mderoy,13,0.00299,59499,13.68775,434688
1028,MehrCurry,13,0.00299,59512,13.69074,434688
1029,mohammed-fuad,13,0.00299,59525,13.69373,434688
1030,msbasanth,13,0.00299,59538,13.69672,434688
1031,mstingl,13,0.00299,59551,13.69971,434688
1032,mukhoakash,13,0.00299,59564,13.70270,434688
1033,ningmingxiao,13,0.00299,59577,13.70569,434688
1034,novahe,13,0.00299,59590,13.70868,434688
1035,om3171991,13,0.00299,59603,13.71167,434688
1036,OmigaXm,13,0.00299,59616,13.71466,434688
1037,patsevanton,13,0.00299,59629,13.71765,434688
1038,PaurushGarg,13,0.00299,59642,13.72065,434688
1039,PBug90,13,0.00299,59655,13.72364,434688
1040,philosophicus,13,0.00299,59668,13.72663,434688
1041,plakyda-codefresh,13,0.00299,59681,13.72962,434688
1042,postescu,13,0.00299,59694,13.73261,434688
1043,psoaresgit,13,0.00299,59707,13.73560,434688
1044,rajivml,13,0.00299,59720,13.73859,434688
1045,ran8080,13,0.00299,59733,13.74158,434688
1046,Rishi22-Coding,13,0.00299,59746,13.74457,434688
1047,samene,13,0.00299,59759,13.74756,434688
1048,Sandy4999,13,0.00299,59772,13.75055,434688
1049,sayantan1413,13,0.00299,59785,13.75354,434688
1050,scaat,13,0.00299,59798,13.75653,434688
1051,setevoy2,13,0.00299,59811,13.75952,434688
1052,shioshiota,13,0.00299,59824,13.76251,434688
1053,siddharthlal25,13,0.00299,59837,13.76551,434688
1054,snuggie12,13,0.00299,59850,13.76850,434688
1055,szubster,13,0.00299,59863,13.77149,434688
1056,theletterf,13,0.00299,59876,13.77448,434688
1057,vadimberezniker,13,0.00299,59889,13.77747,434688
1058,ventifus,13,0.00299,59902,13.78046,434688
1059,vigohe,13,0.00299,59915,13.78345,434688
1060,weizhouBlue,13,0.00299,59928,13.78644,434688
1061,wscheele,13,0.00299,59941,13.78943,434688
1062,xiaopingrubyist,13,0.00299,59954,13.79242,434688
1063,xingjianhui,13,0.00299,59967,13.79541,434688
1064,yasharne,13,0.00299,59980,13.79840,434688
1065,YLyangling,13,0.00299,59993,13.80139,434688
1066,zhyChesterCheung,13,0.00299,60006,13.80438,434688
1067,zou2699,13,0.00299,60019,13.80737,434688
1068,66545shiwo,12,0.00276,60031,13.81014,434688
1069,aakifshaikh,12,0.00276,60043,13.81290,434688
1070,Abingcbc,12,0.00276,60055,13.81566,434688
1071,aidy,12,0.00276,60067,13.81842,434688
1072,alexivanoff,12,0.00276,60079,13.82118,434688
1073,alinaryan,12,0.00276,60091,13.82394,434688
1074,alvarogonzalez-packlink,12,0.00276,60103,13.82670,434688
1075,alvassin,12,0.00276,60115,13.82946,434688
1076,AnavMahajan,12,0.00276,60127,13.83222,434688
1077,arunvelayutham,12,0.00276,60139,13.83498,434688
1078,Belchy06,12,0.00276,60151,13.83774,434688
1079,bensch98,12,0.00276,60163,13.84050,434688
1080,Bergiu,12,0.00276,60175,13.84326,434688
1081,betaincao,12,0.00276,60187,13.84602,434688
1082,bigHave,12,0.00276,60199,13.84878,434688
1083,BinaryFissionGames,12,0.00276,60211,13.85154,434688
1084,Blacklion14,12,0.00276,60223,13.85430,434688
1085,bw-intuit,12,0.00276,60235,13.85707,434688
1086,chapurlatn,12,0.00276,60247,13.85983,434688
1087,charlesxsh,12,0.00276,60259,13.86259,434688
1088,chetanugale,12,0.00276,60271,13.86535,434688
1089,clayg,12,0.00276,60283,13.86811,434688
1090,clearday4,12,0.00276,60295,13.87087,434688
1091,cyran-ryan,12,0.00276,60307,13.87363,434688
1092,dan-j,12,0.00276,60319,13.87639,434688
1093,davissp14,12,0.00276,60331,13.87915,434688
1094,dehamzah,12,0.00276,60343,13.88191,434688
1095,Dragoncell,12,0.00276,60355,13.88467,434688
1096,dropdeadfu,12,0.00276,60367,13.88743,434688
1097,eee4017,12,0.00276,60379,13.89019,434688
1098,eloo,12,0.00276,60391,13.89295,434688
1099,fischor,12,0.00276,60403,13.89571,434688
1100,fnkr,12,0.00276,60415,13.89847,434688
1101,Gbahdeyboh,12,0.00276,60427,13.90123,434688
1102,gilad-bendor,12,0.00276,60439,13.90400,434688
1103,greggirwin,12,0.00276,60451,13.90676,434688
1104,harshagv,12,0.00276,60463,13.90952,434688
1105,hochuenw-dd,12,0.00276,60475,13.91228,434688
1106,hyakuhei,12,0.00276,60487,13.91504,434688
1107,ilixiaocui,12,0.00276,60499,13.91780,434688
1108,jfbai,12,0.00276,60511,13.92056,434688
1109,jhchong92,12,0.00276,60523,13.92332,434688
1110,JosiahCraw,12,0.00276,60535,13.92608,434688
1111,Joyinqin,12,0.00276,60547,13.92884,434688
1112,justchris1,12,0.00276,60559,13.93160,434688
1113,ld100,12,0.00276,60571,13.93436,434688
1114,littlejawa,12,0.00276,60583,13.93712,434688
1115,mandelsoft,12,0.00276,60595,13.93988,434688
1116,manusant,12,0.00276,60607,13.94264,434688
1117,margocrawf,12,0.00276,60619,13.94540,434688
1118,melvinj98,12,0.00276,60631,13.94817,434688
1119,mfz85,12,0.00276,60643,13.95093,434688
1120,MileyFu,12,0.00276,60655,13.95369,434688
1121,mtagstyle,12,0.00276,60667,13.95645,434688
1122,muma378,12,0.00276,60679,13.95921,434688
1123,nareshdesh,12,0.00276,60691,13.96197,434688
1124,nishantminerva,12,0.00276,60703,13.96473,434688
1125,niuyueyang1996,12,0.00276,60715,13.96749,434688
1126,prichrd,12,0.00276,60727,13.97025,434688
1127,prymitive,12,0.00276,60739,13.97301,434688
1128,PurneswarPrasad,12,0.00276,60751,13.97577,434688
1129,rahilsh,12,0.00276,60763,13.97853,434688
1130,rdxmb,12,0.00276,60775,13.98129,434688
1131,renkelvin,12,0.00276,60787,13.98405,434688
1132,richardburakowski,12,0.00276,60799,13.98681,434688
1133,ritpanjw,12,0.00276,60811,13.98957,434688
1134,RobinsChens,12,0.00276,60823,13.99233,434688
1135,RoyceDavison,12,0.00276,60835,13.99510,434688
1136,ryokather,12,0.00276,60847,13.99786,434688
1137,samuelgregorovic,12,0.00276,60859,14.00062,434688
1138,seanschade,12,0.00276,60871,14.00338,434688
1139,SerenaIce,12,0.00276,60883,14.00614,434688
1140,shanthisagar-dhanya-kumar-db,12,0.00276,60895,14.00890,434688
1141,shashwatj07,12,0.00276,60907,14.01166,434688
1142,slon,12,0.00276,60919,14.01442,434688
1143,srprash,12,0.00276,60931,14.01718,434688
1144,swartz-k,12,0.00276,60943,14.01994,434688
1145,Symbianx,12,0.00276,60955,14.02270,434688
1146,syncush,12,0.00276,60967,14.02546,434688
1147,TheBeatles1994,12,0.00276,60979,14.02822,434688
1148,tk42,12,0.00276,60991,14.03098,434688
1149,tokikanno,12,0.00276,61003,14.03374,434688
1150,top,12,0.00276,61015,14.03650,434688
1151,TREiop,12,0.00276,61027,14.03926,434688
1152,vcapretz,12,0.00276,61039,14.04203,434688
1153,victormorfin97,12,0.00276,61051,14.04479,434688
1154,watfordsuzy,12,0.00276,61063,14.04755,434688
1155,whichxjy,12,0.00276,61075,14.05031,434688
1156,wrighbr,12,0.00276,61087,14.05307,434688
1157,yawboateng,12,0.00276,61099,14.05583,434688
1158,yingjianwu199868,12,0.00276,61111,14.05859,434688
1159,yishuT,12,0.00276,61123,14.06135,434688
1160,YitzyD,12,0.00276,61135,14.06411,434688
1161,YuJuncen,12,0.00276,61147,14.06687,434688
1162,zeitounator,12,0.00276,61159,14.06963,434688
1163,zikhan,12,0.00276,61171,14.07239,434688
1164,zingero,12,0.00276,61183,14.07515,434688
1165,zmx,12,0.00276,61195,14.07791,434688
1166,abhinb,11,0.00253,61206,14.08044,434688
1167,adabuleanu,11,0.00253,61217,14.08297,434688
1168,adamotonete,11,0.00253,61228,14.08551,434688
1169,ahrtr,11,0.00253,61239,14.08804,434688
1170,andrii-codefresh,11,0.00253,61250,14.09057,434688
1171,arjunbhandage,11,0.00253,61261,14.09310,434688
1172,Aryan007007,11,0.00253,61272,14.09563,434688
1173,ashish-patwal,11,0.00253,61283,14.09816,434688
1174,asummers,11,0.00253,61294,14.10069,434688
1175,audrey-siqueira,11,0.00253,61305,14.10322,434688
1176,avinashk442,11,0.00253,61316,14.10575,434688
1177,blackdobb,11,0.00253,61327,14.10828,434688
1178,busgo,11,0.00253,61338,14.11081,434688
1179,Bytesu,11,0.00253,61349,14.11334,434688
1180,carlo-colombo,11,0.00253,61360,14.11587,434688
1181,ChiefGhostZero0x1,11,0.00253,61371,14.11840,434688
1182,codearky,11,0.00253,61382,14.12093,434688
1183,cornel-masson,11,0.00253,61393,14.12346,434688
1184,cslauritsen,11,0.00253,61404,14.12599,434688
1185,custhk,11,0.00253,61415,14.12852,434688
1186,dahuaAdmin,11,0.00253,61426,14.13105,434688
1187,danielblando,11,0.00253,61437,14.13359,434688
1188,dannykopping,11,0.00253,61448,14.13612,434688
1189,demonCoder95,11,0.00253,61459,14.13865,434688
1190,djpbessems,11,0.00253,61470,14.14118,434688
1191,erekgit,11,0.00253,61481,14.14371,434688
1192,estk,11,0.00253,61492,14.14624,434688
1193,evanlixin,11,0.00253,61503,14.14877,434688
1194,fatedier,11,0.00253,61514,14.15130,434688
1195,fl42,11,0.00253,61525,14.15383,434688
1196,garyyang2002,11,0.00253,61536,14.15636,434688
1197,geneliu,11,0.00253,61547,14.15889,434688
1198,ggpaue,11,0.00253,61558,14.16142,434688
1199,graywolf-at-work,11,0.00253,61569,14.16395,434688
1200,h0jeZvgoxFepBQ2C,11,0.00253,61580,14.16648,434688
1201,hiba-aldalaty,11,0.00253,61591,14.16901,434688
1202,holdenk,11,0.00253,61602,14.17154,434688
1203,huangxuelun,11,0.00253,61613,14.17407,434688
1204,ichxxx,11,0.00253,61624,14.17660,434688
1205,Jaans,11,0.00253,61635,14.17914,434688
1206,JasonShenk,11,0.00253,61646,14.18167,434688
1207,jchen10500,11,0.00253,61657,14.18420,434688
1208,Jeremy-boo,11,0.00253,61668,14.18673,434688
1209,jeremysf,11,0.00253,61679,14.18926,434688
1210,jiscfoo,11,0.00253,61690,14.19179,434688
1211,joy717,11,0.00253,61701,14.19432,434688
1212,juliankung-db,11,0.00253,61712,14.19685,434688
1213,justinrush,11,0.00253,61723,14.19938,434688
1214,kabab,11,0.00253,61734,14.20191,434688
1215,karezza,11,0.00253,61745,14.20444,434688
1216,karthikkondapally,11,0.00253,61756,14.20697,434688
1217,kconwayinvision,11,0.00253,61767,14.20950,434688
1218,kim5566,11,0.00253,61778,14.21203,434688
1219,kobejn-jb,11,0.00253,61789,14.21456,434688
1220,kralicky,11,0.00253,61800,14.21709,434688
1221,lwmqwer,11,0.00253,61811,14.21962,434688
1222,lyind,11,0.00253,61822,14.22215,434688
1223,marshields,11,0.00253,61833,14.22469,434688
1224,mcmho,11,0.00253,61844,14.22722,434688
1225,mnencia,11,0.00253,61855,14.22975,434688
1226,mustafain117,11,0.00253,61866,14.23228,434688
1227,olljanat,11,0.00253,61877,14.23481,434688
1228,omniproc,11,0.00253,61888,14.23734,434688
1229,opennomad,11,0.00253,61899,14.23987,434688
1230,oppegard,11,0.00253,61910,14.24240,434688
1231,pawbana,11,0.00253,61921,14.24493,434688
1232,philomory,11,0.00253,61932,14.24746,434688
1233,PPACI,11,0.00253,61943,14.24999,434688
1234,PrashantGSIN,11,0.00253,61954,14.25252,434688
1235,praveengt,11,0.00253,61965,14.25505,434688
1236,priyavj08,11,0.00253,61976,14.25758,434688
1237,Reamer,11,0.00253,61987,14.26011,434688
1238,rgeraskin,11,0.00253,61998,14.26264,434688
1239,rms1000watt,11,0.00253,62009,14.26517,434688
1240,rubenssoto,11,0.00253,62020,14.26770,434688
1241,rumanzo,11,0.00253,62031,14.27024,434688
1242,ryansann,11,0.00253,62042,14.27277,434688
1243,sahutd,11,0.00253,62053,14.27530,434688
1244,Sam-Kramer,11,0.00253,62064,14.27783,434688
1245,scila1996,11,0.00253,62075,14.28036,434688
1246,scuzhanglei,11,0.00253,62086,14.28289,434688
1247,Shinerrs,11,0.00253,62097,14.28542,434688
1248,SilvaMatteus,11,0.00253,62108,14.28795,434688
1249,sleipnir,11,0.00253,62119,14.29048,434688
1250,smcavallo,11,0.00253,62130,14.29301,434688
1251,spennymac,11,0.00253,62141,14.29554,434688
1252,sTb1337,11,0.00253,62152,14.29807,434688
1253,TakshakRamteke,11,0.00253,62163,14.30060,434688
1254,ThoTischner,11,0.00253,62174,14.30313,434688
1255,TidalPoo,11,0.00253,62185,14.30566,434688
1256,tigrato,11,0.00253,62196,14.30819,434688
1257,trierra,11,0.00253,62207,14.31072,434688
1258,tyzbit,11,0.00253,62218,14.31325,434688
1259,umanwizard,11,0.00253,62229,14.31579,434688
1260,vannarath-poeu,11,0.00253,62240,14.31832,434688
1261,vinid223,11,0.00253,62251,14.32085,434688
1262,wasmcloud-automation,11,0.00253,62262,14.32338,434688
1263,w-h37,11,0.00253,62273,14.32591,434688
1264,woodliu,11,0.00253,62284,14.32844,434688
1265,xuhui-lu,11,0.00253,62295,14.33097,434688
1266,yaronya,11,0.00253,62306,14.33350,434688
1267,yayaha,11,0.00253,62317,14.33603,434688
1268,ydFu,11,0.00253,62328,14.33856,434688
1269,yharish991,11,0.00253,62339,14.34109,434688
1270,Yoname,11,0.00253,62350,14.34362,434688
1271,YuzeZhang,11,0.00253,62361,14.34615,434688
1272,zcola,11,0.00253,62372,14.34868,434688
1273,zhucegep,11,0.00253,62383,14.35121,434688
1274,zhuyaguang,11,0.00253,62394,14.35374,434688
1275,zr-msft,11,0.00253,62405,14.35627,434688
1276,2pk03,10,0.00230,62415,14.35857,434688
1277,abdelmonem17,10,0.00230,62425,14.36087,434688
1278,AlonGluz,10,0.00230,62435,14.36318,434688
1279,andrewgkew,10,0.00230,62445,14.36548,434688
1280,AnubhavSabharwa,10,0.00230,62455,14.36778,434688
1281,Ashtonian,10,0.00230,62465,14.37008,434688
1282,AtkinsChang,10,0.00230,62475,14.37238,434688
1283,bdhess,10,0.00230,62485,14.37468,434688
1284,benpbrown,10,0.00230,62495,14.37698,434688
1285,Bhumika1997,10,0.00230,62505,14.37928,434688
1286,bnu0,10,0.00230,62515,14.38158,434688
1287,brianpham,10,0.00230,62525,14.38388,434688
1288,brrusino,10,0.00230,62535,14.38618,434688
1289,bsod90,10,0.00230,62545,14.38848,434688
1290,ccbrown,10,0.00230,62555,14.39078,434688
1291,cgafool,10,0.00230,62565,14.39308,434688
1292,ChameleonRed,10,0.00230,62575,14.39538,434688
1293,chenjiandongx,10,0.00230,62585,14.39768,434688
1294,cloudcafetech,10,0.00230,62595,14.39998,434688
1295,codingdiaz,10,0.00230,62605,14.40228,434688
1296,coolyrat,10,0.00230,62615,14.40458,434688
1297,crazywill,10,0.00230,62625,14.40688,434688
1298,DailyAlice,10,0.00230,62635,14.40919,434688
1299,danielzhanghl,10,0.00230,62645,14.41149,434688
1300,danports,10,0.00230,62655,14.41379,434688
1301,deobieta,10,0.00230,62665,14.41609,434688
1302,devincd,10,0.00230,62675,14.41839,434688
1303,Dortmund-Reus,10,0.00230,62685,14.42069,434688
1304,drmorr0,10,0.00230,62695,14.42299,434688
1305,Drumato,10,0.00230,62705,14.42529,434688
1306,elruwen,10,0.00230,62715,14.42759,434688
1307,FilBot3,10,0.00230,62725,14.42989,434688
1308,gautampunhani,10,0.00230,62735,14.43219,434688
1309,gccio,10,0.00230,62745,14.43449,434688
1310,gracewehner,10,0.00230,62755,14.43679,434688
1311,GregoireW,10,0.00230,62765,14.43909,434688
1312,haskell42,10,0.00230,62775,14.44139,434688
1313,hillbun,10,0.00230,62785,14.44369,434688
1314,hiroyaonoe,10,0.00230,62795,14.44599,434688
1315,holyspectral,10,0.00230,62805,14.44829,434688
1316,hongrubb,10,0.00230,62815,14.45059,434688
1317,Huimintai,10,0.00230,62825,14.45289,434688
1318,husky-parul,10,0.00230,62835,14.45520,434688
1319,ialimz,10,0.00230,62845,14.45750,434688
1320,imvalient,10,0.00230,62855,14.45980,434688
1321,irl-segfault,10,0.00230,62865,14.46210,434688
1322,ithaiq,10,0.00230,62875,14.46440,434688
1323,jaehnri,10,0.00230,62885,14.46670,434688
1324,jamiegau,10,0.00230,62895,14.46900,434688
1325,JcJinChen,10,0.00230,62905,14.47130,434688
1326,jiangyuzhao,10,0.00230,62915,14.47360,434688
1327,jniebuhr,10,0.00230,62925,14.47590,434688
1328,jnsrikanth,10,0.00230,62935,14.47820,434688
1329,jorgemansillacriado,10,0.00230,62945,14.48050,434688
1330,josh-endries,10,0.00230,62955,14.48280,434688
1331,julius-welink,10,0.00230,62965,14.48510,434688
1332,kissmikijr,10,0.00230,62975,14.48740,434688
1333,kjost-splunk,10,0.00230,62985,14.48970,434688
1334,korenyoni,10,0.00230,62995,14.49200,434688
1335,kristee-planetscale,10,0.00230,63005,14.49430,434688
1336,lapo-luchini,10,0.00230,63015,14.49660,434688
1337,LemonHX,10,0.00230,63025,14.49890,434688
1338,lexcao,10,0.00230,63035,14.50121,434688
1339,L-jasmine,10,0.00230,63045,14.50351,434688
1340,MahnoorAsghar,10,0.00230,63055,14.50581,434688
1341,mbeards,10,0.00230,63065,14.50811,434688
1342,minkimcello,10,0.00230,63075,14.51041,434688
1343,mkasinat,10,0.00230,63085,14.51271,434688
1344,mmiller1,10,0.00230,63095,14.51501,434688
1345,mnbbrown,10,0.00230,63105,14.51731,434688
1346,mvkrishna86,10,0.00230,63115,14.51961,434688
1347,mysticaltech,10,0.00230,63125,14.52191,434688
1348,naor2013,10,0.00230,63135,14.52421,434688
1349,nastra,10,0.00230,63145,14.52651,434688
1350,nathanawmk,10,0.00230,63155,14.52881,434688
1351,ndrscodes,10,0.00230,63165,14.53111,434688
1352,nikhilbhandari123,10,0.00230,63175,14.53341,434688
1353,Nikhil-Ladha,10,0.00230,63185,14.53571,434688
1354,nuriel77,10,0.00230,63195,14.53801,434688
1355,Olgaminch7,10,0.00230,63205,14.54031,434688
1356,olivierpilotte,10,0.00230,63215,14.54261,434688
1357,omus,10,0.00230,63225,14.54491,434688
1358,onweru,10,0.00230,63235,14.54722,434688
1359,panaji,10,0.00230,63245,14.54952,434688
1360,pavel-lexyr,10,0.00230,63255,14.55182,434688
1361,pdeligia,10,0.00230,63265,14.55412,434688
1362,peteroneilljr,10,0.00230,63275,14.55642,434688
1363,qingvincentyin,10,0.00230,63285,14.55872,434688
1364,qqustc,10,0.00230,63295,14.56102,434688
1365,r10r,10,0.00230,63305,14.56332,434688
1366,rabeeshcharles,10,0.00230,63315,14.56562,434688
1367,removedporn,10,0.00230,63325,14.56792,434688
1368,RenShine,10,0.00230,63335,14.57022,434688
1369,rogfut,10,0.00230,63345,14.57252,434688
1370,roylisto,10,0.00230,63355,14.57482,434688
1371,s3nt3,10,0.00230,63365,14.57712,434688
1372,salim-buet03,10,0.00230,63375,14.57942,434688
1373,santhoshs123,10,0.00230,63385,14.58172,434688
1374,Sarabadu,10,0.00230,63395,14.58402,434688
1375,schneesu,10,0.00230,63405,14.58632,434688
1376,shuklaritvik06,10,0.00230,63415,14.58862,434688
1377,SiarheiBortnik,10,0.00230,63425,14.59092,434688
1378,sibucan,10,0.00230,63435,14.59323,434688
1379,soukron,10,0.00230,63445,14.59553,434688
1380,sunnoy,10,0.00230,63455,14.59783,434688
1381,Temikus,10,0.00230,63465,14.60013,434688
1382,thibgc,10,0.00230,63475,14.60243,434688
1383,thof,10,0.00230,63485,14.60473,434688
1384,thomasmRavn,10,0.00230,63495,14.60703,434688
1385,TimothyAsirJeyasing,10,0.00230,63505,14.60933,434688
1386,tonybaloney,10,0.00230,63515,14.61163,434688
1387,unixomg,10,0.00230,63525,14.61393,434688
1388,ViBiOh,10,0.00230,63535,14.61623,434688
1389,vitruvvius,10,0.00230,63545,14.61853,434688
1390,Voultapher,10,0.00230,63555,14.62083,434688
1391,wpjunior,10,0.00230,63565,14.62313,434688
1392,XIAOYUELIN,10,0.00230,63575,14.62543,434688
1393,xu1zhou,10,0.00230,63585,14.62773,434688
1394,Y0Username,10,0.00230,63595,14.63003,434688
1395,y-tag,10,0.00230,63605,14.63233,434688
1396,z1cheng,10,0.00230,63615,14.63463,434688
1397,zhangbo1882,10,0.00230,63625,14.63693,434688
1398,ZHANGWENTAI,10,0.00230,63635,14.63924,434688
1399,zoftdev,10,0.00230,63645,14.64154,434688
1400,zryfish,10,0.00230,63655,14.64384,434688
1401,zxb789,10,0.00230,63665,14.64614,434688
1402,4molybdenum2,9,0.00207,63674,14.64821,434688
1403,abhibhaw,9,0.00207,63683,14.65028,434688
1404,absynth76,9,0.00207,63692,14.65235,434688
1405,actly,9,0.00207,63701,14.65442,434688
1406,Adarshkumar14,9,0.00207,63710,14.65649,434688
1407,adzshaf,9,0.00207,63719,14.65856,434688
1408,Aj-vrod,9,0.00207,63728,14.66063,434688
1409,anonymousr007,9,0.00207,63737,14.66270,434688
1410,ansinlee,9,0.00207,63746,14.66477,434688
1411,ansjsun,9,0.00207,63755,14.66684,434688
1412,antonisnyc94,9,0.00207,63764,14.66891,434688
1413,Arvind644,9,0.00207,63773,14.67098,434688
1414,Asmit2952,9,0.00207,63782,14.67305,434688
1415,assdddddff,9,0.00207,63791,14.67512,434688
1416,avorima,9,0.00207,63800,14.67719,434688
1417,avwsolutions,9,0.00207,63809,14.67926,434688
1418,bbatha,9,0.00207,63818,14.68133,434688
1419,bechampion,9,0.00207,63827,14.68341,434688
1420,ben1009,9,0.00207,63836,14.68548,434688
1421,benridley,9,0.00207,63845,14.68755,434688
1422,bernokl,9,0.00207,63854,14.68962,434688
1423,bharatnc,9,0.00207,63863,14.69169,434688
1424,cezhang,9,0.00207,63872,14.69376,434688
1425,cfstras,9,0.00207,63881,14.69583,434688
1426,ChenQianCQ,9,0.00207,63890,14.69790,434688
1427,ChetanVyas,9,0.00207,63899,14.69997,434688
1428,cirulls,9,0.00207,63908,14.70204,434688
1429,clux,9,0.00207,63917,14.70411,434688
1430,Cna59,9,0.00207,63926,14.70618,434688
1431,cocampbe,9,0.00207,63935,14.70825,434688
1432,CodingSpiderFox,9,0.00207,63944,14.71032,434688
1433,danielywong,9,0.00207,63953,14.71239,434688
1434,danrot,9,0.00207,63962,14.71446,434688
1435,darknesszy,9,0.00207,63971,14.71653,434688
1436,davide-bolcioni,9,0.00207,63980,14.71860,434688
1437,dechaoqiu,9,0.00207,63989,14.72067,434688
1438,dimabru,9,0.00207,63998,14.72274,434688
1439,doge95,9,0.00207,64007,14.72481,434688
1440,dorisd0102,9,0.00207,64016,14.72688,434688
1441,dosmanak,9,0.00207,64025,14.72896,434688
1442,dougfort,9,0.00207,64034,14.73103,434688
1443,dpstratascale,9,0.00207,64043,14.73310,434688
1444,dragonly,9,0.00207,64052,14.73517,434688
1445,dvirguttman,9,0.00207,64061,14.73724,434688
1446,dyasny,9,0.00207,64070,14.73931,434688
1447,Edge2Ops,9,0.00207,64079,14.74138,434688
1448,elcreator,9,0.00207,64088,14.74345,434688
1449,encodeflush,9,0.00207,64097,14.74552,434688
1450,esatterwhite,9,0.00207,64106,14.74759,434688
1451,FalconerTC,9,0.00207,64115,14.74966,434688
1452,faust64,9,0.00207,64124,14.75173,434688
1453,FilipPyrek,9,0.00207,64133,14.75380,434688
1454,fredrik-jansson-se,9,0.00207,64142,14.75587,434688
1455,gambcl,9,0.00207,64151,14.75794,434688
1456,gecube,9,0.00207,64160,14.76001,434688
1457,g-linville,9,0.00207,64169,14.76208,434688
1458,goroi,9,0.00207,64178,14.76415,434688
1459,goto1134,9,0.00207,64187,14.76622,434688
1460,grieshaber,9,0.00207,64196,14.76829,434688
1461,hijerusalem,9,0.00207,64205,14.77036,434688
1462,hua82556281,9,0.00207,64214,14.77243,434688
1463,huan,9,0.00207,64223,14.77450,434688
1464,HuangYijuan,9,0.00207,64232,14.77658,434688
1465,hurdonkey,9,0.00207,64241,14.77865,434688
1466,iFshadow,9,0.00207,64250,14.78072,434688
1467,Imy123,9,0.00207,64259,14.78279,434688
1468,ItaiPrajgrod,9,0.00207,64268,14.78486,434688
1469,iugastefan922,9,0.00207,64277,14.78693,434688
1470,jabbera,9,0.00207,64286,14.78900,434688
1471,janosdebugs,9,0.00207,64295,14.79107,434688
1472,jessitron,9,0.00207,64304,14.79314,434688
1473,JimPruitt,9,0.00207,64313,14.79521,434688
1474,joebb97,9,0.00207,64322,14.79728,434688
1475,joenzx,9,0.00207,64331,14.79935,434688
1476,josephlim75,9,0.00207,64340,14.80142,434688
1477,joshuabezaleel,9,0.00207,64349,14.80349,434688
1478,karamcgeehan,9,0.00207,64358,14.80556,434688
1479,kitianFresh,9,0.00207,64367,14.80763,434688
1480,klihub,9,0.00207,64376,14.80970,434688
1481,kschu91,9,0.00207,64385,14.81177,434688
1482,kun-lu20,9,0.00207,64394,14.81384,434688
1483,kwanhur,9,0.00207,64403,14.81591,434688
1484,landreasyan,9,0.00207,64412,14.81798,434688
1485,Leschge,9,0.00207,64421,14.82005,434688
1486,lingfengChen03,9,0.00207,64430,14.82213,434688
1487,ljmcgann,9,0.00207,64439,14.82420,434688
1488,llhhbc,9,0.00207,64448,14.82627,434688
1489,luan007,9,0.00207,64457,14.82834,434688
1490,m477r1x,9,0.00207,64466,14.83041,434688
1491,Madhur97,9,0.00207,64475,14.83248,434688
1492,Mangosata,9,0.00207,64484,14.83455,434688
1493,ManirajDeivendran,9,0.00207,64493,14.83662,434688
1494,maokt,9,0.00207,64502,14.83869,434688
1495,MarcinGinszt,9,0.00207,64511,14.84076,434688
1496,Martin-Weiss,9,0.00207,64520,14.84283,434688
1497,MateusAmin,9,0.00207,64529,14.84490,434688
1498,MattUebel,9,0.00207,64538,14.84697,434688
1499,maxlegault,9,0.00207,64547,14.84904,434688
1500,mdb,9,0.00207,64556,14.85111,434688
1501,m-deepakraja,9,0.00207,64565,14.85318,434688
1502,meehanman,9,0.00207,64574,14.85525,434688
1503,meteorlxy,9,0.00207,64583,14.85732,434688
1504,metost,9,0.00207,64592,14.85939,434688
1505,mlorenzo-stratio,9,0.00207,64601,14.86146,434688
1506,mohjam2004,9,0.00207,64610,14.86353,434688
1507,mornyx,9,0.00207,64619,14.86560,434688
1508,mrizzi,9,0.00207,64628,14.86768,434688
1509,mstergianis,9,0.00207,64637,14.86975,434688
1510,mvkzzz,9,0.00207,64646,14.87182,434688
1511,mysticmode,9,0.00207,64655,14.87389,434688
1512,nagygergo,9,0.00207,64664,14.87596,434688
1513,Nebulazhang,9,0.00207,64673,14.87803,434688
1514,nflaig,9,0.00207,64682,14.88010,434688
1515,nishant-yt,9,0.00207,64691,14.88217,434688
1516,Noisyes,9,0.00207,64700,14.88424,434688
1517,ofekrom,9,0.00207,64709,14.88631,434688
1518,OscarDHdz,9,0.00207,64718,14.88838,434688
1519,panzhongxian,9,0.00207,64727,14.89045,434688
1520,parasappafluke,9,0.00207,64736,14.89252,434688
1521,petermant,9,0.00207,64745,14.89459,434688
1522,pingyu,9,0.00207,64754,14.89666,434688
1523,QAQ-rookie,9,0.00207,64763,14.89873,434688
1524,rajeshdeshpande02,9,0.00207,64772,14.90080,434688
1525,rangarb885,9,0.00207,64781,14.90287,434688
1526,rcousineau-xandr,9,0.00207,64790,14.90494,434688
1527,RemonSinnema,9,0.00207,64799,14.90701,434688
1528,rgomez-casa,9,0.00207,64808,14.90908,434688
1529,s1ntaxe770r,9,0.00207,64817,14.91115,434688
1530,Saim-Safdar,9,0.00207,64826,14.91323,434688
1531,sbs2001,9,0.00207,64835,14.91530,434688
1532,sbwfnhn,9,0.00207,64844,14.91737,434688
1533,sczhh,9,0.00207,64853,14.91944,434688
1534,secustor,9,0.00207,64862,14.92151,434688
1535,seiya-annie,9,0.00207,64871,14.92358,434688
1536,Sg-23,9,0.00207,64880,14.92565,434688
1537,shuaizi,9,0.00207,64889,14.92772,434688
1538,shyodx,9,0.00207,64898,14.92979,434688
1539,siguoyicl,9,0.00207,64907,14.93186,434688
1540,simrangupta234,9,0.00207,64916,14.93393,434688
1541,Sir-Jacques,9,0.00207,64925,14.93600,434688
1542,solonish,9,0.00207,64934,14.93807,434688
1543,stefanoborini,9,0.00207,64943,14.94014,434688
1544,sudeeptoroy,9,0.00207,64952,14.94221,434688
1545,sumeetb25,9,0.00207,64961,14.94428,434688
1546,sunnythepatel,9,0.00207,64970,14.94635,434688
1547,syyama-net,9,0.00207,64979,14.94842,434688
1548,taigrr,9,0.00207,64988,14.95049,434688
1549,ternes3,9,0.00207,64997,14.95256,434688
1550,timmyyuan,9,0.00207,65006,14.95463,434688
1551,tinkerborg,9,0.00207,65015,14.95670,434688
1552,tjay,9,0.00207,65024,14.95878,434688
1553,treid314,9,0.00207,65033,14.96085,434688
1554,uxth,9,0.00207,65042,14.96292,434688
1555,velcrine,9,0.00207,65051,14.96499,434688
1556,VisualBean,9,0.00207,65060,14.96706,434688
1557,von1994,9,0.00207,65069,14.96913,434688
1558,wangguoyan,9,0.00207,65078,14.97120,434688
1559,wangshiyang,9,0.00207,65087,14.97327,434688
1560,weilaaa,9,0.00207,65096,14.97534,434688
1561,wespanther,9,0.00207,65105,14.97741,434688
1562,wswind,9,0.00207,65114,14.97948,434688
1563,Wusuluren,9,0.00207,65123,14.98155,434688
1564,wyuan1704,9,0.00207,65132,14.98362,434688
1565,xavipanda,9,0.00207,65141,14.98569,434688
1566,xphyr,9,0.00207,65150,14.98776,434688
1567,xuegao321,9,0.00207,65159,14.98983,434688
1568,yang,9,0.00207,65168,14.99190,434688
1569,yanji09,9,0.00207,65177,14.99397,434688
1570,yashikabadaya,9,0.00207,65186,14.99604,434688
1571,yechs,9,0.00207,65195,14.99811,434688
1572,ygelfand,9,0.00207,65204,15.00018,434688
1573,younseunghyun,9,0.00207,65213,15.00225,434688
1574,yozora-hitagi,9,0.00207,65222,15.00432,434688
1575,YRXING,9,0.00207,65231,15.00640,434688
1576,ytfrank,9,0.00207,65240,15.00847,434688
1577,zf930530,9,0.00207,65249,15.01054,434688
1578,7olstoy,8,0.00184,65257,15.01238,434688
1579,80kk,8,0.00184,65265,15.01422,434688
1580,aallawala,8,0.00184,65273,15.01606,434688
1581,acastong,8,0.00184,65281,15.01790,434688
1582,acsaeed,8,0.00184,65289,15.01974,434688
1583,adamdonahue,8,0.00184,65297,15.02158,434688
1584,Adam-Kulju,8,0.00184,65305,15.02342,434688
1585,ai2soft,8,0.00184,65313,15.02526,434688
1586,alexanderdalloz,8,0.00184,65321,15.02710,434688
1587,alexremn,8,0.00184,65329,15.02894,434688
1588,almorgv,8,0.00184,65337,15.03078,434688
1589,amichai-upstream,8,0.00184,65345,15.03262,434688
1590,anbaig,8,0.00184,65353,15.03446,434688
1591,andresbeckruiz,8,0.00184,65361,15.03630,434688
1592,andrewparmet,8,0.00184,65369,15.03814,434688
1593,andrii29,8,0.00184,65377,15.03998,434688
1594,ankurnigam,8,0.00184,65385,15.04182,434688
1595,apollo13,8,0.00184,65393,15.04366,434688
1596,artem-nefedov,8,0.00184,65401,15.04550,434688
1597,arul-ashri,8,0.00184,65409,15.04734,434688
1598,azylinski,8,0.00184,65417,15.04918,434688
1599,balchua,8,0.00184,65425,15.05103,434688
1600,bcdady,8,0.00184,65433,15.05287,434688
1601,bdegeeter,8,0.00184,65441,15.05471,434688
1602,benagricola,8,0.00184,65449,15.05655,434688
1603,benjaminp,8,0.00184,65457,15.05839,434688
1604,benofben,8,0.00184,65465,15.06023,434688
1605,BeryJu,8,0.00184,65473,15.06207,434688
1606,Bez625,8,0.00184,65481,15.06391,434688
1607,bilelmoakhar,8,0.00184,65489,15.06575,434688
1608,bitgandtter,8,0.00184,65497,15.06759,434688
1609,bnikster,8,0.00184,65505,15.06943,434688
1610,bognarbalazs,8,0.00184,65513,15.07127,434688
1611,buggithubs,8,0.00184,65521,15.07311,434688
1612,bzhaoopenstack,8,0.00184,65529,15.07495,434688
1613,caiconkhicon,8,0.00184,65537,15.07679,434688
1614,caleb15,8,0.00184,65545,15.07863,434688
1615,chauhanshubham,8,0.00184,65553,15.08047,434688
1616,chestarss,8,0.00184,65561,15.08231,434688
1617,ChihSeanHsu,8,0.00184,65569,15.08415,434688
1618,chillum,8,0.00184,65577,15.08599,434688
1619,claytonpeters,8,0.00184,65585,15.08783,434688
1620,clsonel-endava,8,0.00184,65593,15.08967,434688
1621,coopersong,8,0.00184,65601,15.09151,434688
1622,danielortizlira,8,0.00184,65609,15.09335,434688
1623,danilorsilva,8,0.00184,65617,15.09519,434688
1624,danjenkins,8,0.00184,65625,15.09704,434688
1625,danthegoodman1,8,0.00184,65633,15.09888,434688
1626,darkl0rd,8,0.00184,65641,15.10072,434688
1627,david-yu,8,0.00184,65649,15.10256,434688
1628,dburianov,8,0.00184,65657,15.10440,434688
1629,dcoliversun,8,0.00184,65665,15.10624,434688
1630,ddzrc,8,0.00184,65673,15.10808,434688
1631,deepsan,8,0.00184,65681,15.10992,434688
1632,devansh42,8,0.00184,65689,15.11176,434688
1633,Dkaykay,8,0.00184,65697,15.11360,434688
1634,docbobo,8,0.00184,65705,15.11544,434688
1635,dtnyn,8,0.00184,65713,15.11728,434688
1636,ercpereda,8,0.00184,65721,15.11912,434688
1637,eryugey,8,0.00184,65729,15.12096,434688
1638,fanglixuezi,8,0.00184,65737,15.12280,434688
1639,feixiang43,8,0.00184,65745,15.12464,434688
1640,foriequal0,8,0.00184,65753,15.12648,434688
1641,fpinna,8,0.00184,65761,15.12832,434688
1642,francilioaraujo,8,0.00184,65769,15.13016,434688
1643,garfcat,8,0.00184,65777,15.13200,434688
1644,gerobinson,8,0.00184,65785,15.13384,434688
1645,giltene,8,0.00184,65793,15.13568,434688
1646,GM1957,8,0.00184,65801,15.13752,434688
1647,gmcbrien,8,0.00184,65809,15.13936,434688
1648,gopakumarce,8,0.00184,65817,15.14120,434688
1649,hacklschorsch,8,0.00184,65825,15.14305,434688
1650,halleyshx,8,0.00184,65833,15.14489,434688
1651,HaveFun83,8,0.00184,65841,15.14673,434688
1652,heraque,8,0.00184,65849,15.14857,434688
1653,hetpats,8,0.00184,65857,15.15041,434688
1654,HighWatersDev,8,0.00184,65865,15.15225,434688
1655,hmsayem,8,0.00184,65873,15.15409,434688
1656,hodbn,8,0.00184,65881,15.15593,434688
1657,hodgesds,8,0.00184,65889,15.15777,434688
1658,HongjiangHuang,8,0.00184,65897,15.15961,434688
1659,huntkalio,8,0.00184,65905,15.16145,434688
1660,hxietkg,8,0.00184,65913,15.16329,434688
1661,ide-rea,8,0.00184,65921,15.16513,434688
1662,IlianIliev,8,0.00184,65929,15.16697,434688
1663,imgx64,8,0.00184,65937,15.16881,434688
1664,includestdlibrary,8,0.00184,65945,15.17065,434688
1665,jack4it,8,0.00184,65953,15.17249,434688
1666,jackchuong,8,0.00184,65961,15.17433,434688
1667,JamesPGriffith,8,0.00184,65969,15.17617,434688
1668,janlauber,8,0.00184,65977,15.17801,434688
1669,jclangst,8,0.00184,65985,15.17985,434688
1670,jetmuffin,8,0.00184,65993,15.18169,434688
1671,JhoLee,8,0.00184,66001,15.18353,434688
1672,jjrodenburg,8,0.00184,66009,15.18537,434688
1673,jmoldow,8,0.00184,66017,15.18721,434688
1674,johnnycase,8,0.00184,66025,15.18906,434688
1675,jsonbruce,8,0.00184,66033,15.19090,434688
1676,karthikeyanVK,8,0.00184,66041,15.19274,434688
1677,kcrazy,8,0.00184,66049,15.19458,434688
1678,keashem,8,0.00184,66057,15.19642,434688
1679,KimonHoffmann,8,0.00184,66065,15.19826,434688
1680,king-11,8,0.00184,66073,15.20010,434688
1681,kkonovodoff,8,0.00184,66081,15.20194,434688
1682,KLForsythe,8,0.00184,66089,15.20378,434688
1683,kostas-theo,8,0.00184,66097,15.20562,434688
1684,kpcyrd,8,0.00184,66105,15.20746,434688
1685,kriti-sc,8,0.00184,66113,15.20930,434688
1686,kszafran,8,0.00184,66121,15.21114,434688
1687,kumar-deni,8,0.00184,66129,15.21298,434688
1688,kumari23anjali,8,0.00184,66137,15.21482,434688
1689,kylebrandt,8,0.00184,66145,15.21666,434688
1690,laojianzi,8,0.00184,66153,15.21850,434688
1691,Legion2,8,0.00184,66161,15.22034,434688
1692,liqiangz,8,0.00184,66169,15.22218,434688
1693,liuximu,8,0.00184,66177,15.22402,434688
1694,lizw91,8,0.00184,66185,15.22586,434688
1695,lsampras,8,0.00184,66193,15.22770,434688
1696,lx1036,8,0.00184,66201,15.22954,434688
1697,lykkeaxlin,8,0.00184,66209,15.23138,434688
1698,lzhfromustc,8,0.00184,66217,15.23322,434688
1699,mainred,8,0.00184,66225,15.23507,434688
1700,mamiu,8,0.00184,66233,15.23691,434688
1701,marascio,8,0.00184,66241,15.23875,434688
1702,marciogmorales,8,0.00184,66249,15.24059,434688
1703,marwatk,8,0.00184,66257,15.24243,434688
1704,meixingdb,8,0.00184,66265,15.24427,434688
1705,messiahUA,8,0.00184,66273,15.24611,434688
1706,michael-db,8,0.00184,66281,15.24795,434688
1707,michaelkoro,8,0.00184,66289,15.24979,434688
1708,michaelrode,8,0.00184,66297,15.25163,434688
1709,MinhDuc010194,8,0.00184,66305,15.25347,434688
1710,miyucy,8,0.00184,66313,15.25531,434688
1711,m-messiah,8,0.00184,66321,15.25715,434688
1712,moenzuel,8,0.00184,66329,15.25899,434688
1713,mohanli-ml,8,0.00184,66337,15.26083,434688
1714,mstrohl,8,0.00184,66345,15.26267,434688
1715,mullerch,8,0.00184,66353,15.26451,434688
1716,mway-niels,8,0.00184,66361,15.26635,434688
1717,mzrithm,8,0.00184,66369,15.26819,434688
1718,NatMarchand,8,0.00184,66377,15.27003,434688
1719,nhomble,8,0.00184,66385,15.27187,434688
1720,NishkarshRaj,8,0.00184,66393,15.27371,434688
1721,omertuc,8,0.00184,66401,15.27555,434688
1722,ossparvinder,8,0.00184,66409,15.27739,434688
1723,pascal71,8,0.00184,66417,15.27923,434688
1724,pashcan,8,0.00184,66425,15.28108,434688
1725,patrickleet,8,0.00184,66433,15.28292,434688
1726,PaulBenn-UnlikelyAI,8,0.00184,66441,15.28476,434688
1727,pbdger,8,0.00184,66449,15.28660,434688
1728,pierreilki,8,0.00184,66457,15.28844,434688
1729,prashbnair,8,0.00184,66465,15.29028,434688
1730,PrayagS,8,0.00184,66473,15.29212,434688
1731,protess,8,0.00184,66481,15.29396,434688
1732,protosam,8,0.00184,66489,15.29580,434688
1733,pschildkamp,8,0.00184,66497,15.29764,434688
1734,qdm12,8,0.00184,66505,15.29948,434688
1735,qiankunli,8,0.00184,66513,15.30132,434688
1736,rahulchaphalkar,8,0.00184,66521,15.30316,434688
1737,Rahuly360,8,0.00184,66529,15.30500,434688
1738,rajdevworks,8,0.00184,66537,15.30684,434688
1739,ramilmsh,8,0.00184,66545,15.30868,434688
1740,rayw000,8,0.00184,66553,15.31052,434688
1741,renkei,8,0.00184,66561,15.31236,434688
1742,rexagod,8,0.00184,66569,15.31420,434688
1743,riteshnaik,8,0.00184,66577,15.31604,434688
1744,robnanarivo,8,0.00184,66585,15.31788,434688
1745,Roshick,8,0.00184,66593,15.31972,434688
1746,rshearman,8,0.00184,66601,15.32156,434688
1747,Rubix982,8,0.00184,66609,15.32340,434688
1748,rwrz,8,0.00184,66617,15.32524,434688
1749,salvadorac,8,0.00184,66625,15.32709,434688
1750,saprette,8,0.00184,66633,15.32893,434688
1751,sathya0803,8,0.00184,66641,15.33077,434688
1752,sburnwal,8,0.00184,66649,15.33261,434688
1753,seavargas,8,0.00184,66657,15.33445,434688
1754,sebastiaoamaro,8,0.00184,66665,15.33629,434688
1755,sennatitcomb,8,0.00184,66673,15.33813,434688
1756,sepich,8,0.00184,66681,15.33997,434688
1757,Shreya027,8,0.00184,66689,15.34181,434688
1758,sirandysaunders,8,0.00184,66697,15.34365,434688
1759,slashpai,8,0.00184,66705,15.34549,434688
1760,slow-zhang,8,0.00184,66713,15.34733,434688
1761,sourabh3b,8,0.00184,66721,15.34917,434688
1762,spaced,8,0.00184,66729,15.35101,434688
1763,sstone1,8,0.00184,66737,15.35285,434688
1764,stardotcode,8,0.00184,66745,15.35469,434688
1765,stephane-mori,8,0.00184,66753,15.35653,434688
1766,steve-marmalade,8,0.00184,66761,15.35837,434688
1767,t0b3,8,0.00184,66769,15.36021,434688
1768,t3hmrman,8,0.00184,66777,15.36205,434688
1769,TannerGabriel,8,0.00184,66785,15.36389,434688
1770,tapairmax,8,0.00184,66793,15.36573,434688
1771,TFTomSun,8,0.00184,66801,15.36757,434688
1772,TheHydGuy,8,0.00184,66809,15.36941,434688
1773,ThomasLohmann,8,0.00184,66817,15.37125,434688
1774,tonyaw,8,0.00184,66825,15.37310,434688
1775,tooptoop4,8,0.00184,66833,15.37494,434688
1776,tporeba,8,0.00184,66841,15.37678,434688
1777,trutx,8,0.00184,66849,15.37862,434688
1778,tspearconquest,8,0.00184,66857,15.38046,434688
1779,vadimgusev-codefresh,8,0.00184,66865,15.38230,434688
1780,vamsiammineni,8,0.00184,66873,15.38414,434688
1781,voidC1326,8,0.00184,66881,15.38598,434688
1782,vs49688,8,0.00184,66889,15.38782,434688
1783,wangcheng34,8,0.00184,66897,15.38966,434688
1784,wangfakang,8,0.00184,66905,15.39150,434688
1785,weihao,8,0.00184,66913,15.39334,434688
1786,weiwendi,8,0.00184,66921,15.39518,434688
1787,wisdomekpotu,8,0.00184,66929,15.39702,434688
1788,wolffberg,8,0.00184,66937,15.39886,434688
1789,woodgear,8,0.00184,66945,15.40070,434688
1790,wxw-matt,8,0.00184,66953,15.40254,434688
1791,wzru,8,0.00184,66961,15.40438,434688
1792,xincuni,8,0.00184,66969,15.40622,434688
1793,xiongjiwei,8,0.00184,66977,15.40806,434688
1794,yashmehrotra,8,0.00184,66985,15.40990,434688
1795,ydp,8,0.00184,66993,15.41174,434688
1796,yonch,8,0.00184,67001,15.41358,434688
1797,yorikya,8,0.00184,67009,15.41542,434688
1798,yuxiaoba,8,0.00184,67017,15.41726,434688
1799,zhangzerui20,8,0.00184,67025,15.41911,434688
1800,zhiweiv,8,0.00184,67033,15.42095,434688
1801,zijianjoy,8,0.00184,67041,15.42279,434688
1802,zkutasi,8,0.00184,67049,15.42463,434688
1803,zliangliang1024,8,0.00184,67057,15.42647,434688
1804,zziawan,8,0.00184,67065,15.42831,434688
1805,18664599806,7,0.00161,67072,15.42992,434688
1806,aaronla-ms,7,0.00161,67079,15.43153,434688
1807,aasim-syed,7,0.00161,67086,15.43314,434688
1808,AbdYsn,7,0.00161,67093,15.43475,434688
1809,acezen,7,0.00161,67100,15.43636,434688
1810,adamwoolhether,7,0.00161,67107,15.43797,434688
1811,adi90x,7,0.00161,67114,15.43958,434688
1812,adilhafeez,7,0.00161,67121,15.44119,434688
1813,alborotogarcia,7,0.00161,67128,15.44280,434688
1814,alexbarbato,7,0.00161,67135,15.44441,434688
1815,alex-petrov-vt,7,0.00161,67142,15.44602,434688
1816,Alfa-Alex,7,0.00161,67149,15.44763,434688
1817,allen-mun,7,0.00161,67156,15.44924,434688
1818,AlpherJang,7,0.00161,67163,15.45085,434688
1819,amisevsk,7,0.00161,67170,15.45246,434688
1820,amitherlekar,7,0.00161,67177,15.45407,434688
1821,amitsadaphule,7,0.00161,67184,15.45568,434688
1822,amjad489,7,0.00161,67191,15.45729,434688
1823,amybachir,7,0.00161,67198,15.45890,434688
1824,anantsaraswat,7,0.00161,67205,15.46051,434688
1825,AndresJulia,7,0.00161,67212,15.46212,434688
1826,anemyte,7,0.00161,67219,15.46373,434688
1827,ankitanallana-livongo,7,0.00161,67226,15.46535,434688
1828,anmaxvl,7,0.00161,67233,15.46696,434688
1829,anv-mga,7,0.00161,67240,15.46857,434688
1830,araujof,7,0.00161,67247,15.47018,434688
1831,arjenvdhave,7,0.00161,67254,15.47179,434688
1832,arnarg,7,0.00161,67261,15.47340,434688
1833,AustinSchuh,7,0.00161,67268,15.47501,434688
1834,B3DTech,7,0.00161,67275,15.47662,434688
1835,bastianeicher,7,0.00161,67282,15.47823,434688
1836,bathina2,7,0.00161,67289,15.47984,434688
1837,baurine,7,0.00161,67296,15.48145,434688
1838,bbgobie,7,0.00161,67303,15.48306,434688
1839,bchen28,7,0.00161,67310,15.48467,434688
1840,becoded,7,0.00161,67317,15.48628,434688
1841,BenjaminHuang,7,0.00161,67324,15.48789,434688
1842,BenoitKnecht,7,0.00161,67331,15.48950,434688
1843,Birdrock,7,0.00161,67338,15.49111,434688
1844,bkalem,7,0.00161,67345,15.49272,434688
1845,bkupidura,7,0.00161,67352,15.49433,434688
1846,bo0ts,7,0.00161,67359,15.49594,434688
1847,bonareal,7,0.00161,67366,15.49755,434688
1848,boriwo,7,0.00161,67373,15.49916,434688
1849,browncrane,7,0.00161,67380,15.50077,434688
1850,brucelwl,7,0.00161,67387,15.50238,434688
1851,bs-santhosh,7,0.00161,67394,15.50399,434688
1852,buddhi-desilva,7,0.00161,67401,15.50560,434688
1853,cdhunt,7,0.00161,67408,15.50721,434688
1854,cecton,7,0.00161,67415,15.50882,434688
1855,Cellebyte,7,0.00161,67422,15.51044,434688
1856,cg2p,7,0.00161,67429,15.51205,434688
1857,cgorbit,7,0.00161,67436,15.51366,434688
1858,Charizard,7,0.00161,67443,15.51527,434688
1859,chenaoXD,7,0.00161,67450,15.51688,434688
1860,chinzhiweiblank,7,0.00161,67457,15.51849,434688
1861,chlam4,7,0.00161,67464,15.52010,434688
1862,chrislatimer,7,0.00161,67471,15.52171,434688
1863,clly,7,0.00161,67478,15.52332,434688
1864,cmille62,7,0.00161,67485,15.52493,434688
1865,cnukwas,7,0.00161,67492,15.52654,434688
1866,Concurrensee,7,0.00161,67499,15.52815,434688
1867,CoryKoehler,7,0.00161,67506,15.52976,434688
1868,cuiyeshuai,7,0.00161,67513,15.53137,434688
1869,daftgopher,7,0.00161,67520,15.53298,434688
1870,daimg,7,0.00161,67527,15.53459,434688
1871,damienbutt,7,0.00161,67534,15.53620,434688
1872,DanArlowski,7,0.00161,67541,15.53781,434688
1873,danielwegener,7,0.00161,67548,15.53942,434688
1874,Danny-Wei,7,0.00161,67555,15.54103,434688
1875,daviddyball,7,0.00161,67562,15.54264,434688
1876,deb2000-sudo,7,0.00161,67569,15.54425,434688
1877,democracytoday,7,0.00161,67576,15.54586,434688
1878,dempti,7,0.00161,67583,15.54747,434688
1879,devosalain,7,0.00161,67590,15.54908,434688
1880,DFSOrange,7,0.00161,67597,15.55069,434688
1881,DhananjayPurohit,7,0.00161,67604,15.55230,434688
1882,didovesei,7,0.00161,67611,15.55391,434688
1883,disposab1e,7,0.00161,67618,15.55552,434688
1884,dragoangel,7,0.00161,67625,15.55714,434688
1885,dudicoco,7,0.00161,67632,15.55875,434688
1886,ederst,7,0.00161,67639,15.56036,434688
1887,edma2,7,0.00161,67646,15.56197,434688
1888,edoardo-c,7,0.00161,67653,15.56358,434688
1889,edribeirojunior,7,0.00161,67660,15.56519,434688
1890,edwardxia,7,0.00161,67667,15.56680,434688
1891,EHSchmitt4395,7,0.00161,67674,15.56841,434688
1892,elton557,7,0.00161,67681,15.57002,434688
1893,enkelprifti98,7,0.00161,67688,15.57163,434688
1894,eonward,7,0.00161,67695,15.57324,434688
1895,ericlake,7,0.00161,67702,15.57485,434688
1896,erkist,7,0.00161,67709,15.57646,434688
1897,ethframe,7,0.00161,67716,15.57807,434688
1898,Etienne-Carriere,7,0.00161,67723,15.57968,434688
1899,evergreen-trading-systems,7,0.00161,67730,15.58129,434688
1900,Expalex,7,0.00161,67737,15.58290,434688
1901,f10atin9,7,0.00161,67744,15.58451,434688
1902,fabiovn,7,0.00161,67751,15.58612,434688
1903,fdpeiter,7,0.00161,67758,15.58773,434688
1904,feeltimeQ,7,0.00161,67765,15.58934,434688
1905,Flou21,7,0.00161,67772,15.59095,434688
1906,G5Olivieri,7,0.00161,67779,15.59256,434688
1907,gartemiev,7,0.00161,67786,15.59417,434688
1908,giuseppeiannelli,7,0.00161,67793,15.59578,434688
1909,glueball,7,0.00161,67800,15.59739,434688
1910,gojoy,7,0.00161,67807,15.59900,434688
1911,gquintana,7,0.00161,67814,15.60061,434688
1912,gricuk,7,0.00161,67821,15.60223,434688
1913,grunlab,7,0.00161,67828,15.60384,434688
1914,gsmirnov-splk,7,0.00161,67835,15.60545,434688
1915,GuangmingLuo,7,0.00161,67842,15.60706,434688
1916,gujun4990,7,0.00161,67849,15.60867,434688
1917,harivall,7,0.00161,67856,15.61028,434688
1918,harkiratsm,7,0.00161,67863,15.61189,434688
1919,harshmathurx,7,0.00161,67870,15.61350,434688
1920,hem2,7,0.00161,67877,15.61511,434688
1921,henryleduc,7,0.00161,67884,15.61672,434688
1922,henryzhangsta,7,0.00161,67891,15.61833,434688
1923,hickersonj,7,0.00161,67898,15.61994,434688
1924,Hiiirad,7,0.00161,67905,15.62155,434688
1925,hinewwiner,7,0.00161,67912,15.62316,434688
1926,hizegi,7,0.00161,67919,15.62477,434688
1927,Hoohaha,7,0.00161,67926,15.62638,434688
1928,ievgenii-shepeliuk,7,0.00161,67933,15.62799,434688
1929,istvanek,7,0.00161,67940,15.62960,434688
1930,isugimpy,7,0.00161,67947,15.63121,434688
1931,jayd16,7,0.00161,67954,15.63282,434688
1932,Jaypov,7,0.00161,67961,15.63443,434688
1933,jbaez,7,0.00161,67968,15.63604,434688
1934,jevon-23,7,0.00161,67975,15.63765,434688
1935,jfrabaute,7,0.00161,67982,15.63926,434688
1936,jhbae200,7,0.00161,67989,15.64087,434688
1937,jlclx,7,0.00161,67996,15.64248,434688
1938,jobcespedes,7,0.00161,68003,15.64409,434688
1939,Jonas18175,7,0.00161,68010,15.64570,434688
1940,jooooel,7,0.00161,68017,15.64731,434688
1941,jowko,7,0.00161,68024,15.64893,434688
1942,jrife,7,0.00161,68031,15.65054,434688
1943,jrowinski3d,7,0.00161,68038,15.65215,434688
1944,jschintag,7,0.00161,68045,15.65376,434688
1945,juampynr,7,0.00161,68052,15.65537,434688
1946,jyaworski,7,0.00161,68059,15.65698,434688
1947,kailun-qin,7,0.00161,68066,15.65859,434688
1948,kam1kaze,7,0.00161,68073,15.66020,434688
1949,KamalSinghKhanna,7,0.00161,68080,15.66181,434688
1950,Kaszanas,7,0.00161,68087,15.66342,434688
1951,keiSunagawa,7,0.00161,68094,15.66503,434688
1952,khemendra0,7,0.00161,68101,15.66664,434688
1953,kiranchavala,7,0.00161,68108,15.66825,434688
1954,kit837,7,0.00161,68115,15.66986,434688
1955,kompetenzlandkarte,7,0.00161,68122,15.67147,434688
1956,kostyay,7,0.00161,68129,15.67308,434688
1957,ksaur,7,0.00161,68136,15.67469,434688
1958,KShivendu,7,0.00161,68143,15.67630,434688
1959,kurumoorthi89,7,0.00161,68150,15.67791,434688
1960,kvandra,7,0.00161,68157,15.67952,434688
1961,kw7oe,7,0.00161,68164,15.68113,434688
1962,lahirurd,7,0.00161,68171,15.68274,434688
1963,lasred,7,0.00161,68178,15.68435,434688
1964,lavender04,7,0.00161,68185,15.68596,434688
1965,lazybetrayer,7,0.00161,68192,15.68757,434688
1966,leon-marcel,7,0.00161,68199,15.68918,434688
1967,LevonBecker,7,0.00161,68206,15.69079,434688
1968,lf2186,7,0.00161,68213,15.69240,434688
1969,Links2004,7,0.00161,68220,15.69402,434688
1970,liuchintao,7,0.00161,68227,15.69563,434688
1971,lobziik,7,0.00161,68234,15.69724,434688
1972,loopingz,7,0.00161,68241,15.69885,434688
1973,ls-robert-holosynskyi,7,0.00161,68248,15.70046,434688
1974,lubingfeng,7,0.00161,68255,15.70207,434688
1975,luhahn,7,0.00161,68262,15.70368,434688
1976,mac-chaffee,7,0.00161,68269,15.70529,434688
1977,makusu2,7,0.00161,68276,15.70690,434688
1978,maldago,7,0.00161,68283,15.70851,434688
1979,mallow111,7,0.00161,68290,15.71012,434688
1980,MartinEmrich,7,0.00161,68297,15.71173,434688
1981,martinkuba,7,0.00161,68304,15.71334,434688
1982,MartinNovak1991,7,0.00161,68311,15.71495,434688
1983,mattrussell-sonocent,7,0.00161,68318,15.71656,434688
1984,maxg-teachable,7,0.00161,68325,15.71817,434688
1985,mbruner,7,0.00161,68332,15.71978,434688
1986,mddamato,7,0.00161,68339,15.72139,434688
1987,MelbourneDeveloper,7,0.00161,68346,15.72300,434688
1988,merlante,7,0.00161,68353,15.72461,434688
1989,mhoppe-cedar,7,0.00161,68360,15.72622,434688
1990,mikehuston,7,0.00161,68367,15.72783,434688
1991,mingqing,7,0.00161,68374,15.72944,434688
1992,minh-nguyenquang,7,0.00161,68381,15.73105,434688
1993,missingcharacter,7,0.00161,68388,15.73266,434688
1994,mkorfgoogle,7,0.00161,68395,15.73427,434688
1995,mladedav,7,0.00161,68402,15.73588,434688
1996,mlieberman85,7,0.00161,68409,15.73749,434688
1997,mohit94614,7,0.00161,68416,15.73910,434688
1998,mrmagicli,7,0.00161,68423,15.74072,434688
1999,MukulMaheshwari,7,0.00161,68430,15.74233,434688
2000,musJinx,7,0.00161,68437,15.74394,434688
2001,n2ygk,7,0.00161,68444,15.74555,434688
2002,nagarajtrivedi,7,0.00161,68451,15.74716,434688
2003,nguyenhien1994,7,0.00161,68458,15.74877,434688
2004,Nish0808,7,0.00161,68465,15.75038,434688
2005,NishantG01,7,0.00161,68472,15.75199,434688
2006,nissayeva,7,0.00161,68479,15.75360,434688
2007,Nivedita-coder,7,0.00161,68486,15.75521,434688
2008,nmaki,7,0.00161,68493,15.75682,434688
2009,noyessie,7,0.00161,68500,15.75843,434688
2010,oif,7,0.00161,68507,15.76004,434688
2011,okaybase,7,0.00161,68514,15.76165,434688
2012,Onyinye91-ctrl,7,0.00161,68521,15.76326,434688
2013,osherdp,7,0.00161,68528,15.76487,434688
2014,paleozogt,7,0.00161,68535,15.76648,434688
2015,peterwardle,7,0.00161,68542,15.76809,434688
2016,philipp94831,7,0.00161,68549,15.76970,434688
2017,phspies,7,0.00161,68556,15.77131,434688
2018,pipijiev12,7,0.00161,68563,15.77292,434688
2019,piyushgupta1551,7,0.00161,68570,15.77453,434688
2020,plenkl,7,0.00161,68577,15.77614,434688
2021,prowave,7,0.00161,68584,15.77775,434688
2022,quickgiant,7,0.00161,68591,15.77936,434688
2023,rahulbandariSensei,7,0.00161,68598,15.78097,434688
2024,raindylong,7,0.00161,68605,15.78258,434688
2025,raj-katonic,7,0.00161,68612,15.78419,434688
2026,rantianhua,7,0.00161,68619,15.78580,434688
2027,rayjanoka,7,0.00161,68626,15.78742,434688
2028,rdgacarvalho,7,0.00161,68633,15.78903,434688
2029,reapedjuggler,7,0.00161,68640,15.79064,434688
2030,regentov,7,0.00161,68647,15.79225,434688
2031,ReggieCarey,7,0.00161,68654,15.79386,434688
2032,richackard,7,0.00161,68661,15.79547,434688
2033,RickSC,7,0.00161,68668,15.79708,434688
2034,robododge,7,0.00161,68675,15.79869,434688
2035,rowanthorpe,7,0.00161,68682,15.80030,434688
2036,ruben-herold,7,0.00161,68689,15.80191,434688
2037,ruiyaoOps,7,0.00161,68696,15.80352,434688
2038,rumstead,7,0.00161,68703,15.80513,434688
2039,sagar-jadhav,7,0.00161,68710,15.80674,434688
2040,san-coding,7,0.00161,68717,15.80835,434688
2041,sanmai,7,0.00161,68724,15.80996,434688
2042,sbellan,7,0.00161,68731,15.81157,434688
2043,scirner22,7,0.00161,68738,15.81318,434688
2044,seanw2020,7,0.00161,68745,15.81479,434688
2045,sebastianhutter,7,0.00161,68752,15.81640,434688
2046,sevagh,7,0.00161,68759,15.81801,434688
2047,shanecunningham,7,0.00161,68766,15.81962,434688
2048,shannonflying,7,0.00161,68773,15.82123,434688
2049,shaowenchen,7,0.00161,68780,15.82284,434688
2050,sloveridge,7,0.00161,68787,15.82445,434688
2051,snazzysoftware,7,0.00161,68794,15.82606,434688
2052,Sojaner,7,0.00161,68801,15.82767,434688
2053,stephenhong,7,0.00161,68808,15.82928,434688
2054,stone-z,7,0.00161,68815,15.83089,434688
2055,sumitk23,7,0.00161,68822,15.83251,434688
2056,svpace,7,0.00161,68829,15.83412,434688
2057,tathougies,7,0.00161,68836,15.83573,434688
2058,tavolodobela,7,0.00161,68843,15.83734,434688
2059,TaylorMutch,7,0.00161,68850,15.83895,434688
2060,tdolby-at-uk-ibm-com,7,0.00161,68857,15.84056,434688
2061,tenevdev,7,0.00161,68864,15.84217,434688
2062,TennyZhuang,7,0.00161,68871,15.84378,434688
2063,tenzen-y,7,0.00161,68878,15.84539,434688
2064,ThomasSteinbach,7,0.00161,68885,15.84700,434688
2065,tiezhuoyu,7,0.00161,68892,15.84861,434688
2066,Timoses,7,0.00161,68899,15.85022,434688
2067,timyates,7,0.00161,68906,15.85183,434688
2068,tohjustin,7,0.00161,68913,15.85344,434688
2069,tomkivlin,7,0.00161,68920,15.85505,434688
2070,tonglsh,7,0.00161,68927,15.85666,434688
2071,trathailoi,7,0.00161,68934,15.85827,434688
2072,tyler-bixal,7,0.00161,68941,15.85988,434688
2073,ujjwalgarg1995,7,0.00161,68948,15.86149,434688
2074,umialpha,7,0.00161,68955,15.86310,434688
2075,univerone,7,0.00161,68962,15.86471,434688
2076,VannTen,7,0.00161,68969,15.86632,434688
2077,VarunSrinivasa,7,0.00161,68976,15.86793,434688
2078,vas-rus,7,0.00161,68983,15.86954,434688
2079,vauchok,7,0.00161,68990,15.87115,434688
2080,vczyh,7,0.00161,68997,15.87276,434688
2081,vflaux,7,0.00161,69004,15.87437,434688
2082,vivek-koppuru,7,0.00161,69011,15.87598,434688
2083,VJftw,7,0.00161,69018,15.87759,434688
2084,vladdoster,7,0.00161,69025,15.87921,434688
2085,wei840222,7,0.00161,69032,15.88082,434688
2086,WenzelZ,7,0.00161,69039,15.88243,434688
2087,wind57,7,0.00161,69046,15.88404,434688
2088,Windrow,7,0.00161,69053,15.88565,434688
2089,wizbit,7,0.00161,69060,15.88726,434688
2090,wouldgo,7,0.00161,69067,15.88887,434688
2091,xhochy,7,0.00161,69074,15.89048,434688
2092,yalctay93,7,0.00161,69081,15.89209,434688
2093,Yerannnnnn,7,0.00161,69088,15.89370,434688
2094,yerzhant,7,0.00161,69095,15.89531,434688
2095,yunkunrao,7,0.00161,69102,15.89692,434688
2096,yupeng0921,7,0.00161,69109,15.89853,434688
2097,zanven42,7,0.00161,69116,15.90014,434688
2098,zdmytriv,7,0.00161,69123,15.90175,434688
2099,znewman01,7,0.00161,69130,15.90336,434688
2100,zonybob,7,0.00161,69137,15.90497,434688
2101,1125f3da-6abf-4975-9a7d-841cc7f1b38e,6,0.00138,69143,15.90635,434688
2102,3pointer,6,0.00138,69149,15.90773,434688
2103,Aaron1011,6,0.00138,69155,15.90911,434688
2104,aarongreenlee,6,0.00138,69161,15.91049,434688
2105,aaroosh-07,6,0.00138,69167,15.91187,434688
2106,acarmel,6,0.00138,69173,15.91325,434688
2107,AceFire6,6,0.00138,69179,15.91463,434688
2108,AdinhLux,6,0.00138,69185,15.91601,434688
2109,ado120,6,0.00138,69191,15.91739,434688
2110,agryash,6,0.00138,69197,15.91877,434688
2111,akash19980,6,0.00138,69203,15.92015,434688
2112,akitzing,6,0.00138,69209,15.92153,434688
2113,akvlad,6,0.00138,69215,15.92291,434688
2114,Alan-pad,6,0.00138,69221,15.92430,434688
2115,alexku7,6,0.00138,69227,15.92568,434688
2116,alkmim,6,0.00138,69233,15.92706,434688
2117,Alvaro-Campesino,6,0.00138,69239,15.92844,434688
2118,anand3493,6,0.00138,69245,15.92982,434688
2119,AnatomicJC,6,0.00138,69251,15.93120,434688
2120,andreib1,6,0.00138,69257,15.93258,434688
2121,andrewm-aero,6,0.00138,69263,15.93396,434688
2122,andriktr,6,0.00138,69269,15.93534,434688
2123,andycwk,6,0.00138,69275,15.93672,434688
2124,anigkus,6,0.00138,69281,15.93810,434688
2125,anthony-alessi-acquia,6,0.00138,69287,15.93948,434688
2126,anyulled,6,0.00138,69293,15.94086,434688
2127,aravindvs,6,0.00138,69299,15.94224,434688
2128,artem-kosenko,6,0.00138,69305,15.94362,434688
2129,ashishranjan1457,6,0.00138,69311,15.94500,434688
2130,ashish-varma,6,0.00138,69317,15.94638,434688
2131,ashwin153,6,0.00138,69323,15.94776,434688
2132,aspectom,6,0.00138,69329,15.94914,434688
2133,Atharex,6,0.00138,69335,15.95052,434688
2134,balasu,6,0.00138,69341,15.95190,434688
2135,baojr,6,0.00138,69347,15.95328,434688
2136,bartpeeters,6,0.00138,69353,15.95466,434688
2137,basanaguk,6,0.00138,69359,15.95604,434688
2138,BatanGaming,6,0.00138,69365,15.95742,434688
2139,bbagwellffn,6,0.00138,69371,15.95880,434688
2140,benja-wu,6,0.00138,69377,15.96018,434688
2141,benmorehouse,6,0.00138,69383,15.96156,434688
2142,bertdeblock,6,0.00138,69389,15.96294,434688
2143,bherw,6,0.00138,69395,15.96432,434688
2144,bigmarvin,6,0.00138,69401,15.96570,434688
2145,bit-project-de,6,0.00138,69407,15.96708,434688
2146,bks-wujt,6,0.00138,69413,15.96846,434688
2147,blackredscarf,6,0.00138,69419,15.96985,434688
2148,blastik,6,0.00138,69425,15.97123,434688
2149,bluelion,6,0.00138,69431,15.97261,434688
2150,bob-bins,6,0.00138,69437,15.97399,434688
2151,Boojapho,6,0.00138,69443,15.97537,434688
2152,braunsonm,6,0.00138,69449,15.97675,434688
2153,bravous,6,0.00138,69455,15.97813,434688
2154,brianderdiarian,6,0.00138,69461,15.97951,434688
2155,brovatten,6,0.00138,69467,15.98089,434688
2156,brunoterkaly,6,0.00138,69473,15.98227,434688
2157,btrepp,6,0.00138,69479,15.98365,434688
2158,byangtri,6,0.00138,69485,15.98503,434688
2159,caitmulholland,6,0.00138,69491,15.98641,434688
2160,chance2021,6,0.00138,69497,15.98779,434688
2161,changqingsun,6,0.00138,69503,15.98917,434688
2162,charbonnierg,6,0.00138,69509,15.99055,434688
2163,ChaturvediSulabh,6,0.00138,69515,15.99193,434688
2164,chrispytoes,6,0.00138,69521,15.99331,434688
2165,chrisrd,6,0.00138,69527,15.99469,434688
2166,Christian-Oleson,6,0.00138,69533,15.99607,434688
2167,clive-jevons,6,0.00138,69539,15.99745,434688
2168,cloud-66,6,0.00138,69545,15.99883,434688
2169,clrxbl,6,0.00138,69551,16.00021,434688
2170,cnbailian,6,0.00138,69557,16.00159,434688
2171,courtneygreif,6,0.00138,69563,16.00297,434688
2172,craig-riecke,6,0.00138,69569,16.00435,434688
2173,crsandeep,6,0.00138,69575,16.00573,434688
2174,csamant-salesforce,6,0.00138,69581,16.00711,434688
2175,c-s-t-z,6,0.00138,69587,16.00849,434688
2176,cuirunxing-hub,6,0.00138,69593,16.00987,434688
2177,cursedclock,6,0.00138,69599,16.01125,434688
2178,D3DeFi,6,0.00138,69605,16.01263,434688
2179,dakshberry121,6,0.00138,69611,16.01401,434688
2180,danieliziourov-form3,6,0.00138,69617,16.01539,434688
2181,DanielJonesEB,6,0.00138,69623,16.01678,434688
2182,DanielShor,6,0.00138,69629,16.01816,434688
2183,darkpssngr,6,0.00138,69635,16.01954,434688
2184,darryk10,6,0.00138,69641,16.02092,434688
2185,dasiths,6,0.00138,69647,16.02230,434688
2186,DAtanassov1,6,0.00138,69653,16.02368,434688
2187,Davidde94,6,0.00138,69659,16.02506,434688
2188,davidor,6,0.00138,69665,16.02644,434688
2189,Davidrjx,6,0.00138,69671,16.02782,434688
2190,dberkov,6,0.00138,69677,16.02920,434688
2191,dbsid,6,0.00138,69683,16.03058,434688
2192,dehaansa,6,0.00138,69689,16.03196,434688
2193,dharmendrakariya,6,0.00138,69695,16.03334,434688
2194,dharmjit,6,0.00138,69701,16.03472,434688
2195,dhruv0000,6,0.00138,69707,16.03610,434688
2196,djknowles21,6,0.00138,69713,16.03748,434688
2197,d-niu,6,0.00138,69719,16.03886,434688
2198,dolfim,6,0.00138,69725,16.04024,434688
2199,Dorn-,6,0.00138,69731,16.04162,434688
2200,dostalradim,6,0.00138,69737,16.04300,434688
2201,dotunolafunmiloye,6,0.00138,69743,16.04438,434688
2202,douglasread,6,0.00138,69749,16.04576,434688
2203,dsaydon90,6,0.00138,69755,16.04714,434688
2204,dzmitry-kankalovich,6,0.00138,69761,16.04852,434688
2205,edobry,6,0.00138,69767,16.04990,434688
2206,edward-bear,6,0.00138,69773,16.05128,434688
2207,eharaj1,6,0.00138,69779,16.05266,434688
2208,ehf,6,0.00138,69785,16.05404,434688
2209,EKami,6,0.00138,69791,16.05542,434688
2210,EricGreen239,6,0.00138,69797,16.05680,434688
2211,ericksoen,6,0.00138,69803,16.05818,434688
2212,Erokos,6,0.00138,69809,16.05956,434688
2213,esigo,6,0.00138,69815,16.06094,434688
2214,evertrain,6,0.00138,69821,16.06233,434688
2215,exokortex,6,0.00138,69827,16.06371,434688
2216,f-a-a,6,0.00138,69833,16.06509,434688
2217,fcorti,6,0.00138,69839,16.06647,434688
2218,ferbar,6,0.00138,69845,16.06785,434688
2219,FFFrog,6,0.00138,69851,16.06923,434688
2220,franksinankaya,6,0.00138,69857,16.07061,434688
2221,FruityWelsh,6,0.00138,69863,16.07199,434688
2222,fubinzh,6,0.00138,69869,16.07337,434688
2223,gabrielalbino,6,0.00138,69875,16.07475,434688
2224,GauravKakoti,6,0.00138,69881,16.07613,434688
2225,gfrankliu,6,0.00138,69887,16.07751,434688
2226,g-gaston,6,0.00138,69893,16.07889,434688
2227,ghabarid,6,0.00138,69899,16.08027,434688
2228,ghevge,6,0.00138,69905,16.08165,434688
2229,GingoBang,6,0.00138,69911,16.08303,434688
2230,gooddalton,6,0.00138,69917,16.08441,434688
2231,gossion,6,0.00138,69923,16.08579,434688
2232,goutamtadi1,6,0.00138,69929,16.08717,434688
2233,gpanagiotidis,6,0.00138,69935,16.08855,434688
2234,guillermotti,6,0.00138,69941,16.08993,434688
2235,guyoulan,6,0.00138,69947,16.09131,434688
2236,haijianyang,6,0.00138,69953,16.09269,434688
2237,hellobiek,6,0.00138,69959,16.09407,434688
2238,henro001,6,0.00138,69965,16.09545,434688
2239,hiromis,6,0.00138,69971,16.09683,434688
2240,hlacik,6,0.00138,69977,16.09821,434688
2241,holycheater,6,0.00138,69983,16.09959,434688
2242,horizonzy,6,0.00138,69989,16.10097,434688
2243,HuFei2017,6,0.00138,69995,16.10235,434688
2244,hysyeah,6,0.00138,70001,16.10373,434688
2245,IanMoroney,6,0.00138,70007,16.10511,434688
2246,ichasco-heytrade,6,0.00138,70013,16.10649,434688
2247,imheresamir,6,0.00138,70019,16.10788,434688
2248,inaryart,6,0.00138,70025,16.10926,434688
2249,ironstar94,6,0.00138,70031,16.11064,434688
2250,jaideepbellani,6,0.00138,70037,16.11202,434688
2251,JamesHeppenstall,6,0.00138,70043,16.11340,434688
2252,Jashpatel1,6,0.00138,70049,16.11478,434688
2253,javamachr,6,0.00138,70055,16.11616,434688
2254,javierguzman,6,0.00138,70061,16.11754,434688
2255,JavierR14,6,0.00138,70067,16.11892,434688
2256,jaxesn,6,0.00138,70073,16.12030,434688
2257,jbilliau-rcd,6,0.00138,70079,16.12168,434688
2258,Jc2k,6,0.00138,70085,16.12306,434688
2259,jdstone,6,0.00138,70091,16.12444,434688
2260,jeanlouhallee,6,0.00138,70097,16.12582,434688
2261,jedimasterjonny,6,0.00138,70103,16.12720,434688
2262,jehof,6,0.00138,70109,16.12858,434688
2263,jess-belliveau,6,0.00138,70115,16.12996,434688
2264,jesusvazquez,6,0.00138,70121,16.13134,434688
2265,jeyjeyemem,6,0.00138,70127,16.13272,434688
2266,jgillich,6,0.00138,70133,16.13410,434688
2267,jicki,6,0.00138,70139,16.13548,434688
2268,jingliming,6,0.00138,70145,16.13686,434688
2269,JLHasson,6,0.00138,70151,16.13824,434688
2270,jmpolom,6,0.00138,70157,16.13962,434688
2271,joaosilva15,6,0.00138,70163,16.14100,434688
2272,John-Athan,6,0.00138,70169,16.14238,434688
2273,jonassteinberg1,6,0.00138,70175,16.14376,434688
2274,JonParton,6,0.00138,70181,16.14514,434688
2275,jskelin,6,0.00138,70187,16.14652,434688
2276,JuanPabloGarciaMonzon,6,0.00138,70193,16.14790,434688
2277,JWKartheiser,6,0.00138,70199,16.14928,434688
2278,kangzhang,6,0.00138,70205,16.15066,434688
2279,kannamr,6,0.00138,70211,16.15204,434688
2280,karansinghneu,6,0.00138,70217,16.15342,434688
2281,kaushambisharma,6,0.00138,70223,16.15481,434688
2282,kengu,6,0.00138,70229,16.15619,434688
2283,keshamin,6,0.00138,70235,16.15757,434688
2284,kevinschoonover,6,0.00138,70241,16.15895,434688
2285,kharf,6,0.00138,70247,16.16033,434688
2286,khbrady,6,0.00138,70253,16.16171,434688
2287,kkujawa-sumo,6,0.00138,70259,16.16309,434688
2288,knkarthik,6,0.00138,70265,16.16447,434688
2289,konghui,6,0.00138,70271,16.16585,434688
2290,kosecki123,6,0.00138,70277,16.16723,434688
2291,krisek,6,0.00138,70283,16.16861,434688
2292,kriskrishna,6,0.00138,70289,16.16999,434688
2293,Kumar6295,6,0.00138,70295,16.17137,434688
2294,kvcache,6,0.00138,70301,16.17275,434688
2295,lanzhiwang,6,0.00138,70307,16.17413,434688
2296,lebedevsergey,6,0.00138,70313,16.17551,434688
2297,leRobbe,6,0.00138,70319,16.17689,434688
2298,lhchang,6,0.00138,70325,16.17827,434688
2299,lilongfeng0902,6,0.00138,70331,16.17965,434688
2300,LindaYu17,6,0.00138,70337,16.18103,434688
2301,Lingx9,6,0.00138,70343,16.18241,434688
2302,lirlia,6,0.00138,70349,16.18379,434688
2303,lixiang12407,6,0.00138,70355,16.18517,434688
2304,liyuntao,6,0.00138,70361,16.18655,434688
2305,lnattrass,6,0.00138,70367,16.18793,434688
2306,LockLi,6,0.00138,70373,16.18931,434688
2307,lod3456,6,0.00138,70379,16.19069,434688
2308,logrusorgru,6,0.00138,70385,16.19207,434688
2309,lorenzofaresin,6,0.00138,70391,16.19345,434688
2310,lucasmdrs,6,0.00138,70397,16.19483,434688
2311,lucasMesquitaBorges,6,0.00138,70403,16.19621,434688
2312,luchaoqi,6,0.00138,70409,16.19759,434688
2313,luigibk,6,0.00138,70415,16.19897,434688
2314,lukos,6,0.00138,70421,16.20036,434688
2315,Lyt99,6,0.00138,70427,16.20174,434688
2316,M4tteoP,6,0.00138,70433,16.20312,434688
2317,macktab,6,0.00138,70439,16.20450,434688
2318,MagicDevilZhang,6,0.00138,70445,16.20588,434688
2319,majidazimi,6,0.00138,70451,16.20726,434688
2320,malnajdi,6,0.00138,70457,16.20864,434688
2321,MarcaWitt,6,0.00138,70463,16.21002,434688
2322,mark-nc,6,0.00138,70469,16.21140,434688
2323,MatteoInfi,6,0.00138,70475,16.21278,434688
2324,mattgarmon,6,0.00138,70481,16.21416,434688
2325,mcbobke,6,0.00138,70487,16.21554,434688
2326,mertyildiran,6,0.00138,70493,16.21692,434688
2327,mgaunekar,6,0.00138,70499,16.21830,434688
2328,microyahoo,6,0.00138,70505,16.21968,434688
2329,mig4,6,0.00138,70511,16.22106,434688
2330,mihivagyok,6,0.00138,70517,16.22244,434688
2331,Mikhail2048,6,0.00138,70523,16.22382,434688
2332,minchao,6,0.00138,70529,16.22520,434688
2333,MirzaSikander,6,0.00138,70535,16.22658,434688
2334,mishamo,6,0.00138,70541,16.22796,434688
2335,mizhexiaoxiao,6,0.00138,70547,16.22934,434688
2336,mjrepo2,6,0.00138,70553,16.23072,434688
2337,mothershipper,6,0.00138,70559,16.23210,434688
2338,movd,6,0.00138,70565,16.23348,434688
2339,MoXinQian,6,0.00138,70571,16.23486,434688
2340,mqyang56,6,0.00138,70577,16.23624,434688
2341,mrjester888,6,0.00138,70583,16.23762,434688
2342,mvbn6789,6,0.00138,70589,16.23900,434688
2343,mwasilew2,6,0.00138,70595,16.24038,434688
2344,NaNi-Z,6,0.00138,70601,16.24176,434688
2345,nathan-415,6,0.00138,70607,16.24314,434688
2346,nayasam,6,0.00138,70613,16.24452,434688
2347,neo502721,6,0.00138,70619,16.24591,434688
2348,networkException,6,0.00138,70625,16.24729,434688
2349,n-hebert,6,0.00138,70631,16.24867,434688
2350,nico,6,0.00138,70637,16.25005,434688
2351,nicolastakashi,6,0.00138,70643,16.25143,434688
2352,NikNikM,6,0.00138,70649,16.25281,434688
2353,nnsense,6,0.00138,70655,16.25419,434688
2354,Nordie1,6,0.00138,70661,16.25557,434688
2355,nuno-silva,6,0.00138,70667,16.25695,434688
2356,ohadgur,6,0.00138,70673,16.25833,434688
2357,okin,6,0.00138,70679,16.25971,434688
2358,OleksandrMykytenko,6,0.00138,70685,16.26109,434688
2359,oliviermichaelis,6,0.00138,70691,16.26247,434688
2360,ONordander,6,0.00138,70697,16.26385,434688
2361,orangle,6,0.00138,70703,16.26523,434688
2362,or-shachar,6,0.00138,70709,16.26661,434688
2363,ozlotusflare,6,0.00138,70715,16.26799,434688
2364,pandarun,6,0.00138,70721,16.26937,434688
2365,pantaoran,6,0.00138,70727,16.27075,434688
2366,paramsethi,6,0.00138,70733,16.27213,434688
2367,PavelPolyakov,6,0.00138,70739,16.27351,434688
2368,Payaspx,6,0.00138,70745,16.27489,434688
2369,PeterEltgroth,6,0.00138,70751,16.27627,434688
2370,PeterF778,6,0.00138,70757,16.27765,434688
2371,peteroruba,6,0.00138,70763,16.27903,434688
2372,phho,6,0.00138,70769,16.28041,434688
2373,piercetrey-figure,6,0.00138,70775,16.28179,434688
2374,piglei,6,0.00138,70781,16.28317,434688
2375,PigNatovsky,6,0.00138,70787,16.28455,434688
2376,pkbhowmick,6,0.00138,70793,16.28593,434688
2377,pmanno,6,0.00138,70799,16.28731,434688
2378,potatochip,6,0.00138,70805,16.28869,434688
2379,PranshuSrivastava,6,0.00138,70811,16.29007,434688
2380,pratikgote,6,0.00138,70817,16.29146,434688
2381,Praveenrajmani,6,0.00138,70823,16.29284,434688
2382,presztak,6,0.00138,70829,16.29422,434688
2383,p-rog,6,0.00138,70835,16.29560,434688
2384,prousso,6,0.00138,70841,16.29698,434688
2385,ptitvert,6,0.00138,70847,16.29836,434688
2386,python279,6,0.00138,70853,16.29974,434688
2387,qiansheng91,6,0.00138,70859,16.30112,434688
2388,ranger-huang,6,0.00138,70865,16.30250,434688
2389,r-ashish,6,0.00138,70871,16.30388,434688
2390,Raskosk,6,0.00138,70877,16.30526,434688
2391,ravargs,6,0.00138,70883,16.30664,434688
2392,rayshoo,6,0.00138,70889,16.30802,434688
2393,rctay,6,0.00138,70895,16.30940,434688
2394,renato1891,6,0.00138,70901,16.31078,434688
2395,rohanmathure,6,0.00138,70907,16.31216,434688
2396,rouja,6,0.00138,70913,16.31354,434688
2397,rpiceage,6,0.00138,70919,16.31492,434688
2398,rptaylor,6,0.00138,70925,16.31630,434688
2399,rraj-gautam,6,0.00138,70931,16.31768,434688
2400,ruquanzhao,6,0.00138,70937,16.31906,434688
2401,rverchere,6,0.00138,70943,16.32044,434688
2402,rwxrob,6,0.00138,70949,16.32182,434688
2403,RyanBouchard,6,0.00138,70955,16.32320,434688
2404,RyouZhang,6,0.00138,70961,16.32458,434688
2405,safaci2000,6,0.00138,70967,16.32596,434688
2406,samanthawalter,6,0.00138,70973,16.32734,434688
2407,samuel-butcher,6,0.00138,70979,16.32872,434688
2408,SamuelStuchly,6,0.00138,70985,16.33010,434688
2409,SARANYA233,6,0.00138,70991,16.33148,434688
2410,sbidoul,6,0.00138,70997,16.33286,434688
2411,scheler,6,0.00138,71003,16.33424,434688
2412,SchmidtJonathan1,6,0.00138,71009,16.33562,434688
2413,scravy,6,0.00138,71015,16.33700,434688
2414,sebader,6,0.00138,71021,16.33839,434688
2415,Sebor,6,0.00138,71027,16.33977,434688
2416,sengjea,6,0.00138,71033,16.34115,434688
2417,sepulworld,6,0.00138,71039,16.34253,434688
2418,serenashe,6,0.00138,71045,16.34391,434688
2419,servak,6,0.00138,71051,16.34529,434688
2420,shapirus,6,0.00138,71057,16.34667,434688
2421,sherifkayad,6,0.00138,71063,16.34805,434688
2422,shwin0901,6,0.00138,71069,16.34943,434688
2423,shybbko,6,0.00138,71075,16.35081,434688
2424,silasfrigo,6,0.00138,71081,16.35219,434688
2425,SimonGurney,6,0.00138,71087,16.35357,434688
2426,sizowie,6,0.00138,71093,16.35495,434688
2427,skiptomyliu,6,0.00138,71099,16.35633,434688
2428,skpenpen,6,0.00138,71105,16.35771,434688
2429,skrishna-unix,6,0.00138,71111,16.35909,434688
2430,skywe-tang,6,0.00138,71117,16.36047,434688
2431,Slyke,6,0.00138,71123,16.36185,434688
2432,slzcc,6,0.00138,71129,16.36323,434688
2433,sodaRyCN,6,0.00138,71135,16.36461,434688
2434,sonnyhcl,6,0.00138,71141,16.36599,434688
2435,spron-in,6,0.00138,71147,16.36737,434688
2436,spuny,6,0.00138,71153,16.36875,434688
2437,srijan55,6,0.00138,71159,16.37013,434688
2438,ssh2go,6,0.00138,71165,16.37151,434688
2439,SubhasmitaSw,6,0.00138,71171,16.37289,434688
2440,sumitm-iiit,6,0.00138,71177,16.37427,434688
2441,SungYil,6,0.00138,71183,16.37565,434688
2442,swapnilbabladkar,6,0.00138,71189,16.37703,434688
2443,swati-delphix,6,0.00138,71195,16.37841,434688
2444,SynologyOpenSource,6,0.00138,71201,16.37979,434688
2445,sysadmiral,6,0.00138,71207,16.38117,434688
2446,szydek,6,0.00138,71213,16.38255,434688
2447,tanvp112,6,0.00138,71219,16.38394,434688
2448,tbertenshaw,6,0.00138,71225,16.38532,434688
2449,Tcharl,6,0.00138,71231,16.38670,434688
2450,tegefaulkes,6,0.00138,71237,16.38808,434688
2451,tejeshwari,6,0.00138,71243,16.38946,434688
2452,terylt,6,0.00138,71249,16.39084,434688
2453,theAkito,6,0.00138,71255,16.39222,434688
2454,TheKangaroo,6,0.00138,71261,16.39360,434688
2455,Thirumalai-Shaktivel,6,0.00138,71267,16.39498,434688
2456,thislyc,6,0.00138,71273,16.39636,434688
2457,thoraxe,6,0.00138,71279,16.39774,434688
2458,ThoSap,6,0.00138,71285,16.39912,434688
2459,tigerpeng2001,6,0.00138,71291,16.40050,434688
2460,Timdawson264,6,0.00138,71297,16.40188,434688
2461,tjhop,6,0.00138,71303,16.40326,434688
2462,tkovacs-2,6,0.00138,71309,16.40464,434688
2463,tmeralus,6,0.00138,71315,16.40602,434688
2464,tokt,6,0.00138,71321,16.40740,434688
2465,tommyknows,6,0.00138,71327,16.40878,434688
2466,tpetrov-lp,6,0.00138,71333,16.41016,434688
2467,tr1ck3r,6,0.00138,71339,16.41154,434688
2468,trallnag,6,0.00138,71345,16.41292,434688
2469,trelore,6,0.00138,71351,16.41430,434688
2470,TrucullentFreddi,6,0.00138,71357,16.41568,434688
2471,twifkak,6,0.00138,71363,16.41706,434688
2472,tylitianrui,6,0.00138,71369,16.41844,434688
2473,tzneal,6,0.00138,71375,16.41982,434688
2474,u5surf,6,0.00138,71381,16.42120,434688
2475,utkmishr,6,0.00138,71387,16.42258,434688
2476,UVV-gh,6,0.00138,71393,16.42396,434688
2477,vdesplanque,6,0.00138,71399,16.42534,434688
2478,VidarHUN,6,0.00138,71405,16.42672,434688
2479,vijay-dcrust,6,0.00138,71411,16.42810,434688
2480,vkubyshko,6,0.00138,71417,16.42949,434688
2481,voliveirajr,6,0.00138,71423,16.43087,434688
2482,wangshiboqq,6,0.00138,71429,16.43225,434688
2483,wenhuwang,6,0.00138,71435,16.43363,434688
2484,wentao-zh,6,0.00138,71441,16.43501,434688
2485,Winael,6,0.00138,71447,16.43639,434688
2486,windtalker,6,0.00138,71453,16.43777,434688
2487,wlmxjm1,6,0.00138,71459,16.43915,434688
2488,wolfmah,6,0.00138,71465,16.44053,434688
2489,wonleing,6,0.00138,71471,16.44191,434688
2490,wrong42,6,0.00138,71477,16.44329,434688
2491,wssccc,6,0.00138,71483,16.44467,434688
2492,wty4427300,6,0.00138,71489,16.44605,434688
2493,wu-cl,6,0.00138,71495,16.44743,434688
2494,wxqchimei,6,0.00138,71501,16.44881,434688
2495,wzrdtales,6,0.00138,71507,16.45019,434688
2496,Xartos,6,0.00138,71513,16.45157,434688
2497,xclud,6,0.00138,71519,16.45295,434688
2498,xiaomabetter,6,0.00138,71525,16.45433,434688
2499,xstephen95x,6,0.00138,71531,16.45571,434688
2500,yangmarcyang,6,0.00138,71537,16.45709,434688
2501,yangtau,6,0.00138,71543,16.45847,434688
2502,yanovich,6,0.00138,71549,16.45985,434688
2503,yaronf,6,0.00138,71555,16.46123,434688
2504,yedamao,6,0.00138,71561,16.46261,434688
2505,yehaotong,6,0.00138,71567,16.46399,434688
2506,yibozhuang,6,0.00138,71573,16.46537,434688
2507,yingbaiibm,6,0.00138,71579,16.46675,434688
2508,yinxx1007,6,0.00138,71585,16.46813,434688
2509,yogesh-reddy,6,0.00138,71591,16.46951,434688
2510,yongxiu,6,0.00138,71597,16.47089,434688
2511,yuchunyun,6,0.00138,71603,16.47227,434688
2512,YuriiPaneiko,6,0.00138,71609,16.47365,434688
2513,yutachaos,6,0.00138,71615,16.47503,434688
2514,yuyu2172,6,0.00138,71621,16.47642,434688
2515,zeromake,6,0.00138,71627,16.47780,434688
2516,zolug,6,0.00138,71633,16.47918,434688
2517,ZrytyADHD,6,0.00138,71639,16.48056,434688
2518,zs-dima,6,0.00138,71645,16.48194,434688
2519,zubairalimansoor,6,0.00138,71651,16.48332,434688
2520,zyguan,6,0.00138,71657,16.48470,434688
2521,zzchun,6,0.00138,71663,16.48608,434688
2522,1029219814,5,0.00115,71668,16.48723,434688
2523,23r096,5,0.00115,71673,16.48838,434688
2524,2hangchen,5,0.00115,71678,16.48953,434688
2525,a544793138,5,0.00115,71683,16.49068,434688
2526,abcd-ABCD-1234,5,0.00115,71688,16.49183,434688
2527,abhivaidya07,5,0.00115,71693,16.49298,434688
2528,abiosoft,5,0.00115,71698,16.49413,434688
2529,abyth,5,0.00115,71703,16.49528,434688
2530,adarmanto,5,0.00115,71708,16.49643,434688
2531,adduarte,5,0.00115,71713,16.49758,434688
2532,adgerrits,5,0.00115,71718,16.49873,434688
2533,agcom,5,0.00115,71723,16.49988,434688
2534,ahmedTouati,5,0.00115,71728,16.50103,434688
2535,AidanDelaney,5,0.00115,71733,16.50218,434688
2536,aido123,5,0.00115,71738,16.50333,434688
2537,akhil850,5,0.00115,71743,16.50448,434688
2538,akshatki,5,0.00115,71748,16.50563,434688
2539,Alan01252,5,0.00115,71753,16.50678,434688
2540,alex-berger,5,0.00115,71758,16.50793,434688
2541,alexrybch,5,0.00115,71763,16.50908,434688
2542,alex-treebeard,5,0.00115,71768,16.51023,434688
2543,aliencrash,5,0.00115,71773,16.51138,434688
2544,alirezaghey,5,0.00115,71778,16.51253,434688
2545,alittlehorse,5,0.00115,71783,16.51368,434688
2546,aloisbarreras,5,0.00115,71788,16.51483,434688
2547,aLowMagic,5,0.00115,71793,16.51598,434688
2548,ameypant13,5,0.00115,71798,16.51713,434688
2549,amsoedal,5,0.00115,71803,16.51828,434688
2550,amtisyAts,5,0.00115,71808,16.51943,434688
2551,Andrea-Wu,5,0.00115,71813,16.52058,434688
2552,AndreiPaulau,5,0.00115,71818,16.52174,434688
2553,aneeshcts,5,0.00115,71823,16.52289,434688
2554,Anonymity94,5,0.00115,71828,16.52404,434688
2555,anoyli,5,0.00115,71833,16.52519,434688
2556,anthonyhaussman,5,0.00115,71838,16.52634,434688
2557,aperrot42,5,0.00115,71843,16.52749,434688
2558,aramprice,5,0.00115,71848,16.52864,434688
2559,arekkusu,5,0.00115,71853,16.52979,434688
2560,ariary,5,0.00115,71858,16.53094,434688
2561,ArKam,5,0.00115,71863,16.53209,434688
2562,Arkessler,5,0.00115,71868,16.53324,434688
2563,arnitolog,5,0.00115,71873,16.53439,434688
2564,arvidOtt,5,0.00115,71878,16.53554,434688
2565,arvtiwar,5,0.00115,71883,16.53669,434688
2566,asardaes,5,0.00115,71888,16.53784,434688
2567,ashokspeelyaal,5,0.00115,71893,16.53899,434688
2568,askquestions,5,0.00115,71898,16.54014,434688
2569,assafmanzur,5,0.00115,71903,16.54129,434688
2570,asthomasdk,5,0.00115,71908,16.54244,434688
2571,atorrescogollo,5,0.00115,71913,16.54359,434688
2572,auvik-bheesham,5,0.00115,71918,16.54474,434688
2573,awhileback,5,0.00115,71923,16.54589,434688
2574,awsong,5,0.00115,71928,16.54704,434688
2575,Azulinho,5,0.00115,71933,16.54819,434688
2576,babickd,5,0.00115,71938,16.54934,434688
2577,badamowicz,5,0.00115,71943,16.55049,434688
2578,bbeattie-phxlabs,5,0.00115,71948,16.55164,434688
2579,bdluca,5,0.00115,71953,16.55279,434688
2580,beebyen,5,0.00115,71958,16.55394,434688
2581,Benardi,5,0.00115,71963,16.55509,434688
2582,Betula-L,5,0.00115,71968,16.55624,434688
2583,bhass1,5,0.00115,71973,16.55739,434688
2584,bill2cipher,5,0.00115,71978,16.55854,434688
2585,billg-splunk,5,0.00115,71983,16.55969,434688
2586,blame19,5,0.00115,71988,16.56084,434688
2587,blevz,5,0.00115,71993,16.56199,434688
2588,bmalynovytch,5,0.00115,71998,16.56314,434688
2589,bmsiegel,5,0.00115,72003,16.56429,434688
2590,Boes-man,5,0.00115,72008,16.56544,434688
2591,boniek83,5,0.00115,72013,16.56659,434688
2592,boogiefromzk,5,0.00115,72018,16.56775,434688
2593,bordenit,5,0.00115,72023,16.56890,434688
2594,brant4test,5,0.00115,72028,16.57005,434688
2595,Brice187,5,0.00115,72033,16.57120,434688
2596,briceruzand,5,0.00115,72038,16.57235,434688
2597,brucexyz1234,5,0.00115,72043,16.57350,434688
2598,brunoarueira,5,0.00115,72048,16.57465,434688
2599,BrunoCerberus,5,0.00115,72053,16.57580,434688
2600,brunokoeferli,5,0.00115,72058,16.57695,434688
2601,brzyangg,5,0.00115,72063,16.57810,434688
2602,BTDevelop,5,0.00115,72068,16.57925,434688
2603,btrieger,5,0.00115,72073,16.58040,434688
2604,burner-account,5,0.00115,72078,16.58155,434688
2605,bwhaley,5,0.00115,72083,16.58270,434688
2606,canberkkoc,5,0.00115,72088,16.58385,434688
2607,canthonyscott,5,0.00115,72093,16.58500,434688
2608,CaptainVincent,5,0.00115,72098,16.58615,434688
2609,carlanton,5,0.00115,72103,16.58730,434688
2610,carpe-github,5,0.00115,72108,16.58845,434688
2611,cboitel,5,0.00115,72113,16.58960,434688
2612,ccarpita,5,0.00115,72118,16.59075,434688
2613,cchxn258886,5,0.00115,72123,16.59190,434688
2614,Cerebus,5,0.00115,72128,16.59305,434688
2615,charles-horel,5,0.00115,72133,16.59420,434688
2616,chenlujjj,5,0.00115,72138,16.59535,434688
2617,chenqi0805,5,0.00115,72143,16.59650,434688
2618,chris13524,5,0.00115,72148,16.59765,434688
2619,chriscardillo,5,0.00115,72153,16.59880,434688
2620,ChrisCCheng,5,0.00115,72158,16.59995,434688
2621,Chwetion,5,0.00115,72163,16.60110,434688
2622,ciastooo,5,0.00115,72168,16.60225,434688
2623,ciuffoly,5,0.00115,72173,16.60340,434688
2624,cola-zero,5,0.00115,72178,16.60455,434688
2625,colearendt,5,0.00115,72183,16.60570,434688
2626,colin-sitehost,5,0.00115,72188,16.60685,434688
2627,connorclockwise,5,0.00115,72193,16.60800,434688
2628,courageJ,5,0.00115,72198,16.60915,434688
2629,cutecutecat,5,0.00115,72203,16.61030,434688
2630,CyberSec77,5,0.00115,72208,16.61145,434688
2631,daiwei233,5,0.00115,72213,16.61260,434688
2632,damonearp,5,0.00115,72218,16.61376,434688
2633,dandlake,5,0.00115,72223,16.61491,434688
2634,danielfoehrKn,5,0.00115,72228,16.61606,434688
2635,Daniel-Nashed,5,0.00115,72233,16.61721,434688
2636,dany74q,5,0.00115,72238,16.61836,434688
2637,darrenfurr,5,0.00115,72243,16.61951,434688
2638,datamattsson,5,0.00115,72248,16.62066,434688
2639,datcu,5,0.00115,72253,16.62181,434688
2640,david0,5,0.00115,72258,16.62296,434688
2641,daviddawson,5,0.00115,72263,16.62411,434688
2642,DavidSpek,5,0.00115,72268,16.62526,434688
2643,dbavery,5,0.00115,72273,16.62641,434688
2644,dbourget,5,0.00115,72278,16.62756,434688
2645,denisivan0v,5,0.00115,72283,16.62871,434688
2646,devlikai,5,0.00115,72288,16.62986,434688
2647,dfeldman,5,0.00115,72293,16.63101,434688
2648,dickiebowuk,5,0.00115,72298,16.63216,434688
2649,digambar15,5,0.00115,72303,16.63331,434688
2650,Diggsey,5,0.00115,72308,16.63446,434688
2651,DikshithAC,5,0.00115,72313,16.63561,434688
2652,dittakaviram,5,0.00115,72318,16.63676,434688
2653,divyagandhisethi,5,0.00115,72323,16.63791,434688
2654,divyanshuch1,5,0.00115,72328,16.63906,434688
2655,djmcgreal-cc,5,0.00115,72333,16.64021,434688
2656,dlminvestments,5,0.00115,72338,16.64136,434688
2657,dmduggan,5,0.00115,72343,16.64251,434688
2658,Doms61,5,0.00115,72348,16.64366,434688
2659,draco2003,5,0.00115,72353,16.64481,434688
2660,drtpotter,5,0.00115,72358,16.64596,434688
2661,duanhongyi,5,0.00115,72363,16.64711,434688
2662,dzwinning,5,0.00115,72368,16.64826,434688
2663,ecusnir,5,0.00115,72373,16.64941,434688
2664,ekosz,5,0.00115,72378,16.65056,434688
2665,emicklei,5,0.00115,72383,16.65171,434688
2666,emilchitas,5,0.00115,72388,16.65286,434688
2667,Endeavourken,5,0.00115,72393,16.65401,434688
2668,endejoli,5,0.00115,72398,16.65516,434688
2669,enori,5,0.00115,72403,16.65631,434688
2670,enys,5,0.00115,72408,16.65746,434688
2671,etamarw,5,0.00115,72413,16.65861,434688
2672,etiennejournet,5,0.00115,72418,16.65977,434688
2673,exoego,5,0.00115,72423,16.66092,434688
2674,fao89,5,0.00115,72428,16.66207,434688
2675,fbladilo,5,0.00115,72433,16.66322,434688
2676,feedmypixel,5,0.00115,72438,16.66437,434688
2677,fengxidi,5,0.00115,72443,16.66552,434688
2678,feuyeux,5,0.00115,72448,16.66667,434688
2679,fgiorgetti,5,0.00115,72453,16.66782,434688
2680,financefeast,5,0.00115,72458,16.66897,434688
2681,fmmr,5,0.00115,72463,16.67012,434688
2682,fourbytes,5,0.00115,72468,16.67127,434688
2683,francescsanjuanmrf,5,0.00115,72473,16.67242,434688
2684,frankui,5,0.00115,72478,16.67357,434688
2685,frenzymadness,5,0.00115,72483,16.67472,434688
2686,froblesmartin,5,0.00115,72488,16.67587,434688
2687,frommeyerc,5,0.00115,72493,16.67702,434688
2688,fsbaraglia,5,0.00115,72498,16.67817,434688
2689,fspaniol,5,0.00115,72503,16.67932,434688
2690,FStefanni,5,0.00115,72508,16.68047,434688
2691,furstenbergs,5,0.00115,72513,16.68162,434688
2692,gabhi,5,0.00115,72518,16.68277,434688
2693,gaetanww,5,0.00115,72523,16.68392,434688
2694,gaoran10,5,0.00115,72528,16.68507,434688
2695,gardnerdev,5,0.00115,72533,16.68622,434688
2696,gejunqiang,5,0.00115,72538,16.68737,434688
2697,georgehao,5,0.00115,72543,16.68852,434688
2698,GerkinDev,5,0.00115,72548,16.68967,434688
2699,ggardet,5,0.00115,72553,16.69082,434688
2700,giautm,5,0.00115,72558,16.69197,434688
2701,gitolicious,5,0.00115,72563,16.69312,434688
2702,goodgeorge,5,0.00115,72568,16.69427,434688
2703,GregorBiswanger,5,0.00115,72573,16.69542,434688
2704,grstein,5,0.00115,72578,16.69657,434688
2705,guhaneswaran,5,0.00115,72583,16.69772,434688
2706,gumshoe2020,5,0.00115,72588,16.69887,434688
2707,gvisco,5,0.00115,72593,16.70002,434688
2708,gyz2009,5,0.00115,72598,16.70117,434688
2709,haim-ari,5,0.00115,72603,16.70232,434688
2710,haljin,5,0.00115,72608,16.70347,434688
2711,hamidullov,5,0.00115,72613,16.70462,434688
2712,hampuslidin,5,0.00115,72618,16.70578,434688
2713,hanzhc,5,0.00115,72623,16.70693,434688
2714,haoheipi,5,0.00115,72628,16.70808,434688
2715,haoming-db,5,0.00115,72633,16.70923,434688
2716,harekal7,5,0.00115,72638,16.71038,434688
2717,haribabu-nagilli,5,0.00115,72643,16.71153,434688
2718,HariHaraReddyD,5,0.00115,72648,16.71268,434688
2719,harshaagrahara,5,0.00115,72653,16.71383,434688
2720,HashemTaheriSonos,5,0.00115,72658,16.71498,434688
2721,HassanAlsamahi,5,0.00115,72663,16.71613,434688
2722,hedrox,5,0.00115,72668,16.71728,434688
2723,HejVkt,5,0.00115,72673,16.71843,434688
2724,hellt,5,0.00115,72678,16.71958,434688
2725,HenryKamg,5,0.00115,72683,16.72073,434688
2726,Hiroki111,5,0.00115,72688,16.72188,434688
2727,hitzhangjie,5,0.00115,72693,16.72303,434688
2728,hoepfnerj,5,0.00115,72698,16.72418,434688
2729,hol430,5,0.00115,72703,16.72533,434688
2730,huayang-codaio,5,0.00115,72708,16.72648,434688
2731,huiwq1990,5,0.00115,72713,16.72763,434688
2732,hulucc,5,0.00115,72718,16.72878,434688
2733,iamnoah,5,0.00115,72723,16.72993,434688
2734,iamsdas,5,0.00115,72728,16.73108,434688
2735,ianadavies,5,0.00115,72733,16.73223,434688
2736,ibigbug,5,0.00115,72738,16.73338,434688
2737,ideepika,5,0.00115,72743,16.73453,434688
2738,IIvyPy,5,0.00115,72748,16.73568,434688
2739,iliyahoo,5,0.00115,72753,16.73683,434688
2740,imkos,5,0.00115,72758,16.73798,434688
2741,imneov,5,0.00115,72763,16.73913,434688
2742,imranrazakhan,5,0.00115,72768,16.74028,434688
2743,infa-ddeore,5,0.00115,72773,16.74143,434688
2744,innovationhub-asia,5,0.00115,72778,16.74258,434688
2745,ionir-cloud,5,0.00115,72783,16.74373,434688
2746,iTaybb,5,0.00115,72788,16.74488,434688
2747,ivanape,5,0.00115,72793,16.74603,434688
2748,izzyjere,5,0.00115,72798,16.74718,434688
2749,jack-evans,5,0.00115,72803,16.74833,434688
2750,jack-jarvis,5,0.00115,72808,16.74948,434688
2751,JAditya1395,5,0.00115,72813,16.75063,434688
2752,james-woods-mnf,5,0.00115,72818,16.75179,434688
2753,jamesylgan,5,0.00115,72823,16.75294,434688
2754,JamieDanielson,5,0.00115,72828,16.75409,434688
2755,jasondavindev,5,0.00115,72833,16.75524,434688
2756,jasoninmel,5,0.00115,72838,16.75639,434688
2757,jaz1414,5,0.00115,72843,16.75754,434688
2758,jboero,5,0.00115,72848,16.75869,434688
2759,JcdeA,5,0.00115,72853,16.75984,434688
2760,jceb,5,0.00115,72858,16.76099,434688
2761,jdomag,5,0.00115,72863,16.76214,434688
2762,jeffrosenberg,5,0.00115,72868,16.76329,434688
2763,Jemgoss,5,0.00115,72873,16.76444,434688
2764,jennydaman,5,0.00115,72878,16.76559,434688
2765,jerolimov,5,0.00115,72883,16.76674,434688
2766,jerome-ibanes,5,0.00115,72888,16.76789,434688
2767,jhondom,5,0.00115,72893,16.76904,434688
2768,jiapeish,5,0.00115,72898,16.77019,434688
2769,jijiechen,5,0.00115,72903,16.77134,434688
2770,jimtoniq,5,0.00115,72908,16.77249,434688
2771,Jiw0cha,5,0.00115,72913,16.77364,434688
2772,jiwonaid,5,0.00115,72918,16.77479,434688
2773,jjm,5,0.00115,72923,16.77594,434688
2774,jkornblum,5,0.00115,72928,16.77709,434688
2775,jld3103,5,0.00115,72933,16.77824,434688
2776,jleni,5,0.00115,72938,16.77939,434688
2777,jmaaks,5,0.00115,72943,16.78054,434688
2778,jmwurst,5,0.00115,72948,16.78169,434688
2779,jngbng,5,0.00115,72953,16.78284,434688
2780,joachimgoris,5,0.00115,72958,16.78399,434688
2781,joberdick-rcd,5,0.00115,72963,16.78514,434688
2782,joell,5,0.00115,72968,16.78629,434688
2783,johanhammar,5,0.00115,72973,16.78744,434688
2784,JohnNiang,5,0.00115,72978,16.78859,434688
2785,joke,5,0.00115,72983,16.78974,434688
2786,JosephWoodward,5,0.00115,72988,16.79089,434688
2787,jplimack,5,0.00115,72993,16.79204,434688
2788,Jramirezg,5,0.00115,72998,16.79319,434688
2789,jrivers96,5,0.00115,73003,16.79434,434688
2790,jtagcat,5,0.00115,73008,16.79549,434688
2791,juanvasquezreyes,5,0.00115,73013,16.79664,434688
2792,julienlau,5,0.00115,73018,16.79780,434688
2793,jurgeng-ot,5,0.00115,73023,16.79895,434688
2794,K4pt4n,5,0.00115,73028,16.80010,434688
2795,kahveci,5,0.00115,73033,16.80125,434688
2796,kaiso,5,0.00115,73038,16.80240,434688
2797,KanShiori,5,0.00115,73043,16.80355,434688
2798,kappa-wingman,5,0.00115,73048,16.80470,434688
2799,KaymeKaydex,5,0.00115,73053,16.80585,434688
2800,kcirone,5,0.00115,73058,16.80700,434688
2801,keithc-ca,5,0.00115,73063,16.80815,434688
2802,kevanslumin,5,0.00115,73068,16.80930,434688
2803,kevholmes,5,0.00115,73073,16.81045,434688
2804,kevinglasson,5,0.00115,73078,16.81160,434688
2805,kevin-lindsay-1,5,0.00115,73083,16.81275,434688
2806,keymone,5,0.00115,73088,16.81390,434688
2807,kish0620,5,0.00115,73093,16.81505,434688
2808,kiwinesian,5,0.00115,73098,16.81620,434688
2809,kjg,5,0.00115,73103,16.81735,434688
2810,kkaarreell,5,0.00115,73108,16.81850,434688
2811,KKulishov,5,0.00115,73113,16.81965,434688
2812,klaraab,5,0.00115,73118,16.82080,434688
2813,kloading,5,0.00115,73123,16.82195,434688
2814,knopt,5,0.00115,73128,16.82310,434688
2815,knurl,5,0.00115,73133,16.82425,434688
2816,knz,5,0.00115,73138,16.82540,434688
2817,koktlzz,5,0.00115,73143,16.82655,434688
2818,kolbe,5,0.00115,73148,16.82770,434688
2819,komal1503,5,0.00115,73153,16.82885,434688
2820,Kraego,5,0.00115,73158,16.83000,434688
2821,krazik-intuit,5,0.00115,73163,16.83115,434688
2822,krestofur,5,0.00115,73168,16.83230,434688
2823,krikke999,5,0.00115,73173,16.83345,434688
2824,krishnanarchana,5,0.00115,73178,16.83460,434688
2825,kristydv,5,0.00115,73183,16.83575,434688
2826,kselvamaniarkin,5,0.00115,73188,16.83690,434688
2827,kumarabd,5,0.00115,73193,16.83805,434688
2828,kyleprager,5,0.00115,73198,16.83920,434688
2829,kzzalews,5,0.00115,73203,16.84035,434688
2830,L30Bola,5,0.00115,73208,16.84150,434688
2831,lamw,5,0.00115,73213,16.84265,434688
2832,Laxmanpathare,5,0.00115,73218,16.84381,434688
2833,lcw2,5,0.00115,73223,16.84496,434688
2834,learn0208,5,0.00115,73228,16.84611,434688
2835,leeminseob,5,0.00115,73233,16.84726,434688
2836,LehMaxence,5,0.00115,73238,16.84841,434688
2837,Leonardo-Ferreira,5,0.00115,73243,16.84956,434688
2838,leonardpahlke,5,0.00115,73248,16.85071,434688
2839,leonsp-ai,5,0.00115,73253,16.85186,434688
2840,lilihongjava,5,0.00115,73258,16.85301,434688
2841,liljaylj,5,0.00115,73263,16.85416,434688
2842,LIL-Raps,5,0.00115,73268,16.85531,434688
2843,linlih,5,0.00115,73273,16.85646,434688
2844,LittleFox94,5,0.00115,73278,16.85761,434688
2845,littlegreyzhang,5,0.00115,73283,16.85876,434688
2846,loganmc10,5,0.00115,73288,16.85991,434688
2847,lo-jason,5,0.00115,73293,16.86106,434688
2848,Lovnx,5,0.00115,73298,16.86221,434688
2849,lsirac,5,0.00115,73303,16.86336,434688
2850,luankevinferreira,5,0.00115,73308,16.86451,434688
2851,LuBingtan,5,0.00115,73313,16.86566,434688
2852,lucastt,5,0.00115,73318,16.86681,434688
2853,lucky4ever2,5,0.00115,73323,16.86796,434688
2854,lucwillems,5,0.00115,73328,16.86911,434688
2855,lwangbm,5,0.00115,73333,16.87026,434688
2856,macabeus,5,0.00115,73338,16.87141,434688
2857,maciejaszek,5,0.00115,73343,16.87256,434688
2858,madelson,5,0.00115,73348,16.87371,434688
2859,maja5627,5,0.00115,73353,16.87486,434688
2860,majian159,5,0.00115,73358,16.87601,434688
2861,makmanalp,5,0.00115,73363,16.87716,434688
2862,makomatic,5,0.00115,73368,16.87831,434688
2863,MarcoR83,5,0.00115,73373,16.87946,434688
2864,marinoborges,5,0.00115,73378,16.88061,434688
2865,Marks-Ed,5,0.00115,73383,16.88176,434688
2866,matgn,5,0.00115,73388,16.88291,434688
2867,matklad,5,0.00115,73393,16.88406,434688
2868,matt-declarativecloud,5,0.00115,73398,16.88521,434688
2869,mattmetlis,5,0.00115,73403,16.88636,434688
2870,MaurGi,5,0.00115,73408,16.88751,434688
2871,maxisam,5,0.00115,73413,16.88866,434688
2872,mblauth,5,0.00115,73418,16.88982,434688
2873,mchudinov,5,0.00115,73423,16.89097,434688
2874,MederD,5,0.00115,73428,16.89212,434688
2875,Meghavenkatesh,5,0.00115,73433,16.89327,434688
2876,meysam81,5,0.00115,73438,16.89442,434688
2877,mfridman,5,0.00115,73443,16.89557,434688
2878,MGulerce,5,0.00115,73448,16.89672,434688
2879,mhoffm-aiven,5,0.00115,73453,16.89787,434688
2880,michael132,5,0.00115,73458,16.89902,434688
2881,michaelhyatt,5,0.00115,73463,16.90017,434688
2882,michaelhzh,5,0.00115,73468,16.90132,434688
2883,mikebell90,5,0.00115,73473,16.90247,434688
2884,MikeGoltsov,5,0.00115,73478,16.90362,434688
2885,mikeinton,5,0.00115,73483,16.90477,434688
2886,miro-grapeup,5,0.00115,73488,16.90592,434688
2887,MittWillson,5,0.00115,73493,16.90707,434688
2888,mkkatica,5,0.00115,73498,16.90822,434688
2889,ml-,5,0.00115,73503,16.90937,434688
2890,mluds,5,0.00115,73508,16.91052,434688
2891,mmat11,5,0.00115,73513,16.91167,434688
2892,monalisha31,5,0.00115,73518,16.91282,434688
2893,morremeyer,5,0.00115,73523,16.91397,434688
2894,Mossaka,5,0.00115,73528,16.91512,434688
2895,mozz-lx,5,0.00115,73533,16.91627,434688
2896,MrMic,5,0.00115,73538,16.91742,434688
2897,musaprg,5,0.00115,73543,16.91857,434688
2898,muyu-dev,5,0.00115,73548,16.91972,434688
2899,MuZhou233,5,0.00115,73553,16.92087,434688
2900,mwdb,5,0.00115,73558,16.92202,434688
2901,myg0v,5,0.00115,73563,16.92317,434688
2902,nakumgaurav,5,0.00115,73568,16.92432,434688
2903,NanPaiUncle3,5,0.00115,73573,16.92547,434688
2904,Napsty,5,0.00115,73578,16.92662,434688
2905,natalefalco,5,0.00115,73583,16.92777,434688
2906,natdop,5,0.00115,73588,16.92892,434688
2907,natw,5,0.00115,73593,16.93007,434688
2908,nbertram,5,0.00115,73598,16.93122,434688
2909,nedvna,5,0.00115,73603,16.93237,434688
2910,Nekitosss,5,0.00115,73608,16.93352,434688
2911,netpoetica,5,0.00115,73613,16.93467,434688
2912,Nicklason,5,0.00115,73618,16.93583,434688
2913,nicksieger,5,0.00115,73623,16.93698,434688
2914,nicoche,5,0.00115,73628,16.93813,434688
2915,nikitsenka,5,0.00115,73633,16.93928,434688
2916,nikore,5,0.00115,73638,16.94043,434688
2917,niorko,5,0.00115,73643,16.94158,434688
2918,nixon89,5,0.00115,73648,16.94273,434688
2919,nkavian,5,0.00115,73653,16.94388,434688
2920,nkostoulas,5,0.00115,73658,16.94503,434688
2921,nous23,5,0.00115,73663,16.94618,434688
2922,ns-jisorce,5,0.00115,73668,16.94733,434688
2923,nudles,5,0.00115,73673,16.94848,434688
2924,nuguni,5,0.00115,73678,16.94963,434688
2925,oeotvos,5,0.00115,73683,16.95078,434688
2926,ogarcia,5,0.00115,73688,16.95193,434688
2927,olfway,5,0.00115,73693,16.95308,434688
2928,olifly,5,0.00115,73698,16.95423,434688
2929,onikolskyy,5,0.00115,73703,16.95538,434688
2930,PabloG6,5,0.00115,73708,16.95653,434688
2931,panteparak,5,0.00115,73713,16.95768,434688
2932,papalma,5,0.00115,73718,16.95883,434688
2933,pasimoes,5,0.00115,73723,16.95998,434688
2934,patchon,5,0.00115,73728,16.96113,434688
2935,pawankumar94,5,0.00115,73733,16.96228,434688
2936,pbxqdown,5,0.00115,73738,16.96343,434688
2937,pclata,5,0.00115,73743,16.96458,434688
2938,pedro-gutierrez,5,0.00115,73748,16.96573,434688
2939,petedmarsh,5,0.00115,73753,16.96688,434688
2940,peteingithub,5,0.00115,73758,16.96803,434688
2941,pfeigl,5,0.00115,73763,16.96918,434688
2942,pgoyal01,5,0.00115,73768,16.97033,434688
2943,phbits,5,0.00115,73773,16.97148,434688
2944,philipsu522,5,0.00115,73778,16.97263,434688
2945,piffall,5,0.00115,73783,16.97378,434688
2946,pigbrain,5,0.00115,73788,16.97493,434688
2947,Pigi-102,5,0.00115,73793,16.97608,434688
2948,pivotal-david-osullivan,5,0.00115,73798,16.97723,434688
2949,pradeep-hegde,5,0.00115,73803,16.97838,434688
2950,Pradumnasaraf,5,0.00115,73808,16.97953,434688
2951,Prashanth684,5,0.00115,73813,16.98068,434688
2952,pratikbalar,5,0.00115,73818,16.98184,434688
2953,Preisschild,5,0.00115,73823,16.98299,434688
2954,previousdeveloper,5,0.00115,73828,16.98414,434688
2955,primeroz,5,0.00115,73833,16.98529,434688
2956,psemeniuk,5,0.00115,73838,16.98644,434688
2957,punkmonday,5,0.00115,73843,16.98759,434688
2958,putianhui,5,0.00115,73848,16.98874,434688
2959,qqeasonchen,5,0.00115,73853,16.98989,434688
2960,queenns,5,0.00115,73858,16.99104,434688
2961,rafacouto,5,0.00115,73863,16.99219,434688
2962,RafaelMoreira1180778,5,0.00115,73868,16.99334,434688
2963,Ragatzino,5,0.00115,73873,16.99449,434688
2964,ragunathan23,5,0.00115,73878,16.99564,434688
2965,rahulanand16nov,5,0.00115,73883,16.99679,434688
2966,rajibul007,5,0.00115,73888,16.99794,434688
2967,Ramireddyashok,5,0.00115,73893,16.99909,434688
2968,ramosbugs,5,0.00115,73898,17.00024,434688
2969,rbboulton,5,0.00115,73903,17.00139,434688
2970,rbrtmrtn,5,0.00115,73908,17.00254,434688
2971,rdavyd,5,0.00115,73913,17.00369,434688
2972,redblade,5,0.00115,73918,17.00484,434688
2973,rene-dekker,5,0.00115,73923,17.00599,434688
2974,rgulden,5,0.00115,73928,17.00714,434688
2975,RichieAHB,5,0.00115,73933,17.00829,434688
2976,riita10069,5,0.00115,73938,17.00944,434688
2977,riyasyash,5,0.00115,73943,17.01059,434688
2978,rjferguson21,5,0.00115,73948,17.01174,434688
2979,rmarchei,5,0.00115,73953,17.01289,434688
2980,rmeloca,5,0.00115,73958,17.01404,434688
2981,rnsc,5,0.00115,73963,17.01519,434688
2982,rnwhitehead,5,0.00115,73968,17.01634,434688
2983,RoadRunnr,5,0.00115,73973,17.01749,434688
2984,rob-elschot,5,0.00115,73978,17.01864,434688
2985,Robert-Christensen-visa,5,0.00115,73983,17.01979,434688
2986,robinp-tw,5,0.00115,73988,17.02094,434688
2987,rogeeff,5,0.00115,73993,17.02209,434688
2988,roger21gm,5,0.00115,73998,17.02324,434688
2989,ronaldmiranda,5,0.00115,74003,17.02439,434688
2990,ronilichtman,5,0.00115,74008,17.02554,434688
2991,Ronyk1,5,0.00115,74013,17.02670,434688
2992,ROOKIE20570,5,0.00115,74018,17.02785,434688
2993,rrupapara,5,0.00115,74023,17.02900,434688
2994,rsevilla87,5,0.00115,74028,17.03015,434688
2995,rsumukha,5,0.00115,74033,17.03130,434688
2996,ruijzhan,5,0.00115,74038,17.03245,434688
2997,ruilapa,5,0.00115,74043,17.03360,434688
2998,rvadim,5,0.00115,74048,17.03475,434688
2999,rwkarg,5,0.00115,74053,17.03590,434688
3000,SabySen,5,0.00115,74058,17.03705,434688
3001,sadashivjp,5,0.00115,74063,17.03820,434688
3002,sam-mcbr,5,0.00115,74068,17.03935,434688
3003,SammyA,5,0.00115,74073,17.04050,434688
3004,sam-robson,5,0.00115,74078,17.04165,434688
3005,samstride,5,0.00115,74083,17.04280,434688
3006,samuel-form3,5,0.00115,74088,17.04395,434688
3007,SanjaySinghRajpoot,5,0.00115,74093,17.04510,434688
3008,san-ouadghiri,5,0.00115,74098,17.04625,434688
3009,SantiMunoz,5,0.00115,74103,17.04740,434688
3010,saryeHaddadi,5,0.00115,74108,17.04855,434688
3011,sbalajisivaram,5,0.00115,74113,17.04970,434688
3012,schellj,5,0.00115,74118,17.05085,434688
3013,schneiderdotme,5,0.00115,74123,17.05200,434688
3014,seansabour,5,0.00115,74128,17.05315,434688
3015,seed-248,5,0.00115,74133,17.05430,434688
3016,sergiopsyalo,5,0.00115,74138,17.05545,434688
3017,serialoverflow,5,0.00115,74143,17.05660,434688
3018,servo1x,5,0.00115,74148,17.05775,434688
3019,sgavrylenko,5,0.00115,74153,17.05890,434688
3020,shabiel,5,0.00115,74158,17.06005,434688
3021,shahamit,5,0.00115,74163,17.06120,434688
3022,shalin-hudda,5,0.00115,74168,17.06235,434688
3023,shanmukha511,5,0.00115,74173,17.06350,434688
3024,shardulsrivastava,5,0.00115,74178,17.06465,434688
3025,sherman-grewal,5,0.00115,74183,17.06580,434688
3026,shivay-fabric,5,0.00115,74188,17.06695,434688
3027,shoekstra,5,0.00115,74193,17.06810,434688
3028,shuknk8s,5,0.00115,74198,17.06925,434688
3029,Siebjee,5,0.00115,74203,17.07040,434688
3030,signaleleven,5,0.00115,74208,17.07155,434688
3031,simanw,5,0.00115,74213,17.07271,434688
3032,simonstamm,5,0.00115,74218,17.07386,434688
3033,simonvanbernem,5,0.00115,74223,17.07501,434688
3034,SirishaGopigiri,5,0.00115,74228,17.07616,434688
3035,sixeIa,5,0.00115,74233,17.07731,434688
3036,skadefro,5,0.00115,74238,17.07846,434688
3037,slaysd,5,0.00115,74243,17.07961,434688
3038,Spiroman,5,0.00115,74248,17.08076,434688
3039,SpringMT,5,0.00115,74253,17.08191,434688
3040,sqqqrly,5,0.00115,74258,17.08306,434688
3041,squaricdot,5,0.00115,74263,17.08421,434688
3042,sshiba,5,0.00115,74268,17.08536,434688
3043,s-shirayama,5,0.00115,74273,17.08651,434688
3044,sshota0809,5,0.00115,74278,17.08766,434688
3045,ssurovich,5,0.00115,74283,17.08881,434688
3046,startxfr,5,0.00115,74288,17.08996,434688
3047,Static-Flow,5,0.00115,74293,17.09111,434688
3048,StepanKuksenko,5,0.00115,74298,17.09226,434688
3049,stephaniehingtgen,5,0.00115,74303,17.09341,434688
3050,stevenbressey,5,0.00115,74308,17.09456,434688
3051,StevenDewey,5,0.00115,74313,17.09571,434688
3052,stevesea,5,0.00115,74318,17.09686,434688
3053,stoneshi-yunify,5,0.00115,74323,17.09801,434688
3054,storyicon,5,0.00115,74328,17.09916,434688
3055,strideynet,5,0.00115,74333,17.10031,434688
3056,stuartpreston,5,0.00115,74338,17.10146,434688
3057,sudhxnva,5,0.00115,74343,17.10261,434688
3058,suhasark,5,0.00115,74348,17.10376,434688
3059,sujithra-p,5,0.00115,74353,17.10491,434688
3060,SunilDSK,5,0.00115,74358,17.10606,434688
3061,sunpa93,5,0.00115,74363,17.10721,434688
3062,superherointj,5,0.00115,74368,17.10836,434688
3063,svanschie,5,0.00115,74373,17.10951,434688
3064,takuhiro,5,0.00115,74378,17.11066,434688
3065,tavlima,5,0.00115,74383,17.11181,434688
3066,TaylorHere,5,0.00115,74388,17.11296,434688
3067,tcsmith,5,0.00115,74393,17.11411,434688
3068,tculp,5,0.00115,74398,17.11526,434688
3069,tdensmore,5,0.00115,74403,17.11641,434688
3070,tdyas,5,0.00115,74408,17.11756,434688
3071,TechnicalMercenary,5,0.00115,74413,17.11872,434688
3072,techpavan,5,0.00115,74418,17.11987,434688
3073,tee05S,5,0.00115,74423,17.12102,434688
3074,teoyaomiqui,5,0.00115,74428,17.12217,434688
3075,th-2021,5,0.00115,74433,17.12332,434688
3076,thiagosantosleite,5,0.00115,74438,17.12447,434688
3077,thomascjohnson,5,0.00115,74443,17.12562,434688
3078,tidunguyen,5,0.00115,74448,17.12677,434688
3079,tim-mwangi,5,0.00115,74453,17.12792,434688
3080,timofey-barmin,5,0.00115,74458,17.12907,434688
3081,Tincoboekestijn,5,0.00115,74463,17.13022,434688
3082,T-J-L,5,0.00115,74468,17.13137,434688
3083,tobiasfriden,5,0.00115,74473,17.13252,434688
3084,toddmgreer,5,0.00115,74478,17.13367,434688
3085,tomhjp,5,0.00115,74483,17.13482,434688
3086,TomKeyte,5,0.00115,74488,17.13597,434688
3087,tommie,5,0.00115,74493,17.13712,434688
3088,toshipp,5,0.00115,74498,17.13827,434688
3089,tseeling,5,0.00115,74503,17.13942,434688
3090,tsurankov,5,0.00115,74508,17.14057,434688
3091,und3f,5,0.00115,74513,17.14172,434688
3092,urton,5,0.00115,74518,17.14287,434688
3093,vadymrybak,5,0.00115,74523,17.14402,434688
3094,valorl,5,0.00115,74528,17.14517,434688
3095,vanmash,5,0.00115,74533,17.14632,434688
3096,VA-PLE,5,0.00115,74538,17.14747,434688
3097,vegazmaoning,5,0.00115,74543,17.14862,434688
3098,Velociraptor85,5,0.00115,74548,17.14977,434688
3099,velothump,5,0.00115,74553,17.15092,434688
3100,vibhorrawat,5,0.00115,74558,17.15207,434688
3101,VictorCallejas,5,0.00115,74563,17.15322,434688
3102,vishal662,5,0.00115,74568,17.15437,434688
3103,vivekskrishna,5,0.00115,74573,17.15552,434688
3104,vooon,5,0.00115,74578,17.15667,434688
3105,vulndev,5,0.00115,74583,17.15782,434688
3106,WeihanLi,5,0.00115,74588,17.15897,434688
3107,wesleyw72,5,0.00115,74593,17.16012,434688
3108,williammck,5,0.00115,74598,17.16127,434688
3109,William-Mou,5,0.00115,74603,17.16242,434688
3110,wilstoff,5,0.00115,74608,17.16357,434688
3111,Windfarer,5,0.00115,74613,17.16473,434688
3112,wjuan-AFK,5,0.00115,74618,17.16588,434688
3113,wtcampos,5,0.00115,74623,17.16703,434688
3114,wuhuizuo,5,0.00115,74628,17.16818,434688
3115,wyoshmx,5,0.00115,74633,17.16933,434688
3116,xeathen,5,0.00115,74638,17.17048,434688
3117,xuanzhong,5,0.00115,74643,17.17163,434688
3118,xxchan,5,0.00115,74648,17.17278,434688
3119,XzBuleSky,5,0.00115,74653,17.17393,434688
3120,yelhouti,5,0.00115,74658,17.17508,434688
3121,yeus,5,0.00115,74663,17.17623,434688
3122,yhrn,5,0.00115,74668,17.17738,434688
3123,yokomotod,5,0.00115,74673,17.17853,434688
3124,yolossn,5,0.00115,74678,17.17968,434688
3125,yordanovagabriela,5,0.00115,74683,17.18083,434688
3126,YoungjuWang,5,0.00115,74688,17.18198,434688
3127,ytianxia6,5,0.00115,74693,17.18313,434688
3128,yuqiuw,5,0.00115,74698,17.18428,434688
3129,zeaone,5,0.00115,74703,17.18543,434688
3130,zegerius,5,0.00115,74708,17.18658,434688
3131,zekth,5,0.00115,74713,17.18773,434688
3132,zengqingwei,5,0.00115,74718,17.18888,434688
3133,zhanglei1949,5,0.00115,74723,17.19003,434688
3134,ZhangShuaiyi,5,0.00115,74728,17.19118,434688
3135,zhongwenqin,5,0.00115,74733,17.19233,434688
3136,zhuangjinjin,5,0.00115,74738,17.19348,434688
3137,zhxjdwh,5,0.00115,74743,17.19463,434688
3138,zohiba,5,0.00115,74748,17.19578,434688
3139,zq-david-wang,5,0.00115,74753,17.19693,434688
3140,zquintana,5,0.00115,74758,17.19808,434688
3141,zrochler,5,0.00115,74763,17.19923,434688
3142,zxh326,5,0.00115,74768,17.20038,434688
3143,zyitingftnt,5,0.00115,74773,17.20153,434688
3144,0xff-dev,4,0.00092,74777,17.20245,434688
3145,1121437613,4,0.00092,74781,17.20337,434688
3146,123vivekr,4,0.00092,74785,17.20429,434688
3147,253asap,4,0.00092,74789,17.20521,434688
3148,3Xpl0it3r,4,0.00092,74793,17.20613,434688
3149,4integration,4,0.00092,74797,17.20705,434688
3150,4ndr4s,4,0.00092,74801,17.20797,434688
3151,5had3z,4,0.00092,74805,17.20889,434688
3152,992441831,4,0.00092,74809,17.20981,434688
3153,a732264856,4,0.00092,74813,17.21074,434688
3154,aaronnickovich,4,0.00092,74817,17.21166,434688
3155,aayusranjan,4,0.00092,74821,17.21258,434688
3156,ab250597,4,0.00092,74825,17.21350,434688
3157,abhi-bhatra,4,0.00092,74829,17.21442,434688
3158,abhinavmpandey08,4,0.00092,74833,17.21534,434688
3159,Abhishek357,4,0.00092,74837,17.21626,434688
3160,abhishek-jnpr,4,0.00092,74841,17.21718,434688
3161,abhisheksinghbaghel,4,0.00092,74845,17.21810,434688
3162,abikouo,4,0.00092,74849,17.21902,434688
3163,AcidAngel21,4,0.00092,74853,17.21994,434688
3164,adalziso,4,0.00092,74857,17.22086,434688
3165,adetalhouet,4,0.00092,74861,17.22178,434688
3166,aditi1230mhjn,4,0.00092,74865,17.22270,434688
3167,ad-m,4,0.00092,74869,17.22362,434688
3168,ahalay,4,0.00092,74873,17.22454,434688
3169,ahedderich,4,0.00092,74877,17.22546,434688
3170,ahlae,4,0.00092,74881,17.22638,434688
3171,ahmedalnuaimi,4,0.00092,74885,17.22730,434688
3172,ahysing,4,0.00092,74889,17.22822,434688
3173,aibarbetta,4,0.00092,74893,17.22914,434688
3174,Ajith1005604,4,0.00092,74897,17.23006,434688
3175,ajitksingh1,4,0.00092,74901,17.23098,434688
3176,akhila1012,4,0.00092,74905,17.23190,434688
3177,akunszt,4,0.00092,74909,17.23282,434688
3178,akverma10,4,0.00092,74913,17.23374,434688
3179,AlbertoPellitteri,4,0.00092,74917,17.23466,434688
3180,aldenjenkins,4,0.00092,74921,17.23558,434688
3181,aldlfkahs,4,0.00092,74925,17.23650,434688
3182,aleclerc-sonrai,4,0.00092,74929,17.23742,434688
3183,Alexcei88,4,0.00092,74933,17.23834,434688
3184,alexis-wefight,4,0.00092,74937,17.23926,434688
3185,Alex-null,4,0.00092,74941,17.24018,434688
3186,AlexZhenWang,4,0.00092,74945,17.24110,434688
3187,aliyueshuo,4,0.00092,74949,17.24202,434688
3188,alwaysdaylast,4,0.00092,74953,17.24294,434688
3189,am250360,4,0.00092,74957,17.24386,434688
3190,amccague,4,0.00092,74961,17.24478,434688
3191,amej,4,0.00092,74965,17.24570,434688
3192,amirensit,4,0.00092,74969,17.24662,434688
3193,ampc,4,0.00092,74973,17.24754,434688
3194,andreabenfatto,4,0.00092,74977,17.24846,434688
3195,andreassteiner97,4,0.00092,74981,17.24938,434688
3196,AndreasStoner,4,0.00092,74985,17.25030,434688
3197,andrejbranch,4,0.00092,74989,17.25122,434688
3198,andreuxxxx,4,0.00092,74993,17.25214,434688
3199,andreybokhanko,4,0.00092,74997,17.25306,434688
3200,AndreZiviani,4,0.00092,75001,17.25398,434688
3201,andriy-fd,4,0.00092,75005,17.25490,434688
3202,anetanel,4,0.00092,75009,17.25582,434688
3203,angelinelee22,4,0.00092,75013,17.25675,434688
3204,ankel,4,0.00092,75017,17.25767,434688
3205,Ankit-Laddha,4,0.00092,75021,17.25859,434688
3206,anoopwebs,4,0.00092,75025,17.25951,434688
3207,Antonito,4,0.00092,75029,17.26043,434688
3208,anunpn,4,0.00092,75033,17.26135,434688
3209,anupdhamale,4,0.00092,75037,17.26227,434688
3210,aperullo,4,0.00092,75041,17.26319,434688
3211,apinter,4,0.00092,75045,17.26411,434688
3212,apratina,4,0.00092,75049,17.26503,434688
3213,aravindparappil46,4,0.00092,75053,17.26595,434688
3214,archana-maharjan,4,0.00092,75057,17.26687,434688
3215,arempter,4,0.00092,75061,17.26779,434688
3216,Aritrika1234,4,0.00092,75065,17.26871,434688
3217,arm-chair,4,0.00092,75069,17.26963,434688
3218,arpantw,4,0.00092,75073,17.27055,434688
3219,arsley,4,0.00092,75077,17.27147,434688
3220,arugal,4,0.00092,75081,17.27239,434688
3221,arvyshka,4,0.00092,75085,17.27331,434688
3222,ashishgoyal111,4,0.00092,75089,17.27423,434688
3223,ash-man,4,0.00092,75093,17.27515,434688
3224,ashok4244,4,0.00092,75097,17.27607,434688
3225,AtlanCI,4,0.00092,75101,17.27699,434688
3226,atze234,4,0.00092,75105,17.27791,434688
3227,austinsasko,4,0.00092,75109,17.27883,434688
3228,avanderveen,4,0.00092,75113,17.27975,434688
3229,aw185176,4,0.00092,75117,17.28067,434688
3230,AwateAkshay,4,0.00092,75121,17.28159,434688
3231,awcheney,4,0.00092,75125,17.28251,434688
3232,awoods12,4,0.00092,75129,17.28343,434688
3233,axlrosen,4,0.00092,75133,17.28435,434688
3234,aysabzevar,4,0.00092,75137,17.28527,434688
3235,b4nst,4,0.00092,75141,17.28619,434688
3236,baokiemanh,4,0.00092,75145,17.28711,434688
3237,baryluk,4,0.00092,75149,17.28803,434688
3238,BayanAzima,4,0.00092,75153,17.28895,434688
3239,bburky,4,0.00092,75157,17.28987,434688
3240,bcollard,4,0.00092,75161,17.29079,434688
3241,BegoniaGit,4,0.00092,75165,17.29171,434688
3242,bellkev,4,0.00092,75169,17.29263,434688
3243,BenAsaf,4,0.00092,75173,17.29355,434688
3244,benbhall,4,0.00092,75177,17.29447,434688
3245,benjaminhuanghuang,4,0.00092,75181,17.29539,434688
3246,benjmac,4,0.00092,75185,17.29631,434688
3247,bestmike007,4,0.00092,75189,17.29723,434688
3248,bgolding355,4,0.00092,75193,17.29815,434688
3249,bharat15-ml,4,0.00092,75197,17.29907,434688
3250,bhuang-rms,4,0.00092,75201,17.29999,434688
3251,biancoda,4,0.00092,75205,17.30091,434688
3252,Bigsmooth68,4,0.00092,75209,17.30183,434688
3253,bjoernmayer,4,0.00092,75213,17.30276,434688
3254,bkh751,4,0.00092,75217,17.30368,434688
3255,bk-one,4,0.00092,75221,17.30460,434688
3256,blakjak44,4,0.00092,75225,17.30552,434688
3257,Blesmol,4,0.00092,75229,17.30644,434688
3258,bmcentos,4,0.00092,75233,17.30736,434688
3259,bob-gray,4,0.00092,75237,17.30828,434688
3260,brian-pickens,4,0.00092,75241,17.30920,434688
3261,bszeti,4,0.00092,75245,17.31012,434688
3262,btdan,4,0.00092,75249,17.31104,434688
3263,bulexu,4,0.00092,75253,17.31196,434688
3264,buptliuwei,4,0.00092,75257,17.31288,434688
3265,Busch,4,0.00092,75261,17.31380,434688
3266,C1ph3R-s,4,0.00092,75265,17.31472,434688
3267,cabadam,4,0.00092,75269,17.31564,434688
3268,callum-p,4,0.00092,75273,17.31656,434688
3269,CalvinNeo,4,0.00092,75277,17.31748,434688
3270,calvinShan,4,0.00092,75281,17.31840,434688
3271,Carles-Figuerola,4,0.00092,75285,17.31932,434688
3272,Caskia,4,0.00092,75289,17.32024,434688
3273,CatalinMustata,4,0.00092,75293,17.32116,434688
3274,catsem,4,0.00092,75297,17.32208,434688
3275,cawezh,4,0.00092,75301,17.32300,434688
3276,cc83851,4,0.00092,75305,17.32392,434688
3277,ccom-dev-platform,4,0.00092,75309,17.32484,434688
3278,ccremer,4,0.00092,75313,17.32576,434688
3279,cdz99,4,0.00092,75317,17.32668,434688
3280,cfanbo,4,0.00092,75321,17.32760,434688
3281,chandankumar-kr,4,0.00092,75325,17.32852,434688
3282,ChAnYaNG97,4,0.00092,75329,17.32944,434688
3283,cheeming,4,0.00092,75333,17.33036,434688
3284,chengaofeng,4,0.00092,75337,17.33128,434688
3285,Chetan7272,4,0.00092,75341,17.33220,434688
3286,ChiangYintso,4,0.00092,75345,17.33312,434688
3287,chijinxina,4,0.00092,75349,17.33404,434688
3288,chikinchoi,4,0.00092,75353,17.33496,434688
3289,ChrisJBurns,4,0.00092,75357,17.33588,434688
3290,chrisjohnson00,4,0.00092,75361,17.33680,434688
3291,christarazi,4,0.00092,75365,17.33772,434688
3292,christian-schwarzbauer,4,0.00092,75369,17.33864,434688
3293,ChrisWhealy,4,0.00092,75373,17.33956,434688
3294,chtiouiha,4,0.00092,75377,17.34048,434688
3295,chunliu,4,0.00092,75381,17.34140,434688
3296,chunywan,4,0.00092,75385,17.34232,434688
3297,ciiiii,4,0.00092,75389,17.34324,434688
3298,ckittel,4,0.00092,75393,17.34416,434688
3299,CloudWoR,4,0.00092,75397,17.34508,434688
3300,clp01,4,0.00092,75401,17.34600,434688
3301,ClSlaid,4,0.00092,75405,17.34692,434688
3302,cnivolle,4,0.00092,75409,17.34784,434688
3303,cobolbaby,4,0.00092,75413,17.34877,434688
3304,code-reaper08,4,0.00092,75417,17.34969,434688
3305,colussim,4,0.00092,75421,17.35061,434688
3306,cparadal,4,0.00092,75425,17.35153,434688
3307,cradules,4,0.00092,75429,17.35245,434688
3308,CraneShiEMC,4,0.00092,75433,17.35337,434688
3309,criscola,4,0.00092,75437,17.35429,434688
3310,csainty,4,0.00092,75441,17.35521,434688
3311,csurfleet,4,0.00092,75445,17.35613,434688
3312,cuttingedge1109,4,0.00092,75449,17.35705,434688
3313,cyrus-mc,4,0.00092,75453,17.35797,434688
3314,dagda1,4,0.00092,75457,17.35889,434688
3315,damdo,4,0.00092,75461,17.35981,434688
3316,damienleger,4,0.00092,75465,17.36073,434688
3317,danielhoherd,4,0.00092,75469,17.36165,434688
3318,daniv-msft,4,0.00092,75473,17.36257,434688
3319,danslimmon,4,0.00092,75477,17.36349,434688
3320,dare-darryl,4,0.00092,75481,17.36441,434688
3321,darionyaphet,4,0.00092,75485,17.36533,434688
3322,darman96,4,0.00092,75489,17.36625,434688
3323,DarthBenro008,4,0.00092,75493,17.36717,434688
3324,data-dude,4,0.00092,75497,17.36809,434688
3325,daviddetorres,4,0.00092,75501,17.36901,434688
3326,dberardo-com,4,0.00092,75505,17.36993,434688
3327,dblate,4,0.00092,75509,17.37085,434688
3328,dclipca,4,0.00092,75513,17.37177,434688
3329,ddevaal,4,0.00092,75517,17.37269,434688
3330,dectl,4,0.00092,75521,17.37361,434688
3331,deepak-gc,4,0.00092,75525,17.37453,434688
3332,deining,4,0.00092,75529,17.37545,434688
3333,denzhel,4,0.00092,75533,17.37637,434688
3334,DerFels,4,0.00092,75537,17.37729,434688
3335,DevOpserzhao,4,0.00092,75541,17.37821,434688
3336,Devops-Ramdas,4,0.00092,75545,17.37913,434688
3337,dev-samples,4,0.00092,75549,17.38005,434688
3338,Devway21,4,0.00092,75553,17.38097,434688
3339,dgaedcke,4,0.00092,75557,17.38189,434688
3340,dgarciarubio,4,0.00092,75561,17.38281,434688
3341,diannahu,4,0.00092,75565,17.38373,434688
3342,diepgiahung,4,0.00092,75569,17.38465,434688
3343,dingbusan,4,0.00092,75573,17.38557,434688
3344,dingyiyi0226,4,0.00092,75577,17.38649,434688
3345,disparo13,4,0.00092,75581,17.38741,434688
3346,dlouks,4,0.00092,75585,17.38833,434688
3347,dluyer,4,0.00092,75589,17.38925,434688
3348,dlwhitehurst,4,0.00092,75593,17.39017,434688
3349,dmitrika,4,0.00092,75597,17.39109,434688
3350,dmpe,4,0.00092,75601,17.39201,434688
3351,dnutels,4,0.00092,75605,17.39293,434688
3352,domechn,4,0.00092,75609,17.39385,434688
3353,dornimaug,4,0.00092,75613,17.39478,434688
3354,Dorsosiv,4,0.00092,75617,17.39570,434688
3355,dpcollins-google,4,0.00092,75621,17.39662,434688
3356,dquagebeur,4,0.00092,75625,17.39754,434688
3357,drazul,4,0.00092,75629,17.39846,434688
3358,drinks5,4,0.00092,75633,17.39938,434688
3359,drodriguezIE,4,0.00092,75637,17.40030,434688
3360,dulek,4,0.00092,75641,17.40122,434688
3361,duyleekun,4,0.00092,75645,17.40214,434688
3362,duyngle,4,0.00092,75649,17.40306,434688
3363,dvidx,4,0.00092,75653,17.40398,434688
3364,Dviejopomata,4,0.00092,75657,17.40490,434688
3365,echernous,4,0.00092,75661,17.40582,434688
3366,edinardo,4,0.00092,75665,17.40674,434688
3367,edpaget,4,0.00092,75669,17.40766,434688
3368,eelkonio,4,0.00092,75673,17.40858,434688
3369,efortin,4,0.00092,75677,17.40950,434688
3370,egoisz,4,0.00092,75681,17.41042,434688
3371,EGuesnet,4,0.00092,75685,17.41134,434688
3372,ejf-coders51,4,0.00092,75689,17.41226,434688
3373,elad-codefresh,4,0.00092,75693,17.41318,434688
3374,elFarto,4,0.00092,75697,17.41410,434688
3375,eliecer2323,4,0.00092,75701,17.41502,434688
3376,elrob,4,0.00092,75705,17.41594,434688
3377,Elyytscha,4,0.00092,75709,17.41686,434688
3378,elyzov,4,0.00092,75713,17.41778,434688
3379,emike922,4,0.00092,75717,17.41870,434688
3380,emilvberglind,4,0.00092,75721,17.41962,434688
3381,emschwartz,4,0.00092,75725,17.42054,434688
3382,erancx,4,0.00092,75729,17.42146,434688
3383,ercindemir,4,0.00092,75733,17.42238,434688
3384,ericmillin,4,0.00092,75737,17.42330,434688
3385,erikjoh,4,0.00092,75741,17.42422,434688
3386,erkerb4,4,0.00092,75745,17.42514,434688
3387,erpel,4,0.00092,75749,17.42606,434688
3388,etep,4,0.00092,75753,17.42698,434688
3389,eudaimos,4,0.00092,75757,17.42790,434688
3390,EvgenyPrikhodko,4,0.00092,75761,17.42882,434688
3391,fabltd,4,0.00092,75765,17.42974,434688
3392,faizanf47,4,0.00092,75769,17.43066,434688
3393,fajtgyo,4,0.00092,75773,17.43158,434688
3394,fanchy1025,4,0.00092,75777,17.43250,434688
3395,farhat67,4,0.00092,75781,17.43342,434688
3396,farookhus,4,0.00092,75785,17.43434,434688
3397,faseitl,4,0.00092,75789,17.43526,434688
3398,FatalLin,4,0.00092,75793,17.43618,434688
3399,FauxFaux,4,0.00092,75797,17.43710,434688
3400,Fcscanf,4,0.00092,75801,17.43802,434688
3401,febzhang,4,0.00092,75805,17.43894,434688
3402,FelipeEmerim,4,0.00092,75809,17.43986,434688
3403,fengjiankui,4,0.00092,75813,17.44079,434688
3404,filipecosta90,4,0.00092,75817,17.44171,434688
3405,fox-md,4,0.00092,75821,17.44263,434688
3406,fracarvic,4,0.00092,75825,17.44355,434688
3407,francisco-pc7063,4,0.00092,75829,17.44447,434688
3408,franck-romano,4,0.00092,75833,17.44539,434688
3409,frankfil,4,0.00092,75837,17.44631,434688
3410,franklinkim,4,0.00092,75841,17.44723,434688
3411,fregataa,4,0.00092,75845,17.44815,434688
3412,frey66,4,0.00092,75849,17.44907,434688
3413,fstrudel,4,0.00092,75853,17.44999,434688
3414,Fullplate,4,0.00092,75857,17.45091,434688
3415,fulviodenza,4,0.00092,75861,17.45183,434688
3416,furkhat,4,0.00092,75865,17.45275,434688
3417,gabron,4,0.00092,75869,17.45367,434688
3418,gaby,4,0.00092,75873,17.45459,434688
3419,gaffneyd4,4,0.00092,75877,17.45551,434688
3420,galmasi,4,0.00092,75881,17.45643,434688
3421,game5413,4,0.00092,75885,17.45735,434688
3422,gauravsaralMs,4,0.00092,75889,17.45827,434688
3423,gchamon,4,0.00092,75893,17.45919,434688
3424,gdejong,4,0.00092,75897,17.46011,434688
3425,geekhckr,4,0.00092,75901,17.46103,434688
3426,georgechang,4,0.00092,75905,17.46195,434688
3427,gf457832386,4,0.00092,75909,17.46287,434688
3428,ggupthavitob,4,0.00092,75913,17.46379,434688
3429,gharaszti71,4,0.00092,75917,17.46471,434688
3430,gilsonmelo,4,0.00092,75921,17.46563,434688
3431,ginwakeup,4,0.00092,75925,17.46655,434688
3432,gnadaban,4,0.00092,75929,17.46747,434688
3433,gongcon,4,0.00092,75933,17.46839,434688
3434,goyalrohit850,4,0.00092,75937,17.46931,434688
3435,gpabdo,4,0.00092,75941,17.47023,434688
3436,gprossliner,4,0.00092,75945,17.47115,434688
3437,gravishpurohit,4,0.00092,75949,17.47207,434688
3438,grigoriilazari001,4,0.00092,75953,17.47299,434688
3439,gtrubach,4,0.00092,75957,17.47391,434688
3440,GuangzheJiang,4,0.00092,75961,17.47483,434688
3441,guillaumBrisard,4,0.00092,75965,17.47575,434688
3442,guo-shaoge,4,0.00092,75969,17.47667,434688
3443,guyuewenqing,4,0.00092,75973,17.47759,434688
3444,guyyakir,4,0.00092,75977,17.47851,434688
3445,gxglls,4,0.00092,75981,17.47943,434688
3446,habibali95,4,0.00092,75985,17.48035,434688
3447,Hakky54,4,0.00092,75989,17.48127,434688
3448,hamishforbes,4,0.00092,75993,17.48219,434688
3449,Hanggi,4,0.00092,75997,17.48311,434688
3450,haotaogeng,4,0.00092,76001,17.48403,434688
3451,harjis,4,0.00092,76005,17.48495,434688
3452,harryfallows,4,0.00092,76009,17.48587,434688
3453,harshdevl,4,0.00092,76013,17.48680,434688
3454,hdimitriou,4,0.00092,76017,17.48772,434688
3455,heatheralee,4,0.00092,76021,17.48864,434688
3456,heckelmann,4,0.00092,76025,17.48956,434688
3457,henry232323,4,0.00092,76029,17.49048,434688
3458,hensur,4,0.00092,76033,17.49140,434688
3459,HessTina-YuI,4,0.00092,76037,17.49232,434688
3460,HexalGJ,4,0.00092,76041,17.49324,434688
3461,hfxsd,4,0.00092,76045,17.49416,434688
3462,hj24,4,0.00092,76049,17.49508,434688
3463,hohteri,4,0.00092,76053,17.49600,434688
3464,hollowimage,4,0.00092,76057,17.49692,434688
3465,holooooo,4,0.00092,76061,17.49784,434688
3466,hongaar,4,0.00092,76065,17.49876,434688
3467,hoozecn,4,0.00092,76069,17.49968,434688
3468,houstonj1,4,0.00092,76073,17.50060,434688
3469,houweilong,4,0.00092,76077,17.50152,434688
3470,howyi,4,0.00092,76081,17.50244,434688
3471,hspencer77,4,0.00092,76085,17.50336,434688
3472,hughxia,4,0.00092,76089,17.50428,434688
3473,HyeonuPark,4,0.00092,76093,17.50520,434688
3474,hypdeb,4,0.00092,76097,17.50612,434688
3475,hypnopotamus,4,0.00092,76101,17.50704,434688
3476,i3oc9i,4,0.00092,76105,17.50796,434688
3477,iainlane,4,0.00092,76109,17.50888,434688
3478,idarb-oss,4,0.00092,76113,17.50980,434688
3479,idevera,4,0.00092,76117,17.51072,434688
3480,iGene,4,0.00092,76121,17.51164,434688
3481,iisworks,4,0.00092,76125,17.51256,434688
3482,ijt32031,4,0.00092,76129,17.51348,434688
3483,interh852,4,0.00092,76133,17.51440,434688
3484,inverse,4,0.00092,76137,17.51532,434688
3485,IrisG33,4,0.00092,76141,17.51624,434688
3486,iron9light,4,0.00092,76145,17.51716,434688
3487,ironyman,4,0.00092,76149,17.51808,434688
3488,IvanVan,4,0.00092,76153,17.51900,434688
3489,jacky68147527,4,0.00092,76157,17.51992,434688
3490,jagdishkulkarni,4,0.00092,76161,17.52084,434688
3491,japoorv,4,0.00092,76165,17.52176,434688
3492,JasinlikeEatingOrange,4,0.00092,76169,17.52268,434688
3493,JasonCarter80,4,0.00092,76173,17.52360,434688
3494,jaunruh,4,0.00092,76177,17.52452,434688
3495,jayce,4,0.00092,76181,17.52544,434688
3496,JBaptisme33,4,0.00092,76185,17.52636,434688
3497,jbg,4,0.00092,76189,17.52728,434688
3498,jcampbell,4,0.00092,76193,17.52820,434688
3499,j-carpentier,4,0.00092,76197,17.52912,434688
3500,jcpittman144,4,0.00092,76201,17.53004,434688
3501,Jcsenterprisesllc,4,0.00092,76205,17.53096,434688
3502,jeamland,4,0.00092,76209,17.53188,434688
3503,Jeinhaus,4,0.00092,76213,17.53281,434688
3504,jeroenlandheer,4,0.00092,76217,17.53373,434688
3505,jeschkies,4,0.00092,76221,17.53465,434688
3506,jgraettinger,4,0.00092,76225,17.53557,434688
3507,J-Ha,4,0.00092,76229,17.53649,434688
3508,jiaozh8,4,0.00092,76233,17.53741,434688
3509,JiHyunSong,4,0.00092,76237,17.53833,434688
3510,jikuma,4,0.00092,76241,17.53925,434688
3511,jimmywarting,4,0.00092,76245,17.54017,434688
3512,jinfwhuang,4,0.00092,76249,17.54109,434688
3513,jiping-s,4,0.00092,76253,17.54201,434688
3514,jjlakis,4,0.00092,76257,17.54293,434688
3515,jkataja,4,0.00092,76261,17.54385,434688
3516,JKrame,4,0.00092,76265,17.54477,434688
3517,jkschulz,4,0.00092,76269,17.54569,434688
3518,jlisee,4,0.00092,76273,17.54661,434688
3519,jmc-9304,4,0.00092,76277,17.54753,434688
3520,jmdacruz,4,0.00092,76281,17.54845,434688
3521,joaomo,4,0.00092,76285,17.54937,434688
3522,jobinjosem1,4,0.00092,76289,17.55029,434688
3523,JoeryH,4,0.00092,76293,17.55121,434688
3524,Johnny-Three,4,0.00092,76297,17.55213,434688
3525,johnr84,4,0.00092,76301,17.55305,434688
3526,JonathanWamsley,4,0.00092,76305,17.55397,434688
3527,jonshaffer,4,0.00092,76309,17.55489,434688
3528,jordiprats,4,0.00092,76313,17.55581,434688
3529,jothi7891,4,0.00092,76317,17.55673,434688
3530,jroes,4,0.00092,76321,17.55765,434688
3531,jsushetski,4,0.00092,76325,17.55857,434688
3532,jtcarnes,4,0.00092,76329,17.55949,434688
3533,jtr109,4,0.00092,76333,17.56041,434688
3534,juliafriedman8,4,0.00092,76337,17.56133,434688
3535,juliandavid333,4,0.00092,76341,17.56225,434688
3536,jumping,4,0.00092,76345,17.56317,434688
3537,jwalitptl,4,0.00092,76349,17.56409,434688
3538,jwsomis,4,0.00092,76353,17.56501,434688
3539,jzangari,4,0.00092,76357,17.56593,434688
3540,Ka0o0,4,0.00092,76361,17.56685,434688
3541,Kajol-Kumari,4,0.00092,76365,17.56777,434688
3542,kalirajann,4,0.00092,76369,17.56869,434688
3543,kallydev,4,0.00092,76373,17.56961,434688
3544,KamaljeetSahoo,4,0.00092,76377,17.57053,434688
3545,karthick18,4,0.00092,76381,17.57145,434688
3546,KatherineZhou,4,0.00092,76385,17.57237,434688
3547,katyamag,4,0.00092,76389,17.57329,434688
3548,kbkk,4,0.00092,76393,17.57421,434688
3549,kendfinger,4,0.00092,76397,17.57513,434688
3550,KenxinKun,4,0.00092,76401,17.57605,434688
3551,kernel32uiuc,4,0.00092,76405,17.57697,434688
3552,kevin-hanselman,4,0.00092,76409,17.57789,434688
3553,kevwan,4,0.00092,76413,17.57882,434688
3554,keydon,4,0.00092,76417,17.57974,434688
3555,Kharvi-Code,4,0.00092,76421,17.58066,434688
3556,kibernetik542,4,0.00092,76425,17.58158,434688
3557,kickthemooon,4,0.00092,76429,17.58250,434688
3558,Kilz78,4,0.00092,76433,17.58342,434688
3559,kiorky,4,0.00092,76437,17.58434,434688
3560,kiranreddyamk,4,0.00092,76441,17.58526,434688
3561,Kircheisser,4,0.00092,76445,17.58618,434688
3562,kjstart,4,0.00092,76449,17.58710,434688
3563,kleferbe,4,0.00092,76453,17.58802,434688
3564,knidhikaranth,4,0.00092,76457,17.58894,434688
3565,knyttl,4,0.00092,76461,17.58986,434688
3566,kofl91,4,0.00092,76465,17.59078,434688
3567,krmichelos,4,0.00092,76469,17.59170,434688
3568,krnchittora2,4,0.00092,76473,17.59262,434688
3569,krzysztofdrys,4,0.00092,76477,17.59354,434688
3570,ksudhir007,4,0.00092,76481,17.59446,434688
3571,ktpktr0,4,0.00092,76485,17.59538,434688
3572,kuerbis-martin,4,0.00092,76489,17.59630,434688
3573,kumardeni,4,0.00092,76493,17.59722,434688
3574,kunalsingthakur,4,0.00092,76497,17.59814,434688
3575,Kuri-su,4,0.00092,76501,17.59906,434688
3576,Kurt-Rayner-Alpha,4,0.00092,76505,17.59998,434688
3577,kwoodson,4,0.00092,76509,17.60090,434688
3578,kxzonly,4,0.00092,76513,17.60182,434688
3579,l5io,4,0.00092,76517,17.60274,434688
3580,LadySerena,4,0.00092,76521,17.60366,434688
3581,lambertsbennett,4,0.00092,76525,17.60458,434688
3582,lambotchi,4,0.00092,76529,17.60550,434688
3583,larsskj,4,0.00092,76533,17.60642,434688
3584,learnbyseven,4,0.00092,76537,17.60734,434688
3585,LebronAl,4,0.00092,76541,17.60826,434688
3586,leela-maheshwar,4,0.00092,76545,17.60918,434688
3587,lemonit-eric-mao,4,0.00092,76549,17.61010,434688
3588,liamhao,4,0.00092,76553,17.61102,434688
3589,lianxmfor,4,0.00092,76557,17.61194,434688
3590,linzh92,4,0.00092,76561,17.61286,434688
3591,liqd1,4,0.00092,76565,17.61378,434688
3592,litewhatever,4,0.00092,76569,17.61470,434688
3593,liuqi-sun,4,0.00092,76573,17.61562,434688
3594,liusy58,4,0.00092,76577,17.61654,434688
3595,lixiaoyuner,4,0.00092,76581,17.61746,434688
3596,liyjcdl,4,0.00092,76585,17.61838,434688
3597,LLLLLBJ,4,0.00092,76589,17.61930,434688
3598,lloyd-dotmodus,4,0.00092,76593,17.62022,434688
3599,logan2211,4,0.00092,76597,17.62114,434688
3600,loomis-relativity,4,0.00092,76601,17.62206,434688
3601,Loucool111,4,0.00092,76605,17.62298,434688
3602,lukeschlather,4,0.00092,76609,17.62390,434688
3603,luotian-github,4,0.00092,76613,17.62483,434688
3604,maethes,4,0.00092,76617,17.62575,434688
3605,mahaffey,4,0.00092,76621,17.62667,434688
3606,maik-d,4,0.00092,76625,17.62759,434688
3607,MaJie86,4,0.00092,76629,17.62851,434688
3608,malceore,4,0.00092,76633,17.62943,434688
3609,malekobaid,4,0.00092,76637,17.63035,434688
3610,mamercad,4,0.00092,76641,17.63127,434688
3611,marcelobartsch,4,0.00092,76645,17.63219,434688
3612,MarcusGrass,4,0.00092,76649,17.63311,434688
3613,marekcirkos,4,0.00092,76653,17.63403,434688
3614,markgarrigan,4,0.00092,76657,17.63495,434688
3615,markliederbach,4,0.00092,76661,17.63587,434688
3616,MarkMurphy,4,0.00092,76665,17.63679,434688
3617,MarkSRobinson,4,0.00092,76669,17.63771,434688
3618,martiinezz,4,0.00092,76673,17.63863,434688
3619,martinkennelly,4,0.00092,76677,17.63955,434688
3620,martin-schoenegger,4,0.00092,76681,17.64047,434688
3621,mateka,4,0.00092,76685,17.64139,434688
3622,matheushent,4,0.00092,76689,17.64231,434688
3623,matheusnicolas,4,0.00092,76693,17.64323,434688
3624,MATRIX4284,4,0.00092,76697,17.64415,434688
3625,MattBianco,4,0.00092,76701,17.64507,434688
3626,MattesWhite,4,0.00092,76705,17.64599,434688
3627,MattiasVahlberg,4,0.00092,76709,17.64691,434688
3628,mattoberle,4,0.00092,76713,17.64783,434688
3629,maxifom,4,0.00092,76717,17.64875,434688
3630,maxiloEmmmm,4,0.00092,76721,17.64967,434688
3631,mayuraviraj,4,0.00092,76725,17.65059,434688
3632,Mberga14,4,0.00092,76729,17.65151,434688
3633,mboutet,4,0.00092,76733,17.65243,434688
3634,mcarbonneaux,4,0.00092,76737,17.65335,434688
3635,mckernanin,4,0.00092,76741,17.65427,434688
3636,mdhorn,4,0.00092,76745,17.65519,434688
3637,mdraijer,4,0.00092,76749,17.65611,434688
3638,mecseid,4,0.00092,76753,17.65703,434688
3639,mehulhirpara,4,0.00092,76757,17.65795,434688
3640,meiblorn,4,0.00092,76761,17.65887,434688
3641,MeinhardZhou,4,0.00092,76765,17.65979,434688
3642,meSunnySrivastava,4,0.00092,76769,17.66071,434688
3643,metalcyanide,4,0.00092,76773,17.66163,434688
3644,mfine,4,0.00092,76777,17.66255,434688
3645,mhabicht,4,0.00092,76781,17.66347,434688
3646,mhehle,4,0.00092,76785,17.66439,434688
3647,mi5key,4,0.00092,76789,17.66531,434688
3648,MichaelLhommeOFP,4,0.00092,76793,17.66623,434688
3649,michael-sayapin,4,0.00092,76797,17.66715,434688
3650,miguelspe,4,0.00092,76801,17.66807,434688
3651,MihailsKuzmins,4,0.00092,76805,17.66899,434688
3652,mikeccuk2005,4,0.00092,76809,17.66991,434688
3653,mike-england,4,0.00092,76813,17.67084,434688
3654,mike-jm,4,0.00092,76817,17.67176,434688
3655,mikeluosq,4,0.00092,76821,17.67268,434688
3656,mikemorris,4,0.00092,76825,17.67360,434688
3657,MikePadge,4,0.00092,76829,17.67452,434688
3658,MikeZappa87,4,0.00092,76833,17.67544,434688
3659,Miles-Garnsey,4,0.00092,76837,17.67636,434688
3660,mill5james,4,0.00092,76841,17.67728,434688
3661,mimatache,4,0.00092,76845,17.67820,434688
3662,miroswan,4,0.00092,76849,17.67912,434688
3663,missinglink,4,0.00092,76853,17.68004,434688
3664,Mjahannivas,4,0.00092,76857,17.68096,434688
3665,mkjmkumar,4,0.00092,76861,17.68188,434688
3666,mkrutik,4,0.00092,76865,17.68280,434688
3667,mmcaya,4,0.00092,76869,17.68372,434688
3668,mmiranda,4,0.00092,76873,17.68464,434688
3669,molu-guwang,4,0.00092,76877,17.68556,434688
3670,monsteredc,4,0.00092,76881,17.68648,434688
3671,moonlight16,4,0.00092,76885,17.68740,434688
3672,mooyoul,4,0.00092,76889,17.68832,434688
3673,morganchen12,4,0.00092,76893,17.68924,434688
3674,moteesh-in2tive,4,0.00092,76897,17.69016,434688
3675,msfrucht,4,0.00092,76901,17.69108,434688
3676,msugakov,4,0.00092,76905,17.69200,434688
3677,mubarak-j,4,0.00092,76909,17.69292,434688
3678,mukul-seagate11,4,0.00092,76913,17.69384,434688
3679,murphye,4,0.00092,76917,17.69476,434688
3680,mx-foxtel,4,0.00092,76921,17.69568,434688
3681,mzingarelli,4,0.00092,76925,17.69660,434688
3682,n2vo,4,0.00092,76929,17.69752,434688
3683,Nan2018,4,0.00092,76933,17.69844,434688
3684,nanana-w,4,0.00092,76937,17.69936,434688
3685,nannancy,4,0.00092,76941,17.70028,434688
3686,nappa85,4,0.00092,76945,17.70120,434688
3687,narenreddycs,4,0.00092,76949,17.70212,434688
3688,narrenfrei,4,0.00092,76953,17.70304,434688
3689,naveen-krishnan-tm,4,0.00092,76957,17.70396,434688
3690,navjot-puc,4,0.00092,76961,17.70488,434688
3691,ncreated,4,0.00092,76965,17.70580,434688
3692,ndj888,4,0.00092,76969,17.70672,434688
3693,necrolyte2,4,0.00092,76973,17.70764,434688
3694,negram,4,0.00092,76977,17.70856,434688
3695,nicolasbrechet,4,0.00092,76981,17.70948,434688
3696,nicolas-g,4,0.00092,76985,17.71040,434688
3697,nielstenboom,4,0.00092,76989,17.71132,434688
3698,nif,4,0.00092,76993,17.71224,434688
3699,NikitaDef,4,0.00092,76997,17.71316,434688
3700,ning1875,4,0.00092,77001,17.71408,434688
3701,noahkawasakigoogle,4,0.00092,77005,17.71500,434688
3702,Noam-greenberrg,4,0.00092,77009,17.71592,434688
3703,nolem,4,0.00092,77013,17.71685,434688
3704,nomis-rzp,4,0.00092,77017,17.71777,434688
3705,Noremac201,4,0.00092,77021,17.71869,434688
3706,Nothing4You,4,0.00092,77025,17.71961,434688
3707,nsagark,4,0.00092,77029,17.72053,434688
3708,NurlashKO,4,0.00092,77033,17.72145,434688
3709,odilonjk,4,0.00092,77037,17.72237,434688
3710,ogunko12345,4,0.00092,77041,17.72329,434688
3711,ohdearaugustin,4,0.00092,77045,17.72421,434688
3712,oleksandr-balyshyn,4,0.00092,77049,17.72513,434688
3713,olevitt,4,0.00092,77053,17.72605,434688
3714,omeiirr,4,0.00092,77057,17.72697,434688
3715,ondrejdolezal93,4,0.00092,77061,17.72789,434688
3716,Oneal65,4,0.00092,77065,17.72881,434688
3717,o-otte,4,0.00092,77069,17.72973,434688
3718,Ornias1993,4,0.00092,77073,17.73065,434688
3719,Osprey2021,4,0.00092,77077,17.73157,434688
3720,overmeulen,4,0.00092,77081,17.73249,434688
3721,p0tr3c,4,0.00092,77085,17.73341,434688
3722,p3lim,4,0.00092,77089,17.73433,434688
3723,pa1op,4,0.00092,77093,17.73525,434688
3724,pa250194,4,0.00092,77097,17.73617,434688
3725,palson,4,0.00092,77101,17.73709,434688
3726,pandyah,4,0.00092,77105,17.73801,434688
3727,panjf2000,4,0.00092,77109,17.73893,434688
3728,panpengfei21,4,0.00092,77113,17.73985,434688
3729,PatrykSt,4,0.00092,77117,17.74077,434688
3730,paullaffitte,4,0.00092,77121,17.74169,434688
3731,paulohleal,4,0.00092,77125,17.74261,434688
3732,pavankumar-go,4,0.00092,77129,17.74353,434688
3733,pavlo-bondarenko,4,0.00092,77133,17.74445,434688
3734,pawcykca,4,0.00092,77137,17.74537,434688
3735,pefeigl,4,0.00092,77141,17.74629,434688
3736,pendeyao,4,0.00092,77145,17.74721,434688
3737,perjoh,4,0.00092,77149,17.74813,434688
3738,p-e-w,4,0.00092,77153,17.74905,434688
3739,pgeler,4,0.00092,77157,17.74997,434688
3740,piengeng,4,0.00092,77161,17.75089,434688
3741,piyushsingariya,4,0.00092,77165,17.75181,434688
3742,PKUFlyingPig,4,0.00092,77169,17.75273,434688
3743,pllsxyc,4,0.00092,77173,17.75365,434688
3744,Polyipnus,4,0.00092,77177,17.75457,434688
3745,PoojaGidaveer,4,0.00092,77181,17.75549,434688
3746,poojas1607,4,0.00092,77185,17.75641,434688
3747,prajith-nair,4,0.00092,77189,17.75733,434688
3748,prakashkl88,4,0.00092,77193,17.75825,434688
3749,Prashanth-M,4,0.00092,77197,17.75917,434688
3750,praxist,4,0.00092,77201,17.76009,434688
3751,prazumovsky,4,0.00092,77205,17.76101,434688
3752,PriyankaDasKafka,4,0.00092,77209,17.76193,434688
3753,pROFESOR11,4,0.00092,77213,17.76286,434688
3754,profporridge,4,0.00092,77217,17.76378,434688
3755,ProticM,4,0.00092,77221,17.76470,434688
3756,prprasad2020,4,0.00092,77225,17.76562,434688
3757,psarossy,4,0.00092,77229,17.76654,434688
3758,psyhomb,4,0.00092,77233,17.76746,434688
3759,ptnapoleon,4,0.00092,77237,17.76838,434688
3760,pxjohnny,4,0.00092,77241,17.76930,434688
3761,pyrl247,4,0.00092,77245,17.77022,434688
3762,pytimer,4,0.00092,77249,17.77114,434688
3763,qgeffard,4,0.00092,77253,17.77206,434688
3764,qichengzx,4,0.00092,77257,17.77298,434688
3765,quangthe,4,0.00092,77261,17.77390,434688
3766,quite4work,4,0.00092,77265,17.77482,434688
3767,qusc,4,0.00092,77269,17.77574,434688
3768,radinv,4,0.00092,77273,17.77666,434688
3769,rafaeltovargarrido,4,0.00092,77277,17.77758,434688
3770,rafalkasa,4,0.00092,77281,17.77850,434688
3771,raildo,4,0.00092,77285,17.77942,434688
3772,rajivchirania,4,0.00092,77289,17.78034,434688
3773,raman-nbg,4,0.00092,77293,17.78126,434688
3774,Ramilito,4,0.00092,77297,17.78218,434688
3775,rbren,4,0.00092,77301,17.78310,434688
3776,rbrishabh,4,0.00092,77305,17.78402,434688
3777,redtex,4,0.00092,77309,17.78494,434688
3778,rekup,4,0.00092,77313,17.78586,434688
3779,renchili,4,0.00092,77317,17.78678,434688
3780,reneluria,4,0.00092,77321,17.78770,434688
3781,renhuanyu,4,0.00092,77325,17.78862,434688
3782,RenxuanW,4,0.00092,77329,17.78954,434688
3783,RFinland,4,0.00092,77333,17.79046,434688
3784,rgiovanardi,4,0.00092,77337,17.79138,434688
3785,rhassanein,4,0.00092,77341,17.79230,434688
3786,richardjudgeman,4,0.00092,77345,17.79322,434688
3787,rickardp,4,0.00092,77349,17.79414,434688
3788,rickihastings,4,0.00092,77353,17.79506,434688
3789,ricky-rav,4,0.00092,77357,17.79598,434688
3790,rini2208,4,0.00092,77361,17.79690,434688
3791,RjYogi7880,4,0.00092,77365,17.79782,434688
3792,robincher,4,0.00092,77369,17.79874,434688
3793,RobinSegura,4,0.00092,77373,17.79966,434688
3794,robsonvn,4,0.00092,77377,17.80058,434688
3795,rohiddev,4,0.00092,77381,17.80150,434688
3796,Rohit2387,4,0.00092,77385,17.80242,434688
3797,Rol111-hub,4,0.00092,77389,17.80334,434688
3798,rotemjac,4,0.00092,77393,17.80426,434688
3799,rouzier,4,0.00092,77397,17.80518,434688
3800,rseichter,4,0.00092,77401,17.80610,434688
3801,rubber-ant,4,0.00092,77405,17.80702,434688
3802,ruihua-zhao1,4,0.00092,77409,17.80795,434688
3803,Russiancold,4,0.00092,77413,17.80887,434688
3804,rwanito,4,0.00092,77417,17.80979,434688
3805,ryanhfrench,4,0.00092,77421,17.81071,434688
3806,rymnc,4,0.00092,77425,17.81163,434688
3807,Sahith-Shetty,4,0.00092,77429,17.81255,434688
3808,sairaj2119,4,0.00092,77433,17.81347,434688
3809,sajanraj,4,0.00092,77437,17.81439,434688
3810,salemgolemugoo,4,0.00092,77441,17.81531,434688
3811,sanamsarath,4,0.00092,77445,17.81623,434688
3812,sandeep1785,4,0.00092,77449,17.81715,434688
3813,sangramnayak1,4,0.00092,77453,17.81807,434688
3814,sanya301,4,0.00092,77457,17.81899,434688
3815,sanzenwin,4,0.00092,77461,17.81991,434688
3816,saparaj,4,0.00092,77465,17.82083,434688
3817,sash2222,4,0.00092,77469,17.82175,434688
3818,saurabhvagrawal,4,0.00092,77473,17.82267,434688
3819,sbarikdev,4,0.00092,77477,17.82359,434688
3820,scar-lovevery,4,0.00092,77481,17.82451,434688
3821,schra,4,0.00092,77485,17.82543,434688
3822,SCLogo,4,0.00092,77489,17.82635,434688
3823,scott-sudweeks,4,0.00092,77493,17.82727,434688
3824,sdd1798,4,0.00092,77497,17.82819,434688
3825,sdhoward,4,0.00092,77501,17.82911,434688
3826,searchgithub,4,0.00092,77505,17.83003,434688
3827,sebnyberg,4,0.00092,77509,17.83095,434688
3828,sergeyberezansky,4,0.00092,77513,17.83187,434688
3829,sergio-correia,4,0.00092,77517,17.83279,434688
3830,sevendials,4,0.00092,77521,17.83371,434688
3831,seyoongit,4,0.00092,77525,17.83463,434688
3832,sguyennet,4,0.00092,77529,17.83555,434688
3833,shabicheng,4,0.00092,77533,17.83647,434688
3834,shahidhs-ibm,4,0.00092,77537,17.83739,434688
3835,shaisgv,4,0.00092,77541,17.83831,434688
3836,sha-rath,4,0.00092,77545,17.83923,434688
3837,sharmahemlata,4,0.00092,77549,17.84015,434688
3838,sharms,4,0.00092,77553,17.84107,434688
3839,sheisnicola,4,0.00092,77557,17.84199,434688
3840,shetesagar87,4,0.00092,77561,17.84291,434688
3841,shihaodong8899,4,0.00092,77565,17.84383,434688
3842,Shinji-IkariG,4,0.00092,77569,17.84475,434688
3843,shiqinfeng1,4,0.00092,77573,17.84567,434688
3844,shivjm,4,0.00092,77577,17.84659,434688
3845,Shnitzelil,4,0.00092,77581,17.84751,434688
3846,shoukoo,4,0.00092,77585,17.84843,434688
3847,shrey-183,4,0.00092,77589,17.84935,434688
3848,ShreyaTyagi0XD,4,0.00092,77593,17.85027,434688
3849,shubham391,4,0.00092,77597,17.85119,434688
3850,shubhi-1407,4,0.00092,77601,17.85211,434688
3851,SHUFIL,4,0.00092,77605,17.85303,434688
3852,shyamgcpdemo,4,0.00092,77609,17.85396,434688
3853,siddharthck,4,0.00092,77613,17.85488,434688
3854,sidh,4,0.00092,77617,17.85580,434688
3855,SilverBut,4,0.00092,77621,17.85672,434688
3856,silverraven691,4,0.00092,77625,17.85764,434688
3857,simcard0000,4,0.00092,77629,17.85856,434688
3858,Sinhyeok,4,0.00092,77633,17.85948,434688
3859,sitilge,4,0.00092,77637,17.86040,434688
3860,skambashi,4,0.00092,77641,17.86132,434688
3861,Skaronator,4,0.00092,77645,17.86224,434688
3862,skykewei,4,0.00092,77649,17.86316,434688
3863,slavafomin,4,0.00092,77653,17.86408,434688
3864,slm940208,4,0.00092,77657,17.86500,434688
3865,smith1994michael,4,0.00092,77661,17.86592,434688
3866,Smitholi67,4,0.00092,77665,17.86684,434688
3867,smlx,4,0.00092,77669,17.86776,434688
3868,sniranjan,4,0.00092,77673,17.86868,434688
3869,soleimaniamir,4,0.00092,77677,17.86960,434688
3870,some-random-dude123,4,0.00092,77681,17.87052,434688
3871,SoMuchForSubtlety,4,0.00092,77685,17.87144,434688
3872,sonder-joker,4,0.00092,77689,17.87236,434688
3873,sowhat7,4,0.00092,77693,17.87328,434688
3874,spider0061,4,0.00092,77697,17.87420,434688
3875,SpootyMcSpoot,4,0.00092,77701,17.87512,434688
3876,sqerison,4,0.00092,77705,17.87604,434688
3877,sreejithwpg,4,0.00092,77709,17.87696,434688
3878,srgbtl,4,0.00092,77713,17.87788,434688
3879,sriram-kannan-infoblox,4,0.00092,77717,17.87880,434688
3880,ssaraswati,4,0.00092,77721,17.87972,434688
3881,sschroed99,4,0.00092,77725,17.88064,434688
3882,ssgelm,4,0.00092,77729,17.88156,434688
3883,sshimojo,4,0.00092,77733,17.88248,434688
3884,stanosamek,4,0.00092,77737,17.88340,434688
3885,stavenko,4,0.00092,77741,17.88432,434688
3886,stefvic,4,0.00092,77745,17.88524,434688
3887,stephenthedev,4,0.00092,77749,17.88616,434688
3888,stevedunne,4,0.00092,77753,17.88708,434688
3889,sunchill06,4,0.00092,77757,17.88800,434688
3890,sunkuranganath,4,0.00092,77761,17.88892,434688
3891,surajthakur,4,0.00092,77765,17.88984,434688
3892,Sushisource,4,0.00092,77769,17.89076,434688
3893,suzaku,4,0.00092,77773,17.89168,434688
3894,svedatbegar,4,0.00092,77777,17.89260,434688
3895,SysAdmLS,4,0.00092,77781,17.89352,434688
3896,taejune,4,0.00092,77785,17.89444,434688
3897,tahirali-endurance,4,0.00092,77789,17.89536,434688
3898,taktv6,4,0.00092,77793,17.89628,434688
3899,takumakume,4,0.00092,77797,17.89720,434688
3900,tamboliasir1,4,0.00092,77801,17.89812,434688
3901,tamil07,4,0.00092,77805,17.89904,434688
3902,Tammy-kunyu,4,0.00092,77809,17.89997,434688
3903,tburschka,4,0.00092,77813,17.90089,434688
3904,tcchen123,4,0.00092,77817,17.90181,434688
3905,techstep,4,0.00092,77821,17.90273,434688
3906,tejasrinivask,4,0.00092,77825,17.90365,434688
3907,tejohnson123,4,0.00092,77829,17.90457,434688
3908,temirrr,4,0.00092,77833,17.90549,434688
3909,Teo90,4,0.00092,77837,17.90641,434688
3910,tetsuhaut,4,0.00092,77841,17.90733,434688
3911,tewe,4,0.00092,77845,17.90825,434688
3912,tgallant,4,0.00092,77849,17.90917,434688
3913,thackem,4,0.00092,77853,17.91009,434688
3914,thanatchakromsang,4,0.00092,77857,17.91101,434688
3915,thanhma,4,0.00092,77861,17.91193,434688
3916,TheDutchMC,4,0.00092,77865,17.91285,434688
3917,thephpguy,4,0.00092,77869,17.91377,434688
3918,TheRealGoku,4,0.00092,77873,17.91469,434688
3919,thernstig,4,0.00092,77877,17.91561,434688
3920,thetrendspider,4,0.00092,77881,17.91653,434688
3921,theunrealgeek,4,0.00092,77885,17.91745,434688
3922,thiagocaiubi,4,0.00092,77889,17.91837,434688
3923,thiscantbeserious,4,0.00092,77893,17.91929,434688
3924,time-and-fate,4,0.00092,77897,17.92021,434688
3925,Timeraa,4,0.00092,77901,17.92113,434688
3926,timofurrer,4,0.00092,77905,17.92205,434688
3927,timothyleung1,4,0.00092,77909,17.92297,434688
3928,tina-root,4,0.00092,77913,17.92389,434688
3929,tinyzimmer,4,0.00092,77917,17.92481,434688
3930,tjjkj,4,0.00092,77921,17.92573,434688
3931,tjstansell,4,0.00092,77925,17.92665,434688
3932,tkjwa,4,0.00092,77929,17.92757,434688
3933,tlamr,4,0.00092,77933,17.92849,434688
3934,tl-david-hayden,4,0.00092,77937,17.92941,434688
3935,toabi,4,0.00092,77941,17.93033,434688
3936,tomaszdudek7,4,0.00092,77945,17.93125,434688
3937,TomL-dev,4,0.00092,77949,17.93217,434688
3938,tommymalmqvist,4,0.00092,77953,17.93309,434688
3939,topletal,4,0.00092,77957,17.93401,434688
3940,torongu,4,0.00092,77961,17.93493,434688
3941,toyaser,4,0.00092,77965,17.93585,434688
3942,TPX01,4,0.00092,77969,17.93677,434688
3943,TrAnn3l,4,0.00092,77973,17.93769,434688
3944,trastle,4,0.00092,77977,17.93861,434688
3945,triptesh1212,4,0.00092,77981,17.93953,434688
3946,trishu99,4,0.00092,77985,17.94045,434688
3947,TristanB1994,4,0.00092,77989,17.94137,434688
3948,tszngai,4,0.00092,77993,17.94229,434688
3949,ttk,4,0.00092,77997,17.94321,434688
3950,tuananhnguyen-ct,4,0.00092,78001,17.94413,434688
3951,tutuV,4,0.00092,78005,17.94505,434688
3952,twasyl,4,0.00092,78009,17.94598,434688
3953,twilight327426371,4,0.00092,78013,17.94690,434688
3954,twonds,4,0.00092,78017,17.94782,434688
3955,tylerqi,4,0.00092,78021,17.94874,434688
3956,typetetris,4,0.00092,78025,17.94966,434688
3957,tyron,4,0.00092,78029,17.95058,434688
3958,u0324020,4,0.00092,78033,17.95150,434688
3959,u2m4c6,4,0.00092,78037,17.95242,434688
3960,ubhanja,4,0.00092,78041,17.95334,434688
3961,Udbhavbisarya23,4,0.00092,78045,17.95426,434688
3962,ukreddy-erwin,4,0.00092,78049,17.95518,434688
3963,unlucky,4,0.00092,78053,17.95610,434688
3964,upodroid,4,0.00092,78057,17.95702,434688
3965,Utkarshn10,4,0.00092,78061,17.95794,434688
3966,Uttam92477,4,0.00092,78065,17.95886,434688
3967,v1ctorrhs,4,0.00092,78069,17.95978,434688
3968,Vafilor,4,0.00092,78073,17.96070,434688
3969,Varunvallabhan52,4,0.00092,78077,17.96162,434688
3970,vasim38,4,0.00092,78081,17.96254,434688
3971,vcariven,4,0.00092,78085,17.96346,434688
3972,vchirikov,4,0.00092,78089,17.96438,434688
3973,vdjagilev,4,0.00092,78093,17.96530,434688
3974,venom85,4,0.00092,78097,17.96622,434688
3975,viccuad,4,0.00092,78101,17.96714,434688
3976,vicnoah,4,0.00092,78105,17.96806,434688
3977,vijaymateti,4,0.00092,78109,17.96898,434688
3978,vijtrip2,4,0.00092,78113,17.96990,434688
3979,villanel,4,0.00092,78117,17.97082,434688
3980,vinaykr-stripe,4,0.00092,78121,17.97174,434688
3981,vineethvanga18,4,0.00092,78125,17.97266,434688
3982,vinsguru,4,0.00092,78129,17.97358,434688
3983,vinycoolguy2015,4,0.00092,78133,17.97450,434688
3984,visrey,4,0.00092,78137,17.97542,434688
3985,visteras,4,0.00092,78141,17.97634,434688
3986,vitorafgomes,4,0.00092,78145,17.97726,434688
3987,vkhristenko,4,0.00092,78149,17.97818,434688
3988,vkudrik,4,0.00092,78153,17.97910,434688
3989,VladoPortos,4,0.00092,78157,17.98002,434688
3990,vmihailenco,4,0.00092,78161,17.98094,434688
3991,vnline,4,0.00092,78165,17.98186,434688
3992,vpecinka,4,0.00092,78169,17.98278,434688
3993,VR-Architect,4,0.00092,78173,17.98370,434688
3994,vvvirenyu,4,0.00092,78177,17.98462,434688
3995,wangdwcsd,4,0.00092,78181,17.98554,434688
3996,wanjuntham,4,0.00092,78185,17.98646,434688
3997,wchajl,4,0.00092,78189,17.98738,434688
3998,wcurry,4,0.00092,78193,17.98830,434688
3999,WeirdMachine,4,0.00092,78197,17.98922,434688
4000,wenliumeng,4,0.00092,78201,17.99014,434688
4001,wenshin,4,0.00092,78205,17.99106,434688
4002,wesuuu,4,0.00092,78209,17.99199,434688
4003,whatnick,4,0.00092,78213,17.99291,434688
4004,whitneygriffith,4,0.00092,78217,17.99383,434688
4005,wiegandf,4,0.00092,78221,17.99475,434688
4006,willem-jans,4,0.00092,78225,17.99567,434688
4007,WilliamCassanova,4,0.00092,78229,17.99659,434688
4008,willin,4,0.00092,78233,17.99751,434688
4009,witekest,4,0.00092,78237,17.99843,434688
4010,withnale,4,0.00092,78241,17.99935,434688
4011,WMP,4,0.00092,78245,18.00027,434688
4012,wolfguoliang,4,0.00092,78249,18.00119,434688
4013,wong2,4,0.00092,78253,18.00211,434688
4014,wppzxc,4,0.00092,78257,18.00303,434688
4015,ws-prive,4,0.00092,78261,18.00395,434688
4016,WT-Liu,4,0.00092,78265,18.00487,434688
4017,wuestkamp,4,0.00092,78269,18.00579,434688
4018,wu-hui,4,0.00092,78273,18.00671,434688
4019,wuming333666,4,0.00092,78277,18.00763,434688
4020,wuqinqiang,4,0.00092,78281,18.00855,434688
4021,x4m,4,0.00092,78285,18.00947,434688
4022,xammep4,4,0.00092,78289,18.01039,434688
4023,xavier83,4,0.00092,78293,18.01131,434688
4024,xmcqueen,4,0.00092,78297,18.01223,434688
4025,xmlking,4,0.00092,78301,18.01315,434688
4026,xsreality,4,0.00092,78305,18.01407,434688
4027,xxxjkk,4,0.00092,78309,18.01499,434688
4028,yan636,4,0.00092,78313,18.01591,434688
4029,yangjiao2,4,0.00092,78317,18.01683,434688
4030,yangxinyi8,4,0.00092,78321,18.01775,434688
4031,yinxiulong,4,0.00092,78325,18.01867,434688
4032,yipengh,4,0.00092,78329,18.01959,434688
4033,Ymshero,4,0.00092,78333,18.02051,434688
4034,yogagit123,4,0.00092,78337,18.02143,434688
4035,yokymia,4,0.00092,78341,18.02235,434688
4036,younky-yang,4,0.00092,78345,18.02327,434688
4037,yunhjiang,4,0.00092,78349,18.02419,434688
4038,YunLemon,4,0.00092,78353,18.02511,434688
4039,yuranos,4,0.00092,78357,18.02603,434688
4040,yuvan11,4,0.00092,78361,18.02695,434688
4041,yuyue9284,4,0.00092,78365,18.02787,434688
4042,YZ775,4,0.00092,78369,18.02879,434688
4043,zbendhiba,4,0.00092,78373,18.02971,434688
4044,zewelor,4,0.00092,78377,18.03063,434688
4045,zhiburt,4,0.00092,78381,18.03155,434688
4046,zhishi,4,0.00092,78385,18.03247,434688
4047,zhiyxu,4,0.00092,78389,18.03339,434688
4048,zhujf1989,4,0.00092,78393,18.03431,434688
4049,zimv,4,0.00092,78397,18.03523,434688
4050,zmrow,4,0.00092,78401,18.03615,434688
4051,zubenkoivan,4,0.00092,78405,18.03707,434688
4052,zwk5004,4,0.00092,78409,18.03800,434688
4053,0neday,3,0.00069,78412,18.03869,434688
4054,1314cc,3,0.00069,78415,18.03938,434688
4055,15767637775,3,0.00069,78418,18.04007,434688
4056,1ntouchble,3,0.00069,78421,18.04076,434688
4057,494846880,3,0.00069,78424,18.04145,434688
4058,510mt,3,0.00069,78427,18.04214,434688
4059,5wjdgns2,3,0.00069,78430,18.04283,434688
4060,670205427,3,0.00069,78433,18.04352,434688
4061,916264367,3,0.00069,78436,18.04421,434688
4062,97turbotalon,3,0.00069,78439,18.04490,434688
4063,9arriflex9,3,0.00069,78442,18.04559,434688
4064,a5r0n,3,0.00069,78445,18.04628,434688
4065,AAATechGuy,3,0.00069,78448,18.04697,434688
4066,aagu,3,0.00069,78451,18.04766,434688
4067,aaron-geospock,3,0.00069,78454,18.04835,434688
4068,aarongoulet,3,0.00069,78457,18.04904,434688
4069,aaronkorver,3,0.00069,78460,18.04973,434688
4070,abarqawi,3,0.00069,78463,18.05042,434688
4071,abdelouahabb,3,0.00069,78466,18.05111,434688
4072,abhi1693,3,0.00069,78469,18.05180,434688
4073,abhishekghiya,3,0.00069,78472,18.05249,434688
4074,abhishiekgowtham,3,0.00069,78475,18.05318,434688
4075,abroglesc,3,0.00069,78478,18.05387,434688
4076,aburlutskiy,3,0.00069,78481,18.05456,434688
4077,acherifi,3,0.00069,78484,18.05525,434688
4078,achraf17,3,0.00069,78487,18.05594,434688
4079,acjohnson,3,0.00069,78490,18.05663,434688
4080,active-xu,3,0.00069,78493,18.05732,434688
4081,adamtang79,3,0.00069,78496,18.05801,434688
4082,adamtester,3,0.00069,78499,18.05870,434688
4083,Adamyounger,3,0.00069,78502,18.05939,434688
4084,adelca,3,0.00069,78505,18.06008,434688
4085,AdityaC45,3,0.00069,78508,18.06077,434688
4086,adpempx,3,0.00069,78511,18.06146,434688
4087,advissor,3,0.00069,78514,18.06215,434688
4088,agaita,3,0.00069,78517,18.06284,434688
4089,AgustinNormand,3,0.00069,78520,18.06353,434688
4090,aholbreich,3,0.00069,78523,18.06422,434688
4091,Aibing168,3,0.00069,78526,18.06491,434688
4092,ai-denlim,3,0.00069,78529,18.06560,434688
4093,Ailsa-Wu,3,0.00069,78532,18.06629,434688
4094,airkewld,3,0.00069,78535,18.06698,434688
4095,aivanou,3,0.00069,78538,18.06767,434688
4096,AJ-54,3,0.00069,78541,18.06836,434688
4097,ajtomato,3,0.00069,78544,18.06905,434688
4098,akamensky,3,0.00069,78547,18.06974,434688
4099,akanshat,3,0.00069,78550,18.07043,434688
4100,akash-gautam,3,0.00069,78553,18.07112,434688
4101,akhilles,3,0.00069,78556,18.07181,434688
4102,Akifcan,3,0.00069,78559,18.07250,434688
4103,Akiros001,3,0.00069,78562,18.07319,434688
4104,akramwaseem,3,0.00069,78565,18.07388,434688
4105,alanrdel,3,0.00069,78568,18.07457,434688
4106,AlbMor,3,0.00069,78571,18.07526,434688
4107,alexander-melentyev,3,0.00069,78574,18.07595,434688
4108,alexandrevilain,3,0.00069,78577,18.07664,434688
4109,alex-arica,3,0.00069,78580,18.07733,434688
4110,Alex-duzhichao,3,0.00069,78583,18.07802,434688
4111,alexeyatbluescape,3,0.00069,78586,18.07871,434688
4112,alexp1917,3,0.00069,78589,18.07940,434688
4113,AlexStocks,3,0.00069,78592,18.08009,434688
4114,alinjie,3,0.00069,78595,18.08078,434688
4115,alokjani,3,0.00069,78598,18.08147,434688
4116,amanravi12,3,0.00069,78601,18.08216,434688
4117,amine250,3,0.00069,78604,18.08285,434688
4118,amitgud-doordash,3,0.00069,78607,18.08354,434688
4119,amnk,3,0.00069,78610,18.08424,434688
4120,amnonbc,3,0.00069,78613,18.08493,434688
4121,Amos-85,3,0.00069,78616,18.08562,434688
4122,amosshapira,3,0.00069,78619,18.08631,434688
4123,amoylan2,3,0.00069,78622,18.08700,434688
4124,anbrsap,3,0.00069,78625,18.08769,434688
4125,AndersBennedsgaard,3,0.00069,78628,18.08838,434688
4126,andre-lx,3,0.00069,78631,18.08907,434688
4127,AndreMaz,3,0.00069,78634,18.08976,434688
4128,andrew-matteson,3,0.00069,78637,18.09045,434688
4129,andrew-pickin-epi,3,0.00069,78640,18.09114,434688
4130,andrewweston,3,0.00069,78643,18.09183,434688
4131,andrey-shalamov,3,0.00069,78646,18.09252,434688
4132,AndreyTretyak,3,0.00069,78649,18.09321,434688
4133,andykrohg,3,0.00069,78652,18.09390,434688
4134,andywow,3,0.00069,78655,18.09459,434688
4135,AndyYao17,3,0.00069,78658,18.09528,434688
4136,aneeskA,3,0.00069,78661,18.09597,434688
4137,Animezjy,3,0.00069,78664,18.09666,434688
4138,anirudha-ptr,3,0.00069,78667,18.09735,434688
4139,anjaltelang,3,0.00069,78670,18.09804,434688
4140,AnjanaAK,3,0.00069,78673,18.09873,434688
4141,ankitbansal-gc,3,0.00069,78676,18.09942,434688
4142,annalisag-spark,3,0.00069,78679,18.10011,434688
4143,anneadema,3,0.00069,78682,18.10080,434688
4144,anoopnm182,3,0.00069,78685,18.10149,434688
4145,anr09,3,0.00069,78688,18.10218,434688
4146,anthonybudd,3,0.00069,78691,18.10287,434688
4147,Anthony-Jhoiro,3,0.00069,78694,18.10356,434688
4148,antibarbie,3,0.00069,78697,18.10425,434688
4149,AntonSmolkov,3,0.00069,78700,18.10494,434688
4150,antzjm,3,0.00069,78703,18.10563,434688
4151,anurnomeru,3,0.00069,78706,18.10632,434688
4152,anvddriesch,3,0.00069,78709,18.10701,434688
4153,aofekiko,3,0.00069,78712,18.10770,434688
4154,aphilippejolivel,3,0.00069,78715,18.10839,434688
4155,apmartins85,3,0.00069,78718,18.10908,434688
4156,apoorvajagtap,3,0.00069,78721,18.10977,434688
4157,appct,3,0.00069,78724,18.11046,434688
4158,AprilJC,3,0.00069,78727,18.11115,434688
4159,aq17,3,0.00069,78730,18.11184,434688
4160,Aques,3,0.00069,78733,18.11253,434688
4161,archit,3,0.00069,78736,18.11322,434688
4162,arcosx,3,0.00069,78739,18.11391,434688
4163,arielbello,3,0.00069,78742,18.11460,434688
4164,arkgonzales,3,0.00069,78745,18.11529,434688
4165,arodland,3,0.00069,78748,18.11598,434688
4166,artb1sh,3,0.00069,78751,18.11667,434688
4167,artur9010,3,0.00069,78754,18.11736,434688
4168,asankaf,3,0.00069,78757,18.11805,434688
4169,aseg15,3,0.00069,78760,18.11874,434688
4170,ashemachandan,3,0.00069,78763,18.11943,434688
4171,asilverman,3,0.00069,78766,18.12012,434688
4172,astronaut0131,3,0.00069,78769,18.12081,434688
4173,atjones0011,3,0.00069,78772,18.12150,434688
4174,atokarev,3,0.00069,78775,18.12219,434688
4175,attilaersek,3,0.00069,78778,18.12288,434688
4176,AuraSinis,3,0.00069,78781,18.12357,434688
4177,austindrenski,3,0.00069,78784,18.12426,434688
4178,AustinWise,3,0.00069,78787,18.12495,434688
4179,avdeev-a,3,0.00069,78790,18.12564,434688
4180,avi1512,3,0.00069,78793,18.12633,434688
4181,avm99963,3,0.00069,78796,18.12702,434688
4182,aw1cks,3,0.00069,78799,18.12771,434688
4183,AymenSegni,3,0.00069,78802,18.12840,434688
4184,azilber,3,0.00069,78805,18.12909,434688
4185,AzureMarker,3,0.00069,78808,18.12979,434688
4186,Babwenbiber,3,0.00069,78811,18.13048,434688
4187,bainss,3,0.00069,78814,18.13117,434688
4188,balkrishna93,3,0.00069,78817,18.13186,434688
4189,BartoszJaroszkowski,3,0.00069,78820,18.13255,434688
4190,bartpastuszkaTE,3,0.00069,78823,18.13324,434688
4191,basilnsage,3,0.00069,78826,18.13393,434688
4192,Bastien-Bellino,3,0.00069,78829,18.13462,434688
4193,batthebee,3,0.00069,78832,18.13531,434688
4194,bawhetst,3,0.00069,78835,18.13600,434688
4195,bbarnes52,3,0.00069,78838,18.13669,434688
4196,bbdb68,3,0.00069,78841,18.13738,434688
4197,bbeaupain,3,0.00069,78844,18.13807,434688
4198,beastpu,3,0.00069,78847,18.13876,434688
4199,benbooth493,3,0.00069,78850,18.13945,434688
4200,benbyr,3,0.00069,78853,18.14014,434688
4201,bender316,3,0.00069,78856,18.14083,434688
4202,benjamin-hg,3,0.00069,78859,18.14152,434688
4203,Bhanu95190,3,0.00069,78862,18.14221,434688
4204,BhargaviChada,3,0.00069,78865,18.14290,434688
4205,bhundven,3,0.00069,78868,18.14359,434688
4206,bhwanip,3,0.00069,78871,18.14428,434688
4207,bibibubu999,3,0.00069,78874,18.14497,434688
4208,BigSammich,3,0.00069,78877,18.14566,434688
4209,bill-canda,3,0.00069,78880,18.14635,434688
4210,BitProcessor,3,0.00069,78883,18.14704,434688
4211,bjchambers,3,0.00069,78886,18.14773,434688
4212,b-jsshapiro,3,0.00069,78889,18.14842,434688
4213,bjtucker,3,0.00069,78892,18.14911,434688
4214,bkircher,3,0.00069,78895,18.14980,434688
4215,blakeroberts-wk,3,0.00069,78898,18.15049,434688
4216,blemmenes,3,0.00069,78901,18.15118,434688
4217,blesson-james,3,0.00069,78904,18.15187,434688
4218,blindenvy,3,0.00069,78907,18.15256,434688
4219,bLuka,3,0.00069,78910,18.15325,434688
4220,bluntik,3,0.00069,78913,18.15394,434688
4221,boehb-efs,3,0.00069,78916,18.15463,434688
4222,BohdanKalytka,3,0.00069,78919,18.15532,434688
4223,bonetoy,3,0.00069,78922,18.15601,434688
4224,BPJ94487,3,0.00069,78925,18.15670,434688
4225,bputt-e,3,0.00069,78928,18.15739,434688
4226,bradyben,3,0.00069,78931,18.15808,434688
4227,brakmic,3,0.00069,78934,18.15877,434688
4228,bramk,3,0.00069,78937,18.15946,434688
4229,brandonLyonCf,3,0.00069,78940,18.16015,434688
4230,brentschneider,3,0.00069,78943,18.16084,434688
4231,Brian-Wuest,3,0.00069,78946,18.16153,434688
4232,brunoluiz,3,0.00069,78949,18.16222,434688
4233,bruth,3,0.00069,78952,18.16291,434688
4234,bsda,3,0.00069,78955,18.16360,434688
4235,B-Souty,3,0.00069,78958,18.16429,434688
4236,bstrdsmkr,3,0.00069,78961,18.16498,434688
4237,bth8939,3,0.00069,78964,18.16567,434688
4238,budimanjojo,3,0.00069,78967,18.16636,434688
4239,buptubuntu,3,0.00069,78970,18.16705,434688
4240,bwoebi,3,0.00069,78973,18.16774,434688
4241,cah-jyoti-prakash,3,0.00069,78976,18.16843,434688
4242,caizhifeng,3,0.00069,78979,18.16912,434688
4243,caleygoff-invitae,3,0.00069,78982,18.16981,434688
4244,calmh,3,0.00069,78985,18.17050,434688
4245,canidam,3,0.00069,78988,18.17119,434688
4246,cartmast,3,0.00069,78991,18.17188,434688
4247,cartucciam,3,0.00069,78994,18.17257,434688
4248,CashWilliams,3,0.00069,78997,18.17326,434688
4249,c-bata,3,0.00069,79000,18.17395,434688
4250,cbradley857lw,3,0.00069,79003,18.17464,434688
4251,ccccbjcn,3,0.00069,79006,18.17533,434688
4252,cdvv7788,3,0.00069,79009,18.17603,434688
4253,ceclinux,3,0.00069,79012,18.17672,434688
4254,cesarandreslopez,3,0.00069,79015,18.17741,434688
4255,cesarkohl,3,0.00069,79018,18.17810,434688
4256,chancegraff,3,0.00069,79021,18.17879,434688
4257,chandankashyap19,3,0.00069,79024,18.17948,434688
4258,CharesLee,3,0.00069,79027,18.18017,434688
4259,charleech,3,0.00069,79030,18.18086,434688
4260,charlesdrews,3,0.00069,79033,18.18155,434688
4261,charleslin-appd,3,0.00069,79036,18.18224,434688
4262,CharlesQQ,3,0.00069,79039,18.18293,434688
4263,charlie-haley,3,0.00069,79042,18.18362,434688
4264,CharlieReitzel,3,0.00069,79045,18.18431,434688
4265,chasekiefer,3,0.00069,79048,18.18500,434688
4266,chatla-telekom,3,0.00069,79051,18.18569,434688
4267,Checksumz,3,0.00069,79054,18.18638,434688
4268,Chenzhi-vivo,3,0.00069,79057,18.18707,434688
4269,chessman,3,0.00069,79060,18.18776,434688
4270,chgl,3,0.00069,79063,18.18845,434688
4271,ChiefInnovator,3,0.00069,79066,18.18914,434688
4272,chinaboy007,3,0.00069,79069,18.18983,434688
4273,chjtwork,3,0.00069,79072,18.19052,434688
4274,choeffer,3,0.00069,79075,18.19121,434688
4275,choppedpork,3,0.00069,79078,18.19190,434688
4276,choudhary1996,3,0.00069,79081,18.19259,434688
4277,choutone,3,0.00069,79084,18.19328,434688
4278,ChrisChinchilla,3,0.00069,79087,18.19397,434688
4279,chrisk314,3,0.00069,79090,18.19466,434688
4280,christianlafleur,3,0.00069,79093,18.19535,434688
4281,chrisxuwq,3,0.00069,79096,18.19604,434688
4282,chuegel,3,0.00069,79099,18.19673,434688
4283,chullybun,3,0.00069,79102,18.19742,434688
4284,chunter0,3,0.00069,79105,18.19811,434688
4285,ciis0,3,0.00069,79108,18.19880,434688
4286,cikupin,3,0.00069,79111,18.19949,434688
4287,cimnine,3,0.00069,79114,18.20018,434688
4288,circlehddev,3,0.00069,79117,18.20087,434688
4289,circy9,3,0.00069,79120,18.20156,434688
4290,cjconrad2,3,0.00069,79123,18.20225,434688
4291,cjose3,3,0.00069,79126,18.20294,434688
4292,cjprinse,3,0.00069,79129,18.20363,434688
4293,Clayton7510,3,0.00069,79132,18.20432,434688
4294,clebio,3,0.00069,79135,18.20501,434688
4295,ClemOzil,3,0.00069,79138,18.20570,434688
4296,cobexer,3,0.00069,79141,18.20639,434688
4297,codeJack,3,0.00069,79144,18.20708,434688
4298,codingrhythm,3,0.00069,79147,18.20777,434688
4299,coding-to-music,3,0.00069,79150,18.20846,434688
4300,colbyguan,3,0.00069,79153,18.20915,434688
4301,comius,3,0.00069,79156,18.20984,434688
4302,contrun,3,0.00069,79159,18.21053,434688
4303,copolycube,3,0.00069,79162,18.21122,434688
4304,Corgi-Google,3,0.00069,79165,18.21191,434688
4305,corhere,3,0.00069,79168,18.21260,434688
4306,cork,3,0.00069,79171,18.21329,434688
4307,corradomatt,3,0.00069,79174,18.21398,434688
4308,cparik,3,0.00069,79177,18.21467,434688
4309,cqx820,3,0.00069,79180,18.21536,434688
4310,crawforde,3,0.00069,79183,18.21605,434688
4311,CrawX,3,0.00069,79186,18.21674,434688
4312,crookedstorm,3,0.00069,79189,18.21743,434688
4313,csams,3,0.00069,79192,18.21812,434688
4314,ctienshi,3,0.00069,79195,18.21881,434688
4315,ctrought,3,0.00069,79198,18.21950,434688
4316,cunningr,3,0.00069,79201,18.22019,434688
4317,CyberHippo,3,0.00069,79204,18.22088,434688
4318,cycwll,3,0.00069,79207,18.22158,434688
4319,cyliu0,3,0.00069,79210,18.22227,434688
4320,cyrax111,3,0.00069,79213,18.22296,434688
4321,D1abloRUS,3,0.00069,79216,18.22365,434688
4322,dadorf,3,0.00069,79219,18.22434,434688
4323,daemon1024,3,0.00069,79222,18.22503,434688
4324,dahrens,3,0.00069,79225,18.22572,434688
4325,dajulia3,3,0.00069,79228,18.22641,434688
4326,dakky,3,0.00069,79231,18.22710,434688
4327,DalianisDim,3,0.00069,79234,18.22779,434688
4328,damiankopyto,3,0.00069,79237,18.22848,434688
4329,damiendawreck,3,0.00069,79240,18.22917,434688
4330,dandan2095,3,0.00069,79243,18.22986,434688
4331,danielburrell,3,0.00069,79246,18.23055,434688
4332,daniel-levin,3,0.00069,79249,18.23124,434688
4333,DanielQujun,3,0.00069,79252,18.23193,434688
4334,danielrodriguez,3,0.00069,79255,18.23262,434688
4335,danijak,3,0.00069,79258,18.23331,434688
4336,danilobatistaqueiroz,3,0.00069,79261,18.23400,434688
4337,danludwig-happymoney,3,0.00069,79264,18.23469,434688
4338,dan-m8t,3,0.00069,79267,18.23538,434688
4339,dant24,3,0.00069,79270,18.23607,434688
4340,Dapperton-prog,3,0.00069,79273,18.23676,434688
4341,darox,3,0.00069,79276,18.23745,434688
4342,darxkies,3,0.00069,79279,18.23814,434688
4343,datoml,3,0.00069,79282,18.23883,434688
4344,DaveWHarvey,3,0.00069,79285,18.23952,434688
4345,dave-yotta,3,0.00069,79288,18.24021,434688
4346,davidarmstronglewis,3,0.00069,79291,18.24090,434688
4347,david-forster10,3,0.00069,79294,18.24159,434688
4348,davidhay1969,3,0.00069,79297,18.24228,434688
4349,davidhoelzel,3,0.00069,79300,18.24297,434688
4350,david-mcdonagh,3,0.00069,79303,18.24366,434688
4351,davidmlentz,3,0.00069,79306,18.24435,434688
4352,davidvuong,3,0.00069,79309,18.24504,434688
4353,DavidZemon,3,0.00069,79312,18.24573,434688
4354,davinkevin,3,0.00069,79315,18.24642,434688
4355,DaviPtrs,3,0.00069,79318,18.24711,434688
4356,davur,3,0.00069,79321,18.24780,434688
4357,dawgwe1,3,0.00069,79324,18.24849,434688
4358,dbuos,3,0.00069,79327,18.24918,434688
4359,dcherman,3,0.00069,79330,18.24987,434688
4360,dctwan,3,0.00069,79333,18.25056,434688
4361,deamwork,3,0.00069,79336,18.25125,434688
4362,DebakelOrakel,3,0.00069,79339,18.25194,434688
4363,debbyku,3,0.00069,79342,18.25263,434688
4364,debek,3,0.00069,79345,18.25332,434688
4365,debo19,3,0.00069,79348,18.25401,434688
4366,dedale,3,0.00069,79351,18.25470,434688
4367,deejross,3,0.00069,79354,18.25539,434688
4368,deepaksinghvi,3,0.00069,79357,18.25608,434688
4369,Delgus,3,0.00069,79360,18.25677,434688
4370,DennisGlindhart,3,0.00069,79363,18.25746,434688
4371,depfish,3,0.00069,79366,18.25815,434688
4372,derekkraan,3,0.00069,79369,18.25884,434688
4373,dfallert-rcd,3,0.00069,79372,18.25953,434688
4374,dhasek00,3,0.00069,79375,18.26022,434688
4375,dhnikolas,3,0.00069,79378,18.26091,434688
4376,DiegoPomares,3,0.00069,79381,18.26160,434688
4377,diegosanchez,3,0.00069,79384,18.26229,434688
4378,Dietmar1963,3,0.00069,79387,18.26298,434688
4379,dikshant,3,0.00069,79390,18.26367,434688
4380,dinotoa,3,0.00069,79393,18.26436,434688
4381,diogolessa,3,0.00069,79396,18.26505,434688
4382,dionysius,3,0.00069,79399,18.26574,434688
4383,dipen-epi,3,0.00069,79402,18.26643,434688
4384,Div95,3,0.00069,79405,18.26712,434688
4385,djgraff209,3,0.00069,79408,18.26782,434688
4386,dmarkhas,3,0.00069,79411,18.26851,434688
4387,dmatscale,3,0.00069,79414,18.26920,434688
4388,DmitriyStoyanov,3,0.00069,79417,18.26989,434688
4389,dmorgan81,3,0.00069,79420,18.27058,434688
4390,dmrogers7,3,0.00069,79423,18.27127,434688
4391,dodiadodia,3,0.00069,79426,18.27196,434688
4392,dolevf,3,0.00069,79429,18.27265,434688
4393,dominikrose-leanix,3,0.00069,79432,18.27334,434688
4394,dong-jh,3,0.00069,79435,18.27403,434688
4395,dorroddorrod,3,0.00069,79438,18.27472,434688
4396,doubletao318,3,0.00069,79441,18.27541,434688
4397,DoumLaberge,3,0.00069,79444,18.27610,434688
4398,dovholuknf,3,0.00069,79447,18.27679,434688
4399,doyelese,3,0.00069,79450,18.27748,434688
4400,dozer47528,3,0.00069,79453,18.27817,434688
4401,dR3b,3,0.00069,79456,18.27886,434688
4402,DrackThor,3,0.00069,79459,18.27955,434688
4403,DreamEagle0,3,0.00069,79462,18.28024,434688
4404,dsalaza4,3,0.00069,79465,18.28093,434688
4405,dschunack,3,0.00069,79468,18.28162,434688
4406,dullest,3,0.00069,79471,18.28231,434688
4407,durd07,3,0.00069,79474,18.28300,434688
4408,durprasa,3,0.00069,79477,18.28369,434688
4409,duwanqiebi,3,0.00069,79480,18.28438,434688
4410,dweebo,3,0.00069,79483,18.28507,434688
4411,dwgillies-bluescape,3,0.00069,79486,18.28576,434688
4412,e96wic,3,0.00069,79489,18.28645,434688
4413,EasonHe,3,0.00069,79492,18.28714,434688
4414,echisan,3,0.00069,79495,18.28783,434688
4415,edef1c,3,0.00069,79498,18.28852,434688
4416,ede-n,3,0.00069,79501,18.28921,434688
4417,ediezh,3,0.00069,79504,18.28990,434688
4418,edjmao,3,0.00069,79507,18.29059,434688
4419,Edvard-D,3,0.00069,79510,18.29128,434688
4420,ehdieunguyen,3,0.00069,79513,18.29197,434688
4421,EIP-Laurent,3,0.00069,79516,18.29266,434688
4422,elcaafm,3,0.00069,79519,18.29335,434688
4423,elChipardo,3,0.00069,79522,18.29404,434688
4424,electron0zero,3,0.00069,79525,18.29473,434688
4425,elig-salt,3,0.00069,79528,18.29542,434688
4426,elkanatovey,3,0.00069,79531,18.29611,434688
4427,elliotfehr,3,0.00069,79534,18.29680,434688
4428,elmodeer,3,0.00069,79537,18.29749,434688
4429,elrosar,3,0.00069,79540,18.29818,434688
4430,eltociear,3,0.00069,79543,18.29887,434688
4431,emcay,3,0.00069,79546,18.29956,434688
4432,emi662002,3,0.00069,79549,18.30025,434688
4433,emillg,3,0.00069,79552,18.30094,434688
4434,enajeeb,3,0.00069,79555,18.30163,434688
4435,eonward37,3,0.00069,79558,18.30232,434688
4436,EricoCartmanez,3,0.00069,79561,18.30301,434688
4437,erikdw,3,0.00069,79564,18.30370,434688
4438,erikeverts,3,0.00069,79567,18.30439,434688
4439,erkules,3,0.00069,79570,18.30508,434688
4440,ErmakovDmitriy,3,0.00069,79573,18.30577,434688
4441,erockwood,3,0.00069,79576,18.30646,434688
4442,Eronana,3,0.00069,79579,18.30715,434688
4443,es1o,3,0.00069,79582,18.30784,434688
4444,esenmx,3,0.00069,79585,18.30853,434688
4445,es-sz,3,0.00069,79588,18.30922,434688
4446,etavene,3,0.00069,79591,18.30991,434688
4447,Ethan9909,3,0.00069,79594,18.31060,434688
4448,euskadi31,3,0.00069,79597,18.31129,434688
4449,EvgeniiTitov,3,0.00069,79600,18.31198,434688
4450,explorercpp,3,0.00069,79603,18.31267,434688
4451,extbe,3,0.00069,79606,18.31336,434688
4452,fafucoder,3,0.00069,79609,18.31406,434688
4453,Falcon0009,3,0.00069,79612,18.31475,434688
4454,Falimonda,3,0.00069,79615,18.31544,434688
4455,falondarville,3,0.00069,79618,18.31613,434688
4456,farawaychen,3,0.00069,79621,18.31682,434688
4457,Fattouh92,3,0.00069,79624,18.31751,434688
4458,febus982,3,0.00069,79627,18.31820,434688
4459,FeiYing9,3,0.00069,79630,18.31889,434688
4460,felixfontein,3,0.00069,79633,18.31958,434688
4461,fengzhibin,3,0.00069,79636,18.32027,434688
4462,fffffreedom,3,0.00069,79639,18.32096,434688
4463,fgascon,3,0.00069,79642,18.32165,434688
4464,fhitchen,3,0.00069,79645,18.32234,434688
4465,fhopfensperger,3,0.00069,79648,18.32303,434688
4466,fighterhit,3,0.00069,79651,18.32372,434688
4467,firaxis,3,0.00069,79654,18.32441,434688
4468,firstPole,3,0.00069,79657,18.32510,434688
4469,florentinvintila,3,0.00069,79660,18.32579,434688
4470,floydjones1,3,0.00069,79663,18.32648,434688
4471,FlxPeters,3,0.00069,79666,18.32717,434688
4472,fombico,3,0.00069,79669,18.32786,434688
4473,fosterchuck,3,0.00069,79672,18.32855,434688
4474,fotos,3,0.00069,79675,18.32924,434688
4475,fowlerp-qlik,3,0.00069,79678,18.32993,434688
4476,francoran,3,0.00069,79681,18.33062,434688
4477,franitel,3,0.00069,79684,18.33131,434688
4478,fredthomsen,3,0.00069,79687,18.33200,434688
4479,freym,3,0.00069,79690,18.33269,434688
4480,fr-finnova,3,0.00069,79693,18.33338,434688
4481,FromageBlue,3,0.00069,79696,18.33407,434688
4482,fungusakafungus,3,0.00069,79699,18.33476,434688
4483,furkee,3,0.00069,79702,18.33545,434688
4484,FuyuanChu,3,0.00069,79705,18.33614,434688
4485,fvigotti,3,0.00069,79708,18.33683,434688
4486,fvlaicu,3,0.00069,79711,18.33752,434688
4487,fynluk,3,0.00069,79714,18.33821,434688
4488,fyrestone,3,0.00069,79717,18.33890,434688
4489,g3kr,3,0.00069,79720,18.33959,434688
4490,gabecazares-cc,3,0.00069,79723,18.34028,434688
4491,gadekarnitesh,3,0.00069,79726,18.34097,434688
4492,gadiener,3,0.00069,79729,18.34166,434688
4493,gagansingh355,3,0.00069,79732,18.34235,434688
4494,gAmUssA,3,0.00069,79735,18.34304,434688
4495,gaojinhao,3,0.00069,79738,18.34373,434688
4496,GarfieldHuang,3,0.00069,79741,18.34442,434688
4497,gautamk,3,0.00069,79744,18.34511,434688
4498,gavol,3,0.00069,79747,18.34580,434688
4499,gcaracuel,3,0.00069,79750,18.34649,434688
4500,gdubroeucq,3,0.00069,79753,18.34718,434688
4501,genemat,3,0.00069,79756,18.34787,434688
4502,genisd,3,0.00069,79759,18.34856,434688
4503,geokb,3,0.00069,79762,18.34925,434688
4504,geotransformer,3,0.00069,79765,18.34994,434688
4505,geowalrus4gh,3,0.00069,79768,18.35063,434688
4506,germanodasilva,3,0.00069,79771,18.35132,434688
4507,GeroL,3,0.00069,79774,18.35201,434688
4508,gerwim,3,0.00069,79777,18.35270,434688
4509,getpawarful,3,0.00069,79780,18.35339,434688
4510,gfrntz,3,0.00069,79783,18.35408,434688
4511,ggprod,3,0.00069,79786,18.35477,434688
4512,gholliday100,3,0.00069,79789,18.35546,434688
4513,gilesknap,3,0.00069,79792,18.35615,434688
4514,gitaferber2,3,0.00069,79795,18.35684,434688
4515,GitHubxsy,3,0.00069,79798,18.35753,434688
4516,glego,3,0.00069,79801,18.35822,434688
4517,glenjamin,3,0.00069,79804,18.35891,434688
4518,GlowingRuby,3,0.00069,79807,18.35961,434688
4519,gmaquinay,3,0.00069,79810,18.36030,434688
4520,GodSpeedXI,3,0.00069,79813,18.36099,434688
4521,golgotow,3,0.00069,79816,18.36168,434688
4522,gperezivo,3,0.00069,79819,18.36237,434688
4523,gpodila-disc,3,0.00069,79822,18.36306,434688
4524,Granjow,3,0.00069,79825,18.36375,434688
4525,gravesm,3,0.00069,79828,18.36444,434688
4526,greaterthanmost,3,0.00069,79831,18.36513,434688
4527,greglangford,3,0.00069,79834,18.36582,434688
4528,gregnsk,3,0.00069,79837,18.36651,434688
4529,Gregordy,3,0.00069,79840,18.36720,434688
4530,grishy,3,0.00069,79843,18.36789,434688
4531,grobza,3,0.00069,79846,18.36858,434688
4532,grsmith-projects,3,0.00069,79849,18.36927,434688
4533,grubint,3,0.00069,79852,18.36996,434688
4534,GTB3NW,3,0.00069,79855,18.37065,434688
4535,gtskaushik,3,0.00069,79858,18.37134,434688
4536,guanchaoli,3,0.00069,79861,18.37203,434688
4537,GuilleAmutio,3,0.00069,79864,18.37272,434688
4538,gunjasal,3,0.00069,79867,18.37341,434688
4539,guy-frontegg,3,0.00069,79870,18.37410,434688
4540,guyluz11,3,0.00069,79873,18.37479,434688
4541,guyneedhamcanva,3,0.00069,79876,18.37548,434688
4542,gwatts,3,0.00069,79879,18.37617,434688
4543,gwohletz,3,0.00069,79882,18.37686,434688
4544,h0lk,3,0.00069,79885,18.37755,434688
4545,h807892124,3,0.00069,79888,18.37824,434688
4546,haihongren,3,0.00069,79891,18.37893,434688
4547,hainesc,3,0.00069,79894,18.37962,434688
4548,HamidEDD,3,0.00069,79897,18.38031,434688
4549,hamzy,3,0.00069,79900,18.38100,434688
4550,Hanaasagi,3,0.00069,79903,18.38169,434688
4551,haoguangyu,3,0.00069,79906,18.38238,434688
4552,hardboiled,3,0.00069,79909,18.38307,434688
4553,hardy4yooz,3,0.00069,79912,18.38376,434688
4554,harnitsignalfx,3,0.00069,79915,18.38445,434688
4555,harridu,3,0.00069,79918,18.38514,434688
4556,harrylepotter-win,3,0.00069,79921,18.38583,434688
4557,haugom,3,0.00069,79924,18.38652,434688
4558,Hayk96,3,0.00069,79927,18.38721,434688
4559,hazcod,3,0.00069,79930,18.38790,434688
4560,hdv,3,0.00069,79933,18.38859,434688
4561,headconnect,3,0.00069,79936,18.38928,434688
4562,heartTorres,3,0.00069,79939,18.38997,434688
4563,heckler1,3,0.00069,79942,18.39066,434688
4564,HeGaoYuan,3,0.00069,79945,18.39135,434688
4565,HehuiGu,3,0.00069,79948,18.39204,434688
4566,Hemant-Sadana,3,0.00069,79951,18.39273,434688
4567,HeMinzhang,3,0.00069,79954,18.39342,434688
4568,herewasmike,3,0.00069,79957,18.39411,434688
4569,hgovindh86,3,0.00069,79960,18.39480,434688
4570,HimanshuZinzuwadia,3,0.00069,79963,18.39549,434688
4571,Himkwok,3,0.00069,79966,18.39618,434688
4572,hiqsociety,3,0.00069,79969,18.39687,434688
4573,HirokoMatsumoto-novade,3,0.00069,79972,18.39756,434688
4574,hobaen,3,0.00069,79975,18.39825,434688
4575,hollander-cegeka,3,0.00069,79978,18.39894,434688
4576,HontoNoRoger,3,0.00069,79981,18.39963,434688
4577,HouseoLogy,3,0.00069,79984,18.40032,434688
4578,howels,3,0.00069,79987,18.40101,434688
4579,hpple,3,0.00069,79990,18.40170,434688
4580,hqsh,3,0.00069,79993,18.40239,434688
4581,hryamzik,3,0.00069,79996,18.40308,434688
4582,huangchong94,3,0.00069,79999,18.40377,434688
4583,huangfangfeng,3,0.00069,80002,18.40446,434688
4584,huangp0600,3,0.00069,80005,18.40515,434688
4585,HubbeKing,3,0.00069,80008,18.40585,434688
4586,hugoShaka,3,0.00069,80011,18.40654,434688
4587,hui-maker,3,0.00069,80014,18.40723,434688
4588,huizengaJoe,3,0.00069,80017,18.40792,434688
4589,hurongyang,3,0.00069,80020,18.40861,434688
4590,hykych,3,0.00069,80023,18.40930,434688
4591,hylkevds,3,0.00069,80026,18.40999,434688
4592,hzh0425,3,0.00069,80029,18.41068,434688
4593,iambryancs,3,0.00069,80032,18.41137,434688
4594,ibihim,3,0.00069,80035,18.41206,434688
4595,ieaves,3,0.00069,80038,18.41275,434688
4596,ii64,3,0.00069,80041,18.41344,434688
4597,ikarol-gomel-iba-by,3,0.00069,80044,18.41413,434688
4598,ikuanyshbekov,3,0.00069,80047,18.41482,434688
4599,ilikeorangutans,3,0.00069,80050,18.41551,434688
4600,ilovechai,3,0.00069,80053,18.41620,434688
4601,IlyaKiselevKolibri,3,0.00069,80056,18.41689,434688
4602,indigo-saito,3,0.00069,80059,18.41758,434688
4603,IndraWiradinataK,3,0.00069,80062,18.41827,434688
4604,IngussNeilands,3,0.00069,80065,18.41896,434688
4605,invy,3,0.00069,80068,18.41965,434688
4606,ioannissavvaidis,3,0.00069,80071,18.42034,434688
4607,iocumine,3,0.00069,80074,18.42103,434688
4608,ioquatix,3,0.00069,80077,18.42172,434688
4609,irfanrizkiantopratama,3,0.00069,80080,18.42241,434688
4610,irsayvid,3,0.00069,80083,18.42310,434688
4611,isopov,3,0.00069,80086,18.42379,434688
4612,iss0,3,0.00069,80089,18.42448,434688
4613,Itachi666,3,0.00069,80092,18.42517,434688
4614,iuli72an,3,0.00069,80095,18.42586,434688
4615,IwoTens,3,0.00069,80098,18.42655,434688
4616,j021006,3,0.00069,80101,18.42724,434688
4617,jabdoa2,3,0.00069,80104,18.42793,434688
4618,jackila,3,0.00069,80107,18.42862,434688
4619,jacksenechal,3,0.00069,80110,18.42931,434688
4620,JackZxj,3,0.00069,80113,18.43000,434688
4621,jahredhope,3,0.00069,80116,18.43069,434688
4622,JameKeal,3,0.00069,80119,18.43138,434688
4623,jameschoa,3,0.00069,80122,18.43207,434688
4624,jamesrenaud,3,0.00069,80125,18.43276,434688
4625,JamesXNelson,3,0.00069,80128,18.43345,434688
4626,jandubois,3,0.00069,80131,18.43414,434688
4627,Jan-EC,3,0.00069,80134,18.43483,434688
4628,Janiaje,3,0.00069,80137,18.43552,434688
4629,JanScheurich,3,0.00069,80140,18.43621,434688
4630,jaredstehler,3,0.00069,80143,18.43690,434688
4631,jarrettprosser,3,0.00069,80146,18.43759,434688
4632,JasonRD,3,0.00069,80149,18.43828,434688
4633,jayair,3,0.00069,80152,18.43897,434688
4634,jaya-rama,3,0.00069,80155,18.43966,434688
4635,jayasai470,3,0.00069,80158,18.44035,434688
4636,jay-manday,3,0.00069,80161,18.44104,434688
4637,jaymebrd,3,0.00069,80164,18.44173,434688
4638,jaywlm,3,0.00069,80167,18.44242,434688
4639,jberger,3,0.00069,80170,18.44311,434688
4640,jbgachot,3,0.00069,80173,18.44380,434688
4641,Jblomart,3,0.00069,80176,18.44449,434688
4642,jbyers19,3,0.00069,80179,18.44518,434688
4643,jcberleur,3,0.00069,80182,18.44587,434688
4644,jchoi926,3,0.00069,80185,18.44656,434688
4645,jclab-joseph,3,0.00069,80188,18.44725,434688
4646,jddexxx,3,0.00069,80191,18.44794,434688
4647,jdhmtl,3,0.00069,80194,18.44863,434688
4648,JeepNL,3,0.00069,80197,18.44932,434688
4649,jeet129,3,0.00069,80200,18.45001,434688
4650,jeevanjoseph,3,0.00069,80203,18.45070,434688
4651,jeffzoch,3,0.00069,80206,18.45140,434688
4652,jeiroa,3,0.00069,80209,18.45209,434688
4653,jelinek-wgs,3,0.00069,80212,18.45278,434688
4654,jeloba,3,0.00069,80215,18.45347,434688
4655,jerome-quere,3,0.00069,80218,18.45416,434688
4656,JervyShi,3,0.00069,80221,18.45485,434688
4657,jgauth,3,0.00069,80224,18.45554,434688
4658,jgrund,3,0.00069,80227,18.45623,434688
4659,JHogue-80,3,0.00069,80230,18.45692,434688
4660,jianglei-els,3,0.00069,80233,18.45761,434688
4661,jianglu6,3,0.00069,80236,18.45830,434688
4662,jiaqiluo,3,0.00069,80239,18.45899,434688
4663,jimmymccrory,3,0.00069,80242,18.45968,434688
4664,jinlongchen,3,0.00069,80245,18.46037,434688
4665,jinnzy,3,0.00069,80248,18.46106,434688
4666,jinxin-fu,3,0.00069,80251,18.46175,434688
4667,jithkaringada-corp,3,0.00069,80254,18.46244,434688
4668,jj-2020,3,0.00069,80257,18.46313,434688
4669,jketcham,3,0.00069,80260,18.46382,434688
4670,jmariller,3,0.00069,80263,18.46451,434688
4671,jmjohnson-slalom,3,0.00069,80266,18.46520,434688
4672,jmprovencher,3,0.00069,80269,18.46589,434688
4673,jnswindle,3,0.00069,80272,18.46658,434688
4674,joakime,3,0.00069,80275,18.46727,434688
4675,JoelKlint,3,0.00069,80278,18.46796,434688
4676,joeyberkovitz,3,0.00069,80281,18.46865,434688
4677,johnnybigert,3,0.00069,80284,18.46934,434688
4678,johnnyrun,3,0.00069,80287,18.47003,434688
4679,joker-joker-joker,3,0.00069,80290,18.47072,434688
4680,jonathantullett,3,0.00069,80293,18.47141,434688
4681,joncfoo,3,0.00069,80296,18.47210,434688
4682,Jonpez2,3,0.00069,80299,18.47279,434688
4683,jorgemarey,3,0.00069,80302,18.47348,434688
4684,jorikseldeslachts,3,0.00069,80305,18.47417,434688
4685,josefschabasser,3,0.00069,80308,18.47486,434688
4686,jotasixto,3,0.00069,80311,18.47555,434688
4687,joubertredrat,3,0.00069,80314,18.47624,434688
4688,joyartoun,3,0.00069,80317,18.47693,434688
4689,JParisR,3,0.00069,80320,18.47762,434688
4690,jplouis,3,0.00069,80323,18.47831,434688
4691,j-poecher,3,0.00069,80326,18.47900,434688
4692,JPRbrs,3,0.00069,80329,18.47969,434688
4693,jracollins,3,0.00069,80332,18.48038,434688
4694,jrdi,3,0.00069,80335,18.48107,434688
4695,Jsalas424,3,0.00069,80338,18.48176,434688
4696,jsinghuy,3,0.00069,80341,18.48245,434688
4697,jtai-omniex,3,0.00069,80344,18.48314,434688
4698,jtstrohl,3,0.00069,80347,18.48383,434688
4699,juanfescobar,3,0.00069,80350,18.48452,434688
4700,juergenzimmermann,3,0.00069,80353,18.48521,434688
4701,juicycool92,3,0.00069,80356,18.48590,434688
4702,julianahrens,3,0.00069,80359,18.48659,434688
4703,julianwilkinson,3,0.00069,80362,18.48728,434688
4704,JulianZhang,3,0.00069,80365,18.48797,434688
4705,junm-cloudnatix,3,0.00069,80368,18.48866,434688
4706,JunweiSUN,3,0.00069,80371,18.48935,434688
4707,jurgen-weber-deltatre,3,0.00069,80374,18.49004,434688
4708,jurkrit,3,0.00069,80377,18.49073,434688
4709,justadogistaken,3,0.00069,80380,18.49142,434688
4710,justknife,3,0.00069,80383,18.49211,434688
4711,ka1em,3,0.00069,80386,18.49280,434688
4712,kadooster,3,0.00069,80389,18.49349,434688
4713,kaegoorn,3,0.00069,80392,18.49418,434688
4714,kaijchen,3,0.00069,80395,18.49487,434688
4715,kakaZhou719,3,0.00069,80398,18.49556,434688
4716,kamtschatka,3,0.00069,80401,18.49625,434688
4717,Karlah28,3,0.00069,80404,18.49694,434688
4718,kartikdc,3,0.00069,80407,18.49764,434688
4719,Kashalls,3,0.00069,80410,18.49833,434688
4720,kaustubhsharma-009,3,0.00069,80413,18.49902,434688
4721,Keforix,3,0.00069,80416,18.49971,434688
4722,KellyBennett,3,0.00069,80419,18.50040,434688
4723,KennyLindahl,3,0.00069,80422,18.50109,434688
4724,kerberjg,3,0.00069,80425,18.50178,434688
4725,kettlereve,3,0.00069,80428,18.50247,434688
4726,kevgrig,3,0.00069,80431,18.50316,434688
4727,kevincasier,3,0.00069,80434,18.50385,434688
4728,kevinquillen,3,0.00069,80437,18.50454,434688
4729,Keyhoh,3,0.00069,80440,18.50523,434688
4730,kgibm,3,0.00069,80443,18.50592,434688
4731,khatrig,3,0.00069,80446,18.50661,434688
4732,kierajost4,3,0.00069,80449,18.50730,434688
4733,kieron-dev,3,0.00069,80452,18.50799,434688
4734,kimba74,3,0.00069,80455,18.50868,434688
4735,kir4h,3,0.00069,80458,18.50937,434688
4736,kiran-jsk,3,0.00069,80461,18.51006,434688
4737,kirito-236,3,0.00069,80464,18.51075,434688
4738,kjvellajr,3,0.00069,80467,18.51144,434688
4739,knowhoper,3,0.00069,80470,18.51213,434688
4740,kodeninja,3,0.00069,80473,18.51282,434688
4741,KoelhoSec,3,0.00069,80476,18.51351,434688
4742,koivunen,3,0.00069,80479,18.51420,434688
4743,kongwu-,3,0.00069,80482,18.51489,434688
4744,Konig-Corey,3,0.00069,80485,18.51558,434688
4745,konnase,3,0.00069,80488,18.51627,434688
4746,korenlev,3,0.00069,80491,18.51696,434688
4747,krahil,3,0.00069,80494,18.51765,434688
4748,krishna2603,3,0.00069,80497,18.51834,434688
4749,Krishnacore,3,0.00069,80500,18.51903,434688
4750,krishnendudas1979,3,0.00069,80503,18.51972,434688
4751,krmao,3,0.00069,80506,18.52041,434688
4752,kryptonite303,3,0.00069,80509,18.52110,434688
4753,krzysiekg,3,0.00069,80512,18.52179,434688
4754,kuja53,3,0.00069,80515,18.52248,434688
4755,kumarshobhit,3,0.00069,80518,18.52317,434688
4756,kurimi1,3,0.00069,80521,18.52386,434688
4757,kurnal-volt,3,0.00069,80524,18.52455,434688
4758,kuzhao,3,0.00069,80527,18.52524,434688
4759,kviala,3,0.00069,80530,18.52593,434688
4760,KVInventoR,3,0.00069,80533,18.52662,434688
4761,kw4k10,3,0.00069,80536,18.52731,434688
4762,kycfeel,3,0.00069,80539,18.52800,434688
4763,kylerisse,3,0.00069,80542,18.52869,434688
4764,kyrieSun-wow,3,0.00069,80545,18.52938,434688
4765,kzu,3,0.00069,80548,18.53007,434688
4766,L3T,3,0.00069,80551,18.53076,434688
4767,lalanikarim,3,0.00069,80554,18.53145,434688
4768,lari002,3,0.00069,80557,18.53214,434688
4769,larryclaman,3,0.00069,80560,18.53283,434688
4770,LarsAC,3,0.00069,80563,18.53352,434688
4771,lazouz,3,0.00069,80566,18.53421,434688
4772,lbm,3,0.00069,80569,18.53490,434688
4773,leehuoche,3,0.00069,80572,18.53559,434688
4774,leikang123,3,0.00069,80575,18.53628,434688
4775,LeiZhang-Hunter,3,0.00069,80578,18.53697,434688
4776,leonheld,3,0.00069,80581,18.53766,434688
4777,leoxhj,3,0.00069,80584,18.53835,434688
4778,LERSONG,3,0.00069,80587,18.53904,434688
4779,lessmian,3,0.00069,80590,18.53973,434688
4780,Leteong,3,0.00069,80593,18.54042,434688
4781,lewiscowleschipuk,3,0.00069,80596,18.54111,434688
4782,liangdong1992,3,0.00069,80599,18.54180,434688
4783,liangjingtao11,3,0.00069,80602,18.54249,434688
4784,lic17,3,0.00069,80605,18.54318,434688
4785,lidh15,3,0.00069,80608,18.54388,434688
4786,LiginGeorge,3,0.00069,80611,18.54457,434688
4787,likangjian01,3,0.00069,80614,18.54526,434688
4788,linyinli,3,0.00069,80617,18.54595,434688
4789,liogate,3,0.00069,80620,18.54664,434688
4790,lionelJi,3,0.00069,80623,18.54733,434688
4791,liornabat,3,0.00069,80626,18.54802,434688
4792,liranr23,3,0.00069,80629,18.54871,434688
4793,lirantal,3,0.00069,80632,18.54940,434688
4794,littleant1111,3,0.00069,80635,18.55009,434688
4795,LittleFall,3,0.00069,80638,18.55078,434688
4796,littlehell,3,0.00069,80641,18.55147,434688
4797,litvindev,3,0.00069,80644,18.55216,434688
4798,liutaot,3,0.00069,80647,18.55285,434688
4799,LiuYuHui,3,0.00069,80650,18.55354,434688
4800,LiYiPeng-1,3,0.00069,80653,18.55423,434688
4801,llauderesv,3,0.00069,80656,18.55492,434688
4802,lmercl,3,0.00069,80659,18.55561,434688
4803,longrunningprocess,3,0.00069,80662,18.55630,434688
4804,LoonyRules,3,0.00069,80665,18.55699,434688
4805,Lordnibbler,3,0.00069,80668,18.55768,434688
4806,loujaybee,3,0.00069,80671,18.55837,434688
4807,lousyd,3,0.00069,80674,18.55906,434688
4808,lromor,3,0.00069,80677,18.55975,434688
4809,lspringer,3,0.00069,80680,18.56044,434688
4810,ltdonner,3,0.00069,80683,18.56113,434688
4811,LU-386,3,0.00069,80686,18.56182,434688
4812,lucacome,3,0.00069,80689,18.56251,434688
4813,ludurr,3,0.00069,80692,18.56320,434688
4814,LuisMLGDev,3,0.00069,80695,18.56389,434688
4815,luizhlelis,3,0.00069,80698,18.56458,434688
4816,luizrojo,3,0.00069,80701,18.56527,434688
4817,lukasgomez,3,0.00069,80704,18.56596,434688
4818,lukyer,3,0.00069,80707,18.56665,434688
4819,luodw,3,0.00069,80710,18.56734,434688
4820,luohaixiannz,3,0.00069,80713,18.56803,434688
4821,lweberru,3,0.00069,80716,18.56872,434688
4822,lwmxiaobei,3,0.00069,80719,18.56941,434688
4823,LyleXu,3,0.00069,80722,18.57010,434688
4824,LynnOwens,3,0.00069,80725,18.57079,434688
4825,M0rdecay,3,0.00069,80728,18.57148,434688
4826,m1,3,0.00069,80731,18.57217,434688
4827,m3nthal,3,0.00069,80734,18.57286,434688
4828,maartenvdezz,3,0.00069,80737,18.57355,434688
4829,maheshsmc5,3,0.00069,80740,18.57424,434688
4830,Mahi-coding,3,0.00069,80743,18.57493,434688
4831,mahudees,3,0.00069,80746,18.57562,434688
4832,mailhari,3,0.00069,80749,18.57631,434688
4833,majidsd,3,0.00069,80752,18.57700,434688
4834,majinghe,3,0.00069,80755,18.57769,434688
4835,malletgaetan,3,0.00069,80758,18.57838,434688
4836,mallikarjunraju,3,0.00069,80761,18.57907,434688
4837,Mamba1981,3,0.00069,80764,18.57976,434688
4838,mandre,3,0.00069,80767,18.58045,434688
4839,maneeshmehra,3,0.00069,80770,18.58114,434688
4840,mano233,3,0.00069,80773,18.58183,434688
4841,mans0954,3,0.00069,80776,18.58252,434688
4842,manu12miskin,3,0.00069,80779,18.58321,434688
4843,maorleger,3,0.00069,80782,18.58390,434688
4844,maoueh,3,0.00069,80785,18.58459,434688
4845,maoyangLiu,3,0.00069,80788,18.58528,434688
4846,marcoalban-hidalgo,3,0.00069,80791,18.58597,434688
4847,marlenekoh,3,0.00069,80794,18.58666,434688
4848,marrem,3,0.00069,80797,18.58735,434688
4849,martialblog,3,0.00069,80800,18.58804,434688
4850,martindekov,3,0.00069,80803,18.58873,434688
4851,martinothamar,3,0.00069,80806,18.58943,434688
4852,martin-schaefer,3,0.00069,80809,18.59012,434688
4853,MartLTB,3,0.00069,80812,18.59081,434688
4854,massimo-coletti,3,0.00069,80815,18.59150,434688
4855,MasterOdin,3,0.00069,80818,18.59219,434688
4856,MatanAmoyal,3,0.00069,80821,18.59288,434688
4857,matancarmeli7,3,0.00069,80824,18.59357,434688
4858,MatthewDolan,3,0.00069,80827,18.59426,434688
4859,matthewmrichter,3,0.00069,80830,18.59495,434688
4860,matthiasgubler,3,0.00069,80833,18.59564,434688
4861,mattjo,3,0.00069,80836,18.59633,434688
4862,mattwelke,3,0.00069,80839,18.59702,434688
4863,MaximGurschi,3,0.00069,80842,18.59771,434688
4864,maxlein,3,0.00069,80845,18.59840,434688
4865,mayankmahajan,3,0.00069,80848,18.59909,434688
4866,mayerraphael,3,0.00069,80851,18.59978,434688
4867,mayuki,3,0.00069,80854,18.60047,434688
4868,MBaczun,3,0.00069,80857,18.60116,434688
4869,mbu93,3,0.00069,80860,18.60185,434688
4870,mbyio,3,0.00069,80863,18.60254,434688
4871,mdettelson,3,0.00069,80866,18.60323,434688
4872,mdharper,3,0.00069,80869,18.60392,434688
4873,mdrenger,3,0.00069,80872,18.60461,434688
4874,Meghana-12,3,0.00069,80875,18.60530,434688
4875,mehran-prs,3,0.00069,80878,18.60599,434688
4876,MeijerM1,3,0.00069,80881,18.60668,434688
4877,mfamador,3,0.00069,80884,18.60737,434688
4878,mf-lit,3,0.00069,80887,18.60806,434688
4879,mfmbarros,3,0.00069,80890,18.60875,434688
4880,MGBtrust,3,0.00069,80893,18.60944,434688
4881,mhavelant,3,0.00069,80896,18.61013,434688
4882,mheers,3,0.00069,80899,18.61082,434688
4883,mhelkey,3,0.00069,80902,18.61151,434688
4884,miaoqingli,3,0.00069,80905,18.61220,434688
4885,michael-baraboo-datastax,3,0.00069,80908,18.61289,434688
4886,michaelhongsam,3,0.00069,80911,18.61358,434688
4887,michaelli321,3,0.00069,80914,18.61427,434688
4888,michaellzc,3,0.00069,80917,18.61496,434688
4889,michaelpoellath,3,0.00069,80920,18.61565,434688
4890,michaelsproul,3,0.00069,80923,18.61634,434688
4891,michal-jagiello-tmpl,3,0.00069,80926,18.61703,434688
4892,middlestone,3,0.00069,80929,18.61772,434688
4893,mierzej91,3,0.00069,80932,18.61841,434688
4894,mihaimyh,3,0.00069,80935,18.61910,434688
4895,mihdih,3,0.00069,80938,18.61979,434688
4896,mijingling,3,0.00069,80941,18.62048,434688
4897,mikefox,3,0.00069,80944,18.62117,434688
4898,milica-nikolic,3,0.00069,80947,18.62186,434688
4899,mimizohar,3,0.00069,80950,18.62255,434688
4900,Mindtoeye,3,0.00069,80953,18.62324,434688
4901,minight,3,0.00069,80956,18.62393,434688
4902,MioOgbeni,3,0.00069,80959,18.62462,434688
4903,Mixermachine,3,0.00069,80962,18.62531,434688
4904,mjpowersjr,3,0.00069,80965,18.62600,434688
4905,mjrist,3,0.00069,80968,18.62669,434688
4906,mkopinsky,3,0.00069,80971,18.62738,434688
4907,mkridzelis,3,0.00069,80974,18.62807,434688
4908,mkrull,3,0.00069,80977,18.62876,434688
4909,mmayeda,3,0.00069,80980,18.62945,434688
4910,mmckane,3,0.00069,80983,18.63014,434688
4911,mmelyp,3,0.00069,80986,18.63083,434688
4912,mmerickel,3,0.00069,80989,18.63152,434688
4913,mofanke,3,0.00069,80992,18.63221,434688
4914,MohammadRVR,3,0.00069,80995,18.63290,434688
4915,mohanchazz,3,0.00069,80998,18.63359,434688
4916,mohit1795,3,0.00069,81001,18.63428,434688
4917,mojoa,3,0.00069,81004,18.63497,434688
4918,moltenice,3,0.00069,81007,18.63567,434688
4919,momania,3,0.00069,81010,18.63636,434688
4920,Montatip16,3,0.00069,81013,18.63705,434688
4921,mosdav,3,0.00069,81016,18.63774,434688
4922,moshe-shahar,3,0.00069,81019,18.63843,434688
4923,moshey1,3,0.00069,81022,18.63912,434688
4924,mouhsen-ibrahim,3,0.00069,81025,18.63981,434688
4925,mozillazg,3,0.00069,81028,18.64050,434688
4926,mper0003,3,0.00069,81031,18.64119,434688
4927,mprolaz,3,0.00069,81034,18.64188,434688
4928,MrKrisKrisu,3,0.00069,81037,18.64257,434688
4929,mrksngl,3,0.00069,81040,18.64326,434688
4930,mrnonz,3,0.00069,81043,18.64395,434688
4931,mschuwalow,3,0.00069,81046,18.64464,434688
4932,mseverin,3,0.00069,81049,18.64533,434688
4933,mshekharee,3,0.00069,81052,18.64602,434688
4934,msinghal34,3,0.00069,81055,18.64671,434688
4935,msmarks,3,0.00069,81058,18.64740,434688
4936,MukulKolpe,3,0.00069,81061,18.64809,434688
4937,multimac,3,0.00069,81064,18.64878,434688
4938,mupasak,3,0.00069,81067,18.64947,434688
4939,muralaris,3,0.00069,81070,18.65016,434688
4940,mustiikhalil,3,0.00069,81073,18.65085,434688
4941,mutescent,3,0.00069,81076,18.65154,434688
4942,m-v-k,3,0.00069,81079,18.65223,434688
4943,MWoscek,3,0.00069,81082,18.65292,434688
4944,mycloudedu,3,0.00069,81085,18.65361,434688
4945,mynameborat,3,0.00069,81088,18.65430,434688
4946,myvelmurugan,3,0.00069,81091,18.65499,434688
4947,Mzhiing,3,0.00069,81094,18.65568,434688
4948,n0v1,3,0.00069,81097,18.65637,434688
4949,naaly17,3,0.00069,81100,18.65706,434688
4950,nabiladoui,3,0.00069,81103,18.65775,434688
4951,Nair-Sunil,3,0.00069,81106,18.65844,434688
4952,Name-X,3,0.00069,81109,18.65913,434688
4953,nandakumar-sre,3,0.00069,81112,18.65982,434688
4954,nanorobocop,3,0.00069,81115,18.66051,434688
4955,napathome,3,0.00069,81118,18.66120,434688
4956,nasir-rabbani,3,0.00069,81121,18.66189,434688
4957,natChr-OL,3,0.00069,81124,18.66258,434688
4958,nathansgreen,3,0.00069,81127,18.66327,434688
4959,nee1esh,3,0.00069,81130,18.66396,434688
4960,negrel,3,0.00069,81133,18.66465,434688
4961,Neilblaze,3,0.00069,81136,18.66534,434688
4962,neilkane,3,0.00069,81139,18.66603,434688
4963,NersesAM,3,0.00069,81142,18.66672,434688
4964,networkingana,3,0.00069,81145,18.66741,434688
4965,netwrk197,3,0.00069,81148,18.66810,434688
4966,newhuangchuan,3,0.00069,81151,18.66879,434688
4967,NeXT405,3,0.00069,81154,18.66948,434688
4968,nexustar,3,0.00069,81157,18.67017,434688
4969,ngauje,3,0.00069,81160,18.67086,434688
4970,ngoluuduythai,3,0.00069,81163,18.67155,434688
4971,nibirrayy,3,0.00069,81166,18.67224,434688
4972,nickgerace,3,0.00069,81169,18.67293,434688
4973,nick-oconnor,3,0.00069,81172,18.67362,434688
4974,nicolas-goudry,3,0.00069,81175,18.67431,434688
4975,nidiculageorge,3,0.00069,81178,18.67500,434688
4976,nielsvanderbeke,3,0.00069,81181,18.67569,434688
4977,NikolaNemes,3,0.00069,81184,18.67638,434688
4978,ninjaprox,3,0.00069,81187,18.67707,434688
4979,nishidhaSri,3,0.00069,81190,18.67776,434688
4980,NitichaiSawangsai,3,0.00069,81193,18.67845,434688
4981,nitish1986,3,0.00069,81196,18.67914,434688
4982,nitrag,3,0.00069,81199,18.67983,434688
4983,nitrocode,3,0.00069,81202,18.68052,434688
4984,noel-rapido,3,0.00069,81205,18.68122,434688
4985,nomanuddin,3,0.00069,81208,18.68191,434688
4986,Nosmoht,3,0.00069,81211,18.68260,434688
4987,notcool11,3,0.00069,81214,18.68329,434688
4988,notklaatu,3,0.00069,81217,18.68398,434688
4989,novoselskiy,3,0.00069,81220,18.68467,434688
4990,NOWYOU,3,0.00069,81223,18.68536,434688
4991,nuka137,3,0.00069,81226,18.68605,434688
4992,nurhun,3,0.00069,81229,18.68674,434688
4993,nwmcsween,3,0.00069,81232,18.68743,434688
4994,o099408,3,0.00069,81235,18.68812,434688
4995,obockows,3,0.00069,81238,18.68881,434688
4996,ObserverYu,3,0.00069,81241,18.68950,434688
4997,occelebi,3,0.00069,81244,18.69019,434688
4998,ofir-shapira-como,3,0.00069,81247,18.69088,434688
4999,ohmyglb,3,0.00069,81250,18.69157,434688
5000,olegy2008,3,0.00069,81253,18.69226,434688
5001,olemathias,3,0.00069,81256,18.69295,434688
5002,olundin,3,0.00069,81259,18.69364,434688
5003,ondrejkolin,3,0.00069,81262,18.69433,434688
5004,orangetangerine,3,0.00069,81265,18.69502,434688
5005,osaffer,3,0.00069,81268,18.69571,434688
5006,OscarLuu,3,0.00069,81271,18.69640,434688
5007,osela,3,0.00069,81274,18.69709,434688
5008,osg-grafana,3,0.00069,81277,18.69778,434688
5009,osilkin98,3,0.00069,81280,18.69847,434688
5010,osit78,3,0.00069,81283,18.69916,434688
5011,ouroboros8,3,0.00069,81286,18.69985,434688
5012,oursland,3,0.00069,81289,18.70054,434688
5013,outsideris,3,0.00069,81292,18.70123,434688
5014,owenmarinas,3,0.00069,81295,18.70192,434688
5015,p1ass,3,0.00069,81298,18.70261,434688
5016,Padarn,3,0.00069,81301,18.70330,434688
5017,pangsq,3,0.00069,81304,18.70399,434688
5018,papapumpnz,3,0.00069,81307,18.70468,434688
5019,parisni,3,0.00069,81310,18.70537,434688
5020,parthyadav3105,3,0.00069,81313,18.70606,434688
5021,patelsaheb29,3,0.00069,81316,18.70675,434688
5022,patrickhuy,3,0.00069,81319,18.70744,434688
5023,PatrikHysky,3,0.00069,81322,18.70813,434688
5024,paulbsch,3,0.00069,81325,18.70882,434688
5025,PaulFurtado,3,0.00069,81328,18.70951,434688
5026,paul-lupu,3,0.00069,81331,18.71020,434688
5027,PauloFavero,3,0.00069,81334,18.71089,434688
5028,PauloGDPeixoto,3,0.00069,81337,18.71158,434688
5029,PavanVasisht29,3,0.00069,81340,18.71227,434688
5030,PayalSasmal10,3,0.00069,81343,18.71296,434688
5031,paynejacob,3,0.00069,81346,18.71365,434688
5032,pcairns,3,0.00069,81349,18.71434,434688
5033,pealtrufo,3,0.00069,81352,18.71503,434688
5034,peiniliu,3,0.00069,81355,18.71572,434688
5035,penthaapatel,3,0.00069,81358,18.71641,434688
5036,Pete-PlaytimeSolutions,3,0.00069,81361,18.71710,434688
5037,peterhurley-meraki,3,0.00069,81364,18.71779,434688
5038,petershaw,3,0.00069,81367,18.71848,434688
5039,petrkohut,3,0.00069,81370,18.71917,434688
5040,petr-ujezdsky,3,0.00069,81373,18.71986,434688
5041,pgalache,3,0.00069,81376,18.72055,434688
5042,PhdLoLi,3,0.00069,81379,18.72124,434688
5043,philanton,3,0.00069,81382,18.72193,434688
5044,PhilippB21,3,0.00069,81385,18.72262,434688
5045,philipszalla,3,0.00069,81388,18.72331,434688
5046,philnalwalker,3,0.00069,81391,18.72400,434688
5047,phsys,3,0.00069,81394,18.72469,434688
5048,piepmatz,3,0.00069,81397,18.72538,434688
5049,PieterVanZyl-Dev,3,0.00069,81400,18.72607,434688
5050,pigLoveRabbit520,3,0.00069,81403,18.72676,434688
5051,pipeworks-asmith,3,0.00069,81406,18.72746,434688
5052,piwi3910,3,0.00069,81409,18.72815,434688
5053,pjamenaja,3,0.00069,81412,18.72884,434688
5054,pjgg,3,0.00069,81415,18.72953,434688
5055,pkilar,3,0.00069,81418,18.73022,434688
5056,PKizzle,3,0.00069,81421,18.73091,434688
5057,plauko,3,0.00069,81424,18.73160,434688
5058,playerx,3,0.00069,81427,18.73229,434688
5059,pmbanugo,3,0.00069,81430,18.73298,434688
5060,pmgk07,3,0.00069,81433,18.73367,434688
5061,pomverte,3,0.00069,81436,18.73436,434688
5062,portsip,3,0.00069,81439,18.73505,434688
5063,potiuk,3,0.00069,81442,18.73574,434688
5064,pozsgaic,3,0.00069,81445,18.73643,434688
5065,p-palanis,3,0.00069,81448,18.73712,434688
5066,prashant3863,3,0.00069,81451,18.73781,434688
5067,Prashanth-BP,3,0.00069,81454,18.73850,434688
5068,prasunsultania,3,0.00069,81457,18.73919,434688
5069,pratimsc,3,0.00069,81460,18.73988,434688
5070,Pravenn18,3,0.00069,81463,18.74057,434688
5071,Premfer,3,0.00069,81466,18.74126,434688
5072,princeliang,3,0.00069,81469,18.74195,434688
5073,prokher,3,0.00069,81472,18.74264,434688
5074,pshahonica,3,0.00069,81475,18.74333,434688
5075,pssvenkatrao,3,0.00069,81478,18.74402,434688
5076,pturanyi,3,0.00069,81481,18.74471,434688
5077,pwschuurman,3,0.00069,81484,18.74540,434688
5078,qas,3,0.00069,81487,18.74609,434688
5079,qgervacio,3,0.00069,81490,18.74678,434688
5080,qhua948,3,0.00069,81493,18.74747,434688
5081,qiandu2006,3,0.00069,81496,18.74816,434688
5082,qlisc,3,0.00069,81499,18.74885,434688
5083,qmloong,3,0.00069,81502,18.74954,434688
5084,qRoC,3,0.00069,81505,18.75023,434688
5085,qwertyp4nts,3,0.00069,81508,18.75092,434688
5086,raghulkrishna,3,0.00069,81511,18.75161,434688
5087,ragsarang,3,0.00069,81514,18.75230,434688
5088,rahultokase,3,0.00069,81517,18.75299,434688
5089,rajar0201,3,0.00069,81520,18.75368,434688
5090,rajdeep2001,3,0.00069,81523,18.75437,434688
5091,rajesh-u,3,0.00069,81526,18.75506,434688
5092,ralf0131,3,0.00069,81529,18.75575,434688
5093,rammanavalan,3,0.00069,81532,18.75644,434688
5094,RamyChaabane,3,0.00069,81535,18.75713,434688
5095,ran-huang,3,0.00069,81538,18.75782,434688
5096,raspitakesovertheworld,3,0.00069,81541,18.75851,434688
5097,raul1991,3,0.00069,81544,18.75920,434688
5098,rbrandino1,3,0.00069,81547,18.75989,434688
5099,RCarretta,3,0.00069,81550,18.76058,434688
5100,rduan,3,0.00069,81553,18.76127,434688
5101,red8888,3,0.00069,81556,18.76196,434688
5102,reggie-k,3,0.00069,81559,18.76265,434688
5103,remm,3,0.00069,81562,18.76334,434688
5104,renehonig,3,0.00069,81565,18.76403,434688
5105,renepardon,3,0.00069,81568,18.76472,434688
5106,rguarnotta,3,0.00069,81571,18.76541,434688
5107,rhishikeshj,3,0.00069,81574,18.76610,434688
5108,rhjanders,3,0.00069,81577,18.76679,434688
5109,ricjhill,3,0.00069,81580,18.76748,434688
5110,ricosega,3,0.00069,81583,18.76817,434688
5111,RiddlerKnight,3,0.00069,81586,18.76886,434688
5112,RinaisSuper,3,0.00069,81589,18.76955,434688
5113,Rishabhraghwendra18,3,0.00069,81592,18.77024,434688
5114,risicle,3,0.00069,81595,18.77093,434688
5115,rissson,3,0.00069,81598,18.77162,434688
5116,ritchiekng,3,0.00069,81601,18.77231,434688
5117,Rits333,3,0.00069,81604,18.77301,434688
5118,riturajx,3,0.00069,81607,18.77370,434688
5119,rizvaughan,3,0.00069,81610,18.77439,434688
5120,rjhuijsman,3,0.00069,81613,18.77508,434688
5121,RK-GITHUB,3,0.00069,81616,18.77577,434688
5122,rlabrecque,3,0.00069,81619,18.77646,434688
5123,rlaveycal,3,0.00069,81622,18.77715,434688
5124,rleiwang,3,0.00069,81625,18.77784,434688
5125,rmros,3,0.00069,81628,18.77853,434688
5126,rmvangun,3,0.00069,81631,18.77922,434688
5127,Ro0tk1t,3,0.00069,81634,18.77991,434688
5128,robbrucks,3,0.00069,81637,18.78060,434688
5129,robertsben,3,0.00069,81640,18.78129,434688
5130,rodiongork-genestack,3,0.00069,81643,18.78198,434688
5131,roelarents,3,0.00069,81646,18.78267,434688
5132,rohrit,3,0.00069,81649,18.78336,434688
5133,roim,3,0.00069,81652,18.78405,434688
5134,rolanderdei,3,0.00069,81655,18.78474,434688
5135,R-omk,3,0.00069,81658,18.78543,434688
5136,romuloscampini,3,0.00069,81661,18.78612,434688
5137,Roneri75,3,0.00069,81664,18.78681,434688
5138,ros0x5Ft,3,0.00069,81667,18.78750,434688
5139,roygbip,3,0.00069,81670,18.78819,434688
5140,rposts,3,0.00069,81673,18.78888,434688
5141,rsheasby,3,0.00069,81676,18.78957,434688
5142,rsmets,3,0.00069,81679,18.79026,434688
5143,rsommer,3,0.00069,81682,18.79095,434688
5144,rs-tas,3,0.00069,81685,18.79164,434688
5145,rszabolcs,3,0.00069,81688,18.79233,434688
5146,rthamrin,3,0.00069,81691,18.79302,434688
5147,rubinus,3,0.00069,81694,18.79371,434688
5148,ruicao93,3,0.00069,81697,18.79440,434688
5149,rupang790,3,0.00069,81700,18.79509,434688
5150,Rupesh-Darimisetti,3,0.00069,81703,18.79578,434688
5151,RusAdrianC,3,0.00069,81706,18.79647,434688
5152,rweilg,3,0.00069,81709,18.79716,434688
5153,ryanaross,3,0.00069,81712,18.79785,434688
5154,ryneal,3,0.00069,81715,18.79854,434688
5155,ryuichi1208,3,0.00069,81718,18.79923,434688
5156,Sabuhi1,3,0.00069,81721,18.79992,434688
5157,sachinjoshi72,3,0.00069,81724,18.80061,434688
5158,sailorgallifrey,3,0.00069,81727,18.80130,434688
5159,saketrp,3,0.00069,81730,18.80199,434688
5160,saltxwater,3,0.00069,81733,18.80268,434688
5161,samelie,3,0.00069,81736,18.80337,434688
5162,samidbb,3,0.00069,81739,18.80406,434688
5163,samitpal,3,0.00069,81742,18.80475,434688
5164,samiurrehman92,3,0.00069,81745,18.80544,434688
5165,samuelBB,3,0.00069,81748,18.80613,434688
5166,sanathkumarbs,3,0.00069,81751,18.80682,434688
5167,sandal-maker,3,0.00069,81754,18.80751,434688
5168,sandipb,3,0.00069,81757,18.80820,434688
5169,Sanhajio,3,0.00069,81760,18.80889,434688
5170,sanjivsharmalv,3,0.00069,81763,18.80958,434688
5171,santoshkumarpatro23,3,0.00069,81766,18.81027,434688
5172,sanusatyadarshi,3,0.00069,81769,18.81096,434688
5173,sanwishe,3,0.00069,81772,18.81165,434688
5174,sarumont,3,0.00069,81775,18.81234,434688
5175,sascha-eglau-phx,3,0.00069,81778,18.81303,434688
5176,sateekot,3,0.00069,81781,18.81372,434688
5177,sathishc58,3,0.00069,81784,18.81441,434688
5178,savanipoojan78,3,0.00069,81787,18.81510,434688
5179,Sayanta66,3,0.00069,81790,18.81579,434688
5180,SAY-droid427,3,0.00069,81793,18.81648,434688
5181,sbrivio-rh,3,0.00069,81796,18.81717,434688
5182,sbrunk,3,0.00069,81799,18.81786,434688
5183,sbrunner,3,0.00069,81802,18.81855,434688
5184,sbunce,3,0.00069,81805,18.81925,434688
5185,scarlet25151,3,0.00069,81808,18.81994,434688
5186,scharissis-wx,3,0.00069,81811,18.82063,434688
5187,schealex,3,0.00069,81814,18.82132,434688
5188,schizoid90,3,0.00069,81817,18.82201,434688
5189,schmurfy,3,0.00069,81820,18.82270,434688
5190,schneems,3,0.00069,81823,18.82339,434688
5191,schuerle,3,0.00069,81826,18.82408,434688
5192,scythargon,3,0.00069,81829,18.82477,434688
5193,sdwire,3,0.00069,81832,18.82546,434688
5194,seaguest,3,0.00069,81835,18.82615,434688
5195,seanchann,3,0.00069,81838,18.82684,434688
5196,seanlnx,3,0.00069,81841,18.82753,434688
5197,SebTardif,3,0.00069,81844,18.82822,434688
5198,sechunOH,3,0.00069,81847,18.82891,434688
5199,sekhrivijay,3,0.00069,81850,18.82960,434688
5200,Seneli,3,0.00069,81853,18.83029,434688
5201,senthil13,3,0.00069,81856,18.83098,434688
5202,SeptoDog,3,0.00069,81859,18.83167,434688
5203,Sepush,3,0.00069,81862,18.83236,434688
5204,setchy,3,0.00069,81865,18.83305,434688
5205,sethjones,3,0.00069,81868,18.83374,434688
5206,seven1240,3,0.00069,81871,18.83443,434688
5207,sfhl,3,0.00069,81874,18.83512,434688
5208,shahafy-ma,3,0.00069,81877,18.83581,434688
5209,shanzi,3,0.00069,81880,18.83650,434688
5210,sharmarajdaksh,3,0.00069,81883,18.83719,434688
5211,sharpevo,3,0.00069,81886,18.83788,434688
5212,sharpjs,3,0.00069,81889,18.83857,434688
5213,shellfu,3,0.00069,81892,18.83926,434688
5214,shellyyang1989,3,0.00069,81895,18.83995,434688
5215,shenmuxiaosen,3,0.00069,81898,18.84064,434688
5216,sherifabdlnaby,3,0.00069,81901,18.84133,434688
5217,shield-9,3,0.00069,81904,18.84202,434688
5218,ShinyAnnie,3,0.00069,81907,18.84271,434688
5219,shivaburade,3,0.00069,81910,18.84340,434688
5220,shivrajjadhav733,3,0.00069,81913,18.84409,434688
5221,shmyer,3,0.00069,81916,18.84478,434688
5222,shoopdedoop,3,0.00069,81919,18.84547,434688
5223,shortsn,3,0.00069,81922,18.84616,434688
5224,shrac,3,0.00069,81925,18.84685,434688
5225,shriamrut,3,0.00069,81928,18.84754,434688
5226,shubhamrai1993,3,0.00069,81931,18.84823,434688
5227,shubinmi,3,0.00069,81934,18.84892,434688
5228,shukla2009,3,0.00069,81937,18.84961,434688
5229,shuoshadow,3,0.00069,81940,18.85030,434688
5230,siegenthalerroger,3,0.00069,81943,18.85099,434688
5231,sikkamukul,3,0.00069,81946,18.85168,434688
5232,simanwangSC,3,0.00069,81949,18.85237,434688
5233,simha5009,3,0.00069,81952,18.85306,434688
5234,SimoneLazzaris,3,0.00069,81955,18.85375,434688
5235,sinato,3,0.00069,81958,18.85444,434688
5236,sirakav,3,0.00069,81961,18.85513,434688
5237,sirkubax,3,0.00069,81964,18.85582,434688
5238,sjamidar,3,0.00069,81967,18.85651,434688
5239,sjortiz,3,0.00069,81970,18.85720,434688
5240,skadem07,3,0.00069,81973,18.85789,434688
5241,skaravad,3,0.00069,81976,18.85858,434688
5242,skattoju,3,0.00069,81979,18.85927,434688
5243,skgsergio,3,0.00069,81982,18.85996,434688
5244,skinny85,3,0.00069,81985,18.86065,434688
5245,skjoher,3,0.00069,81988,18.86134,434688
5246,sknopp,3,0.00069,81991,18.86203,434688
5247,skorobogatydmitry,3,0.00069,81994,18.86272,434688
5248,skowrons,3,0.00069,81997,18.86341,434688
5249,skupjoe,3,0.00069,82000,18.86410,434688
5250,skyrain,3,0.00069,82003,18.86479,434688
5251,Slach,3,0.00069,82006,18.86549,434688
5252,smartbit,3,0.00069,82009,18.86618,434688
5253,smartding,3,0.00069,82012,18.86687,434688
5254,smb-h,3,0.00069,82015,18.86756,434688
5255,sming,3,0.00069,82018,18.86825,434688
5256,smithdebug,3,0.00069,82021,18.86894,434688
5257,snehaM2210,3,0.00069,82024,18.86963,434688
5258,snOm3ad,3,0.00069,82027,18.87032,434688
5259,SoaadMahmoud,3,0.00069,82030,18.87101,434688
5260,sodul,3,0.00069,82033,18.87170,434688
5261,sokoide,3,0.00069,82036,18.87239,434688
5262,songlh,3,0.00069,82039,18.87308,434688
5263,song-liang,3,0.00069,82042,18.87377,434688
5264,songwenchaols,3,0.00069,82045,18.87446,434688
5265,song-zhang,3,0.00069,82048,18.87515,434688
5266,sonika-gautami,3,0.00069,82051,18.87584,434688
5267,soorajambadi,3,0.00069,82054,18.87653,434688
5268,Soprano74,3,0.00069,82057,18.87722,434688
5269,souhaiebtar,3,0.00069,82060,18.87791,434688
5270,SovakPaleny,3,0.00069,82063,18.87860,434688
5271,sp7infinity,3,0.00069,82066,18.87929,434688
5272,Spartan-65,3,0.00069,82069,18.87998,434688
5273,SpectralHiss,3,0.00069,82072,18.88067,434688
5274,squ94wk,3,0.00069,82075,18.88136,434688
5275,sreejesh123,3,0.00069,82078,18.88205,434688
5276,sreenuraghavan,3,0.00069,82081,18.88274,434688
5277,sriedel,3,0.00069,82084,18.88343,434688
5278,Srikrishnabh,3,0.00069,82087,18.88412,434688
5279,sspreitzer,3,0.00069,82090,18.88481,434688
5280,St0rmingBr4in,3,0.00069,82093,18.88550,434688
5281,stefaneberl,3,0.00069,82096,18.88619,434688
5282,stefanjacobs,3,0.00069,82099,18.88688,434688
5283,steinarvk-kolonial,3,0.00069,82102,18.88757,434688
5284,stevenbarlow,3,0.00069,82105,18.88826,434688
5285,Stevenyu1982,3,0.00069,82108,18.88895,434688
5286,stieglma,3,0.00069,82111,18.88964,434688
5287,stl-victor-sudakov,3,0.00069,82114,18.89033,434688
5288,sui77,3,0.00069,82117,18.89102,434688
5289,sumitbaurai,3,0.00069,82120,18.89171,434688
5290,sunbinzhu,3,0.00069,82123,18.89240,434688
5291,sundayfloweringPhoenix,3,0.00069,82126,18.89309,434688
5292,sunface,3,0.00069,82129,18.89378,434688
5293,sunilkhokalay,3,0.00069,82132,18.89447,434688
5294,sunng87,3,0.00069,82135,18.89516,434688
5295,Sun-V,3,0.00069,82138,18.89585,434688
5296,suprita23,3,0.00069,82141,18.89654,434688
5297,sureshballa,3,0.00069,82144,18.89723,434688
5298,sutyak,3,0.00069,82147,18.89792,434688
5299,svatwork,3,0.00069,82150,18.89861,434688
5300,Sven-bg,3,0.00069,82153,18.89930,434688
5301,swamat,3,0.00069,82156,18.89999,434688
5302,swright-eti,3,0.00069,82159,18.90068,434688
5303,sylvain-ri,3,0.00069,82162,18.90137,434688
5304,sysedwinistrator,3,0.00069,82165,18.90206,434688
5305,sysintelligent,3,0.00069,82168,18.90275,434688
5306,Szarny,3,0.00069,82171,18.90344,434688
5307,tabdulazim,3,0.00069,82174,18.90413,434688
5308,taehioum,3,0.00069,82177,18.90482,434688
5309,take,3,0.00069,82180,18.90551,434688
5310,TamasNeumer,3,0.00069,82183,18.90620,434688
5311,TannerGilbert,3,0.00069,82186,18.90689,434688
5312,taori,3,0.00069,82189,18.90758,434688
5313,tayloreisman16,3,0.00069,82192,18.90827,434688
5314,tbeets,3,0.00069,82195,18.90896,434688
5315,TCGOGOGO,3,0.00069,82198,18.90965,434688
5316,techdeba901,3,0.00069,82201,18.91034,434688
5317,TechnoChimp,3,0.00069,82204,18.91104,434688
5318,TedleyM-AVISPL,3,0.00069,82207,18.91173,434688
5319,Tejeev,3,0.00069,82210,18.91242,434688
5320,Teramaks,3,0.00069,82213,18.91311,434688
5321,TheBaus,3,0.00069,82216,18.91380,434688
5322,the-code-man,3,0.00069,82219,18.91449,434688
5323,thevinter,3,0.00069,82222,18.91518,434688
5324,thomasdbaker,3,0.00069,82225,18.91587,434688
5325,thorstenhuhn,3,0.00069,82228,18.91656,434688
5326,ThSchrad,3,0.00069,82231,18.91725,434688
5327,thyn,3,0.00069,82234,18.91794,434688
5328,tianxin8206,3,0.00069,82237,18.91863,434688
5329,Tiku24,3,0.00069,82240,18.91932,434688
5330,timbuchwaldt,3,0.00069,82243,18.92001,434688
5331,timcappalli,3,0.00069,82246,18.92070,434688
5332,TimShilov,3,0.00069,82249,18.92139,434688
5333,tinder-robertcheng,3,0.00069,82252,18.92208,434688
5334,TJDjchao,3,0.00069,82255,18.92277,434688
5335,tjjh89017,3,0.00069,82258,18.92346,434688
5336,tlcowling,3,0.00069,82261,18.92415,434688
5337,TobixDS,3,0.00069,82264,18.92484,434688
5338,tomas-mota,3,0.00069,82267,18.92553,434688
5339,Tomasz-Kluczkowski,3,0.00069,82270,18.92622,434688
5340,tomaszkolodziej,3,0.00069,82273,18.92691,434688
5341,tombokombo,3,0.00069,82276,18.92760,434688
5342,tom-odb,3,0.00069,82279,18.92829,434688
5343,tomsozolins,3,0.00069,82282,18.92898,434688
5344,tomsunyu,3,0.00069,82285,18.92967,434688
5345,TomTucka,3,0.00069,82288,18.93036,434688
5346,toymachiner62,3,0.00069,82291,18.93105,434688
5347,tppalani,3,0.00069,82294,18.93174,434688
5348,tRavAsty,3,0.00069,82297,18.93243,434688
5349,Treiblesschorle,3,0.00069,82300,18.93312,434688
5350,trentmurray,3,0.00069,82303,18.93381,434688
5351,triii10,3,0.00069,82306,18.93450,434688
5352,trishnendu,3,0.00069,82309,18.93519,434688
5353,trs4,3,0.00069,82312,18.93588,434688
5354,tscheepers,3,0.00069,82315,18.93657,434688
5355,tsndqst,3,0.00069,82318,18.93726,434688
5356,Tuhis,3,0.00069,82321,18.93795,434688
5357,tuommaki,3,0.00069,82324,18.93864,434688
5358,Turb0Fly,3,0.00069,82327,18.93933,434688
5359,Turgon37,3,0.00069,82330,18.94002,434688
5360,tushardas,3,0.00069,82333,18.94071,434688
5361,twon33,3,0.00069,82336,18.94140,434688
5362,Uehara96,3,0.00069,82339,18.94209,434688
5363,uhinze,3,0.00069,82342,18.94278,434688
5364,Ullaakut,3,0.00069,82345,18.94347,434688
5365,Ultimo12,3,0.00069,82348,18.94416,434688
5366,umairyounus,3,0.00069,82351,18.94485,434688
5367,UmarNeo,3,0.00069,82354,18.94554,434688
5368,uncycler,3,0.00069,82357,18.94623,434688
5369,unikzforce,3,0.00069,82360,18.94692,434688
5370,unreal-altran,3,0.00069,82363,18.94761,434688
5371,uralsemih,3,0.00069,82366,18.94830,434688
5372,uscwifi,3,0.00069,82369,18.94899,434688
5373,Usergitbit,3,0.00069,82372,18.94968,434688
5374,ustiugov,3,0.00069,82375,18.95037,434688
5375,VadimZy,3,0.00069,82378,18.95106,434688
5376,vakrat1,3,0.00069,82381,18.95175,434688
5377,valencetech,3,0.00069,82384,18.95244,434688
5378,ValeriiVozniuk,3,0.00069,82387,18.95313,434688
5379,vandersonmota,3,0.00069,82390,18.95382,434688
5380,vanillathunder1337,3,0.00069,82393,18.95451,434688
5381,vasuganireddy,3,0.00069,82396,18.95520,434688
5382,verycici,3,0.00069,82399,18.95589,434688
5383,Vespasian,3,0.00069,82402,18.95658,434688
5384,vglen,3,0.00069,82405,18.95728,434688
5385,vg-vaibhav,3,0.00069,82408,18.95797,434688
5386,victuos,3,0.00069,82411,18.95866,434688
5387,vierno,3,0.00069,82414,18.95935,434688
5388,vinayus,3,0.00069,82417,18.96004,434688
5389,virasatkhan,3,0.00069,82420,18.96073,434688
5390,vivek-yamsani,3,0.00069,82423,18.96142,434688
5391,vladimirkus,3,0.00069,82426,18.96211,434688
5392,vladislavPV,3,0.00069,82429,18.96280,434688
5393,VladRassokhin,3,0.00069,82432,18.96349,434688
5394,vlorc,3,0.00069,82435,18.96418,434688
5395,vnhirenko,3,0.00069,82438,18.96487,434688
5396,vossss,3,0.00069,82441,18.96556,434688
5397,vovando-pomelo,3,0.00069,82444,18.96625,434688
5398,VPeruS,3,0.00069,82447,18.96694,434688
5399,vpnachev,3,0.00069,82450,18.96763,434688
5400,vpranckaitis,3,0.00069,82453,18.96832,434688
5401,vv-grinko,3,0.00069,82456,18.96901,434688
5402,vvydier,3,0.00069,82459,18.96970,434688
5403,wa6smn,3,0.00069,82462,18.97039,434688
5404,wade19870531,3,0.00069,82465,18.97108,434688
5405,WaffleThief123,3,0.00069,82468,18.97177,434688
5406,wangyd1988,3,0.00069,82471,18.97246,434688
5407,warent,3,0.00069,82474,18.97315,434688
5408,WaynePN,3,0.00069,82477,18.97384,434688
5409,wayne-pq,3,0.00069,82480,18.97453,434688
5410,waynr,3,0.00069,82483,18.97522,434688
5411,wcecs,3,0.00069,82486,18.97591,434688
5412,Wenshiqi222,3,0.00069,82489,18.97660,434688
5413,wgitg,3,0.00069,82492,18.97729,434688
5414,whz11,3,0.00069,82495,18.97798,434688
5415,willfindlay,3,0.00069,82498,18.97867,434688
5416,windevkay,3,0.00069,82501,18.97936,434688
5417,wintonzheng,3,0.00069,82504,18.98005,434688
5418,wolfedale,3,0.00069,82507,18.98074,434688
5419,workman-Lu,3,0.00069,82510,18.98143,434688
5420,woyouwole2012,3,0.00069,82513,18.98212,434688
5421,wtchangdm,3,0.00069,82516,18.98281,434688
5422,wuchuxiong,3,0.00069,82519,18.98350,434688
5423,wuxingro,3,0.00069,82522,18.98419,434688
5424,wvxvw,3,0.00069,82525,18.98488,434688
5425,wwj-2017-1117,3,0.00069,82528,18.98557,434688
5426,wxing1292,3,0.00069,82531,18.98626,434688
5427,wyq984700527,3,0.00069,82534,18.98695,434688
5428,Wysselbie,3,0.00069,82537,18.98764,434688
5429,xamroc,3,0.00069,82540,18.98833,434688
5430,xanecs,3,0.00069,82543,18.98902,434688
5431,xavidram,3,0.00069,82546,18.98971,434688
5432,xhejtman,3,0.00069,82549,18.99040,434688
5433,xiaoyaocloud,3,0.00069,82552,18.99109,434688
5434,XingZYu,3,0.00069,82555,18.99178,434688
5435,xinyanw409,3,0.00069,82558,18.99247,434688
5436,xizhang919,3,0.00069,82561,18.99316,434688
5437,xkilian,3,0.00069,82564,18.99385,434688
5438,X-Mars,3,0.00069,82567,18.99454,434688
5439,xmsanchez,3,0.00069,82570,18.99523,434688
5440,xmskf,3,0.00069,82573,18.99592,434688
5441,xujiaja,3,0.00069,82576,18.99661,434688
5442,xuming-code,3,0.00069,82579,18.99730,434688
5443,Xushaohong,3,0.00069,82582,18.99799,434688
5444,YAMLcase,3,0.00069,82585,18.99868,434688
5445,yangruiray,3,0.00069,82588,18.99937,434688
5446,yangyangyyyplus,3,0.00069,82591,19.00006,434688
5447,yanivgel,3,0.00069,82594,19.00075,434688
5448,yan-lgtm,3,0.00069,82597,19.00144,434688
5449,Yapcheekian,3,0.00069,82600,19.00213,434688
5450,yartman,3,0.00069,82603,19.00283,434688
5451,yashwanth-l,3,0.00069,82606,19.00352,434688
5452,yasn77,3,0.00069,82609,19.00421,434688
5453,YAXILALIANGFEIFAN,3,0.00069,82612,19.00490,434688
5454,ydmao,3,0.00069,82615,19.00559,434688
5455,yehaifeng,3,0.00069,82618,19.00628,434688
5456,yene,3,0.00069,82621,19.00697,434688
5457,yeqown,3,0.00069,82624,19.00766,434688
5458,YesemKebede,3,0.00069,82627,19.00835,434688
5459,yhrunyk,3,0.00069,82630,19.00904,434688
5460,YiDing-Duke,3,0.00069,82633,19.00973,434688
5461,yishaihl,3,0.00069,82636,19.01042,434688
5462,ykizin,3,0.00069,82639,19.01111,434688
5463,ylmcr7,3,0.00069,82642,19.01180,434688
5464,yo000,3,0.00069,82645,19.01249,434688
5465,yogeshVU,3,0.00069,82648,19.01318,434688
5466,YoninL,3,0.00069,82651,19.01387,434688
5467,yosshi825,3,0.00069,82654,19.01456,434688
5468,younesehb,3,0.00069,82657,19.01525,434688
5469,Young-Zen,3,0.00069,82660,19.01594,434688
5470,youyuancode,3,0.00069,82663,19.01663,434688
5471,yquansah,3,0.00069,82666,19.01732,434688
5472,yriveiro,3,0.00069,82669,19.01801,434688
5473,yschimke,3,0.00069,82672,19.01870,434688
5474,yuchengwu,3,0.00069,82675,19.01939,434688
5475,YugReddy,3,0.00069,82678,19.02008,434688
5476,yuhaoliu77,3,0.00069,82681,19.02077,434688
5477,yujinqiu,3,0.00069,82684,19.02146,434688
5478,yukurt,3,0.00069,82687,19.02215,434688
5479,YuraHrunyk,3,0.00069,82690,19.02284,434688
5480,yuriyyakym,3,0.00069,82693,19.02353,434688
5481,YuxiaoHu,3,0.00069,82696,19.02422,434688
5482,yyt6200,3,0.00069,82699,19.02491,434688
5483,Zain-Muiz,3,0.00069,82702,19.02560,434688
5484,Zandrael,3,0.00069,82705,19.02629,434688
5485,zaval1976,3,0.00069,82708,19.02698,434688
5486,zbialik,3,0.00069,82711,19.02767,434688
5487,zdbasset,3,0.00069,82714,19.02836,434688
5488,ZeChArtiahSaher,3,0.00069,82717,19.02905,434688
5489,zees-dev,3,0.00069,82720,19.02974,434688
5490,Zeltserj,3,0.00069,82723,19.03043,434688
5491,zengyuxing007,3,0.00069,82726,19.03112,434688
5492,zero-below,3,0.00069,82729,19.03181,434688
5493,zgcbj,3,0.00069,82732,19.03250,434688
5494,zghyy,3,0.00069,82735,19.03319,434688
5495,zhangkun1117,3,0.00069,82738,19.03388,434688
5496,zhaytee,3,0.00069,82741,19.03457,434688
5497,zhengyuyzhao,3,0.00069,82744,19.03526,434688
5498,zhenk14,3,0.00069,82747,19.03595,434688
5499,ZhiXingHeYiApple,3,0.00069,82750,19.03664,434688
5500,zilin00,3,0.00069,82753,19.03733,434688
5501,zishen,3,0.00069,82756,19.03802,434688
5502,zjpersc,3,0.00069,82759,19.03871,434688
5503,zoechou,3,0.00069,82762,19.03940,434688
5504,zt185019,3,0.00069,82765,19.04009,434688
5505,zthomas2,3,0.00069,82768,19.04078,434688
5506,zubanst,3,0.00069,82771,19.04147,434688
5507,zulrang,3,0.00069,82774,19.04216,434688
5508,zv0n,3,0.00069,82777,19.04285,434688
5509,zwilling79,3,0.00069,82780,19.04354,434688
5510,zwiy,3,0.00069,82783,19.04423,434688
5511,zx8,3,0.00069,82786,19.04492,434688
5512,zxh19920616,3,0.00069,82789,19.04561,434688
5513,zxpower,3,0.00069,82792,19.04630,434688
5514,0400H,2,0.00046,82794,19.04676,434688
5515,0asp0,2,0.00046,82796,19.04722,434688
5516,0x0badc0de,2,0.00046,82798,19.04768,434688
5517,0xf10413,2,0.00046,82800,19.04814,434688
5518,0xRenegade,2,0.00046,82802,19.04860,434688
5519,100mik,2,0.00046,82804,19.04907,434688
5520,1231sadqwf,2,0.00046,82806,19.04953,434688
5521,13667285528,2,0.00046,82808,19.04999,434688
5522,15989206052,2,0.00046,82810,19.05045,434688
5523,2013kaa,2,0.00046,82812,19.05091,434688
5524,24king,2,0.00046,82814,19.05137,434688
5525,3deep5me,2,0.00046,82816,19.05183,434688
5526,66li,2,0.00046,82818,19.05229,434688
5527,6929400,2,0.00046,82820,19.05275,434688
5528,877087845,2,0.00046,82822,19.05321,434688
5529,89trillion-wenjie,2,0.00046,82824,19.05367,434688
5530,8none1,2,0.00046,82826,19.05413,434688
5531,aaabdallah,2,0.00046,82828,19.05459,434688
5532,aak74,2,0.00046,82830,19.05505,434688
5533,Aakankshagoyal0803,2,0.00046,82832,19.05551,434688
5534,aamagzoub,2,0.00046,82834,19.05597,434688
5535,aandrushchenko,2,0.00046,82836,19.05643,434688
5536,aangoulvant,2,0.00046,82838,19.05689,434688
5537,Aankhen,2,0.00046,82840,19.05735,434688
5538,AaronChelvan,2,0.00046,82842,19.05781,434688
5539,Aaron-ML,2,0.00046,82844,19.05827,434688
5540,aaronspruit,2,0.00046,82846,19.05873,434688
5541,aazon,2,0.00046,82848,19.05919,434688
5542,ab574,2,0.00046,82850,19.05965,434688
5543,AbdelmalekBen98,2,0.00046,82852,19.06011,434688
5544,abgn,2,0.00046,82854,19.06057,434688
5545,abhijitchaudhari1,2,0.00046,82856,19.06103,434688
5546,abhineettikoo,2,0.00046,82858,19.06149,434688
5547,abhisheksharma2805,2,0.00046,82860,19.06195,434688
5548,AbhyudayDixit,2,0.00046,82862,19.06241,434688
5549,abihf,2,0.00046,82864,19.06287,434688
5550,abiram1991,2,0.00046,82866,19.06333,434688
5551,abjoseph,2,0.00046,82868,19.06379,434688
5552,ableuler,2,0.00046,82870,19.06425,434688
5553,aboyanov,2,0.00046,82872,19.06471,434688
5554,abritpal,2,0.00046,82874,19.06517,434688
5555,achauvin-wish,2,0.00046,82876,19.06563,434688
5556,achimismaili,2,0.00046,82878,19.06609,434688
5557,aclements,2,0.00046,82880,19.06655,434688
5558,ACMoretxj,2,0.00046,82882,19.06701,434688
5559,acohen4,2,0.00046,82884,19.06747,434688
5560,Adaendra,2,0.00046,82886,19.06793,434688
5561,adamdyszy,2,0.00046,82888,19.06839,434688
5562,AddoSolutions,2,0.00046,82890,19.06885,434688
5563,aderuwe,2,0.00046,82892,19.06931,434688
5564,Adiii717,2,0.00046,82894,19.06977,434688
5565,aditighag,2,0.00046,82896,19.07023,434688
5566,adityati,2,0.00046,82898,19.07069,434688
5567,Adphi,2,0.00046,82900,19.07115,434688
5568,adrianbjordan,2,0.00046,82902,19.07161,434688
5569,adyanth,2,0.00046,82904,19.07207,434688
5570,afmyr,2,0.00046,82906,19.07253,434688
5571,afolarin,2,0.00046,82908,19.07299,434688
5572,aforAyush,2,0.00046,82910,19.07345,434688
5573,afsheen824,2,0.00046,82912,19.07391,434688
5574,agbanagba,2,0.00046,82914,19.07437,434688
5575,agritik89,2,0.00046,82916,19.07483,434688
5576,aguinet,2,0.00046,82918,19.07529,434688
5577,agustindaguerre,2,0.00046,82920,19.07575,434688
5578,ahelsley,2,0.00046,82922,19.07621,434688
5579,ahilsend,2,0.00046,82924,19.07667,434688
5580,ahmet2mir,2,0.00046,82926,19.07713,434688
5581,aivanov-citc,2,0.00046,82928,19.07759,434688
5582,AjayKumar4,2,0.00046,82930,19.07805,434688
5583,ajsaclayan,2,0.00046,82932,19.07851,434688
5584,akashagarwal7,2,0.00046,82934,19.07897,434688
5585,akath19,2,0.00046,82936,19.07943,434688
5586,akuster,2,0.00046,82938,19.07989,434688
5587,AlaaMouch,2,0.00046,82940,19.08035,434688
5588,aladrocMatiner,2,0.00046,82942,19.08081,434688
5589,AlanDavd,2,0.00046,82944,19.08127,434688
5590,alandovskis,2,0.00046,82946,19.08173,434688
5591,alanisaac,2,0.00046,82948,19.08219,434688
5592,alec-mccook,2,0.00046,82950,19.08265,434688
5593,alen-z,2,0.00046,82952,19.08311,434688
5594,alessio4tech,2,0.00046,82954,19.08357,434688
5595,alexal,2,0.00046,82956,19.08403,434688
5596,alexandresavicki,2,0.00046,82958,19.08449,434688
5597,Alex-Burmak,2,0.00046,82960,19.08495,434688
5598,AlexChenSkyBlue,2,0.00046,82962,19.08541,434688
5599,alexei-matveev,2,0.00046,82964,19.08587,434688
5600,alexeyerm,2,0.00046,82966,19.08633,434688
5601,AlexeyKukin,2,0.00046,82968,19.08679,434688
5602,AlexeyPirogov,2,0.00046,82970,19.08725,434688
5603,alexfanat86,2,0.00046,82972,19.08771,434688
5604,alexglyde,2,0.00046,82974,19.08817,434688
5605,alexisph,2,0.00046,82976,19.08863,434688
5606,alex-kovshovik,2,0.00046,82978,19.08909,434688
5607,alexnoz,2,0.00046,82980,19.08955,434688
5608,AlexShu88,2,0.00046,82982,19.09001,434688
5609,alex-vmw,2,0.00046,82984,19.09047,434688
5610,alippai,2,0.00046,82986,19.09093,434688
5611,allaboutopensource,2,0.00046,82988,19.09139,434688
5612,almson,2,0.00046,82990,19.09185,434688
5613,alniheli,2,0.00046,82992,19.09231,434688
5614,alochym01,2,0.00046,82994,19.09277,434688
5615,aloisiobilck,2,0.00046,82996,19.09323,434688
5616,AloysAugustin,2,0.00046,82998,19.09369,434688
5617,aloysius-lim,2,0.00046,83000,19.09415,434688
5618,alpha01,2,0.00046,83002,19.09461,434688
5619,Alphasaurs,2,0.00046,83004,19.09508,434688
5620,alstonzero,2,0.00046,83006,19.09554,434688
5621,alvarosanchez,2,0.00046,83008,19.09600,434688
5622,AlyssaBetty,2,0.00046,83010,19.09646,434688
5623,AmazingPangWei,2,0.00046,83012,19.09692,434688
5624,ame89,2,0.00046,83014,19.09738,434688
5625,ameerhu,2,0.00046,83016,19.09784,434688
5626,amishaCodes,2,0.00046,83018,19.09830,434688
5627,amit4257,2,0.00046,83020,19.09876,434688
5628,amitbhatia1987,2,0.00046,83022,19.09922,434688
5629,AmnaIrfan,2,0.00046,83024,19.09968,434688
5630,amoghrajesh,2,0.00046,83026,19.10014,434688
5631,amyangfei,2,0.00046,83028,19.10060,434688
5632,ananya26-vishnoi,2,0.00046,83030,19.10106,434688
5633,andreacoccodi,2,0.00046,83032,19.10152,434688
5634,andreatosato,2,0.00046,83034,19.10198,434688
5635,andreevgrisha,2,0.00046,83036,19.10244,434688
5636,andrewnazarov,2,0.00046,83038,19.10290,434688
5637,andrey-twic,2,0.00046,83040,19.10336,434688
5638,AndreyZaslavskiyWMG,2,0.00046,83042,19.10382,434688
5639,andy-g,2,0.00046,83044,19.10428,434688
5640,aneelmonangi,2,0.00046,83046,19.10474,434688
5641,aneeshusa,2,0.00046,83048,19.10520,434688
5642,angelala00,2,0.00046,83050,19.10566,434688
5643,ANGkeith,2,0.00046,83052,19.10612,434688
5644,anibali,2,0.00046,83054,19.10658,434688
5645,aniketArkin,2,0.00046,83056,19.10704,434688
5646,ankisinha3005,2,0.00046,83058,19.10750,434688
5647,ankit-ls,2,0.00046,83060,19.10796,434688
5648,AnnieTalvasto,2,0.00046,83062,19.10842,434688
5649,anniewang408,2,0.00046,83064,19.10888,434688
5650,anon17,2,0.00046,83066,19.10934,434688
5651,anongitmous,2,0.00046,83068,19.10980,434688
5652,anrajme,2,0.00046,83070,19.11026,434688
5653,anrossi,2,0.00046,83072,19.11072,434688
5654,antbreton,2,0.00046,83074,19.11118,434688
5655,anthonyrisinger,2,0.00046,83076,19.11164,434688
5656,Antny3360,2,0.00046,83078,19.11210,434688
5657,AntoineC44,2,0.00046,83080,19.11256,434688
5658,antonyc,2,0.00046,83082,19.11302,434688
5659,anujeet-chatterjee,2,0.00046,83084,19.11348,434688
5660,anujg-splunk,2,0.00046,83086,19.11394,434688
5661,an-voronov,2,0.00046,83088,19.11440,434688
5662,anvpetrov,2,0.00046,83090,19.11486,434688
5663,aolvictim,2,0.00046,83092,19.11532,434688
5664,apinnick,2,0.00046,83094,19.11578,434688
5665,aporuchy,2,0.00046,83096,19.11624,434688
5666,applike-ss,2,0.00046,83098,19.11670,434688
5667,AqlaSolutions,2,0.00046,83100,19.11716,434688
5668,Arashi5,2,0.00046,83102,19.11762,434688
5669,archenroot,2,0.00046,83104,19.11808,434688
5670,Arfey,2,0.00046,83106,19.11854,434688
5671,AristoStelar,2,0.00046,83108,19.11900,434688
5672,arjun024,2,0.00046,83110,19.11946,434688
5673,arjunsalyan,2,0.00046,83112,19.11992,434688
5674,ARKP1981,2,0.00046,83114,19.12038,434688
5675,arnaldomf,2,0.00046,83116,19.12084,434688
5676,arnewiebalck,2,0.00046,83118,19.12130,434688
5677,arniesaha,2,0.00046,83120,19.12176,434688
5678,arnonki,2,0.00046,83122,19.12222,434688
5679,arontsang,2,0.00046,83124,19.12268,434688
5680,arshanvit,2,0.00046,83126,19.12314,434688
5681,artemkoru,2,0.00046,83128,19.12360,434688
5682,ArthurVardevanyan,2,0.00046,83130,19.12406,434688
5683,artiom,2,0.00046,83132,19.12452,434688
5684,ArtyomKozyrev8,2,0.00046,83134,19.12498,434688
5685,arun2arunraj,2,0.00046,83136,19.12544,434688
5686,Arunmai1704,2,0.00046,83138,19.12590,434688
5687,arunzco,2,0.00046,83140,19.12636,434688
5688,aryklein,2,0.00046,83142,19.12682,434688
5689,asalatkamal,2,0.00046,83144,19.12728,434688
5690,aSemy,2,0.00046,83146,19.12774,434688
5691,asheesh1996,2,0.00046,83148,19.12820,434688
5692,ashokballolli,2,0.00046,83150,19.12866,434688
5693,ashraf133,2,0.00046,83152,19.12912,434688
5694,ashutosh5786,2,0.00046,83154,19.12958,434688
5695,AshwiniGhanwat,2,0.00046,83156,19.13004,434688
5696,asibece,2,0.00046,83158,19.13050,434688
5697,asimb123,2,0.00046,83160,19.13096,434688
5698,asjoyner,2,0.00046,83162,19.13142,434688
5699,aslamkhan-dremio,2,0.00046,83164,19.13188,434688
5700,AstroProfundis,2,0.00046,83166,19.13234,434688
5701,aswathsaru,2,0.00046,83168,19.13280,434688
5702,aswathysen,2,0.00046,83170,19.13326,434688
5703,atali,2,0.00046,83172,19.13372,434688
5704,athalhammer,2,0.00046,83174,19.13418,434688
5705,attila123,2,0.00046,83176,19.13464,434688
5706,AustenBaker,2,0.00046,83178,19.13510,434688
5707,AustinEscobedo,2,0.00046,83180,19.13556,434688
5708,avant1,2,0.00046,83182,19.13602,434688
5709,avishefi,2,0.00046,83184,19.13648,434688
5710,avisiedo,2,0.00046,83186,19.13694,434688
5711,awarus,2,0.00046,83188,19.13740,434688
5712,awasilyev,2,0.00046,83190,19.13786,434688
5713,AWSCloud21,2,0.00046,83192,19.13832,434688
5714,AWSmith0216,2,0.00046,83194,19.13878,434688
5715,axjowo,2,0.00046,83196,19.13924,434688
5716,azamaschikov,2,0.00046,83198,19.13970,434688
5717,A-Zee029,2,0.00046,83200,19.14016,434688
5718,aztechian,2,0.00046,83202,19.14063,434688
5719,b99andla,2,0.00046,83204,19.14109,434688
5720,backtrackshubham,2,0.00046,83206,19.14155,434688
5721,Bacto,2,0.00046,83208,19.14201,434688
5722,Bafff,2,0.00046,83210,19.14247,434688
5723,balajir24,2,0.00046,83212,19.14293,434688
5724,Balasahebpmule,2,0.00046,83214,19.14339,434688
5725,bambam247,2,0.00046,83216,19.14385,434688
5726,banshee86vr,2,0.00046,83218,19.14431,434688
5727,bartebor,2,0.00046,83220,19.14477,434688
5728,bartlomiejdanek,2,0.00046,83222,19.14523,434688
5729,BaseMax,2,0.00046,83224,19.14569,434688
5730,basezeus,2,0.00046,83226,19.14615,434688
5731,bbarin,2,0.00046,83228,19.14661,434688
5732,bbesset,2,0.00046,83230,19.14707,434688
5733,B-Betty,2,0.00046,83232,19.14753,434688
5734,bbros-dev,2,0.00046,83234,19.14799,434688
5735,bcressey,2,0.00046,83236,19.14845,434688
5736,bd-clara,2,0.00046,83238,19.14891,434688
5737,bdshadow,2,0.00046,83240,19.14937,434688
5738,bduclaux,2,0.00046,83242,19.14983,434688
5739,bdun1013,2,0.00046,83244,19.15029,434688
5740,beep-bop-cloud,2,0.00046,83246,19.15075,434688
5741,belovi,2,0.00046,83248,19.15121,434688
5742,bemeyert,2,0.00046,83250,19.15167,434688
5743,benbolivar,2,0.00046,83252,19.15213,434688
5744,BenDu89,2,0.00046,83254,19.15259,434688
5745,benfdking,2,0.00046,83256,19.15305,434688
5746,benjojo,2,0.00046,83258,19.15351,434688
5747,benlandrum,2,0.00046,83260,19.15397,434688
5748,bergerst,2,0.00046,83262,19.15443,434688
5749,bergmannf,2,0.00046,83264,19.15489,434688
5750,BernhardRode,2,0.00046,83266,19.15535,434688
5751,bert-at-github,2,0.00046,83268,19.15581,434688
5752,besha100,2,0.00046,83270,19.15627,434688
5753,bespanto,2,0.00046,83272,19.15673,434688
5754,betanummeric,2,0.00046,83274,19.15719,434688
5755,Betterme001,2,0.00046,83276,19.15765,434688
5756,bglmmz,2,0.00046,83278,19.15811,434688
5757,bharathreddy-lab,2,0.00046,83280,19.15857,434688
5758,bhasinkaran,2,0.00046,83282,19.15903,434688
5759,bhawnabharati,2,0.00046,83284,19.15949,434688
5760,bhester01,2,0.00046,83286,19.15995,434688
5761,bigon,2,0.00046,83288,19.16041,434688
5762,bigquant,2,0.00046,83290,19.16087,434688
5763,bilibilibalala,2,0.00046,83292,19.16133,434688
5764,billgale,2,0.00046,83294,19.16179,434688
5765,bjd2385,2,0.00046,83296,19.16225,434688
5766,bklooste,2,0.00046,83298,19.16271,434688
5767,blackguard88,2,0.00046,83300,19.16317,434688
5768,blackjackyau,2,0.00046,83302,19.16363,434688
5769,BlakeWilliams,2,0.00046,83304,19.16409,434688
5770,bleech1,2,0.00046,83306,19.16455,434688
5771,blindmatrix,2,0.00046,83308,19.16501,434688
5772,blind-oracle,2,0.00046,83310,19.16547,434688
5773,bliof-fc,2,0.00046,83312,19.16593,434688
5774,Blitss,2,0.00046,83314,19.16639,434688
5775,BlocDrummer,2,0.00046,83316,19.16685,434688
5776,bluejekyll,2,0.00046,83318,19.16731,434688
5777,bluven,2,0.00046,83320,19.16777,434688
5778,bmovva1991,2,0.00046,83322,19.16823,434688
5779,bnayae,2,0.00046,83324,19.16869,434688
5780,boanerges317,2,0.00046,83326,19.16915,434688
5781,bobbygryzynger,2,0.00046,83328,19.16961,434688
5782,bobymark,2,0.00046,83330,19.17007,434688
5783,bojeil-google,2,0.00046,83332,19.17053,434688
5784,boldt,2,0.00046,83334,19.17099,434688
5785,BOLT04,2,0.00046,83336,19.17145,434688
5786,boopathykpm,2,0.00046,83338,19.17191,434688
5787,Bo-peter,2,0.00046,83340,19.17237,434688
5788,bpietraga,2,0.00046,83342,19.17283,434688
5789,Bpmm9012,2,0.00046,83344,19.17329,434688
5790,bpschuck,2,0.00046,83346,19.17375,434688
5791,bracketttc,2,0.00046,83348,19.17421,434688
5792,bramwelt,2,0.00046,83350,19.17467,434688
5793,brendanmaguire,2,0.00046,83352,19.17513,434688
5794,brew,2,0.00046,83354,19.17559,434688
5795,brian14708,2,0.00046,83356,19.17605,434688
5796,brianmjones,2,0.00046,83358,19.17651,434688
5797,brianpgerson,2,0.00046,83360,19.17697,434688
5798,brianthelion,2,0.00046,83362,19.17743,434688
5799,briscula,2,0.00046,83364,19.17789,434688
5800,BrixSat,2,0.00046,83366,19.17835,434688
5801,brunobat,2,0.00046,83368,19.17881,434688
5802,brunocascio,2,0.00046,83370,19.17927,434688
5803,Brunomachadob,2,0.00046,83372,19.17973,434688
5804,bruto0,2,0.00046,83374,19.18019,434688
5805,bryant-rh,2,0.00046,83376,19.18065,434688
5806,bschaeffer,2,0.00046,83378,19.18111,434688
5807,bschweizer,2,0.00046,83380,19.18157,434688
5808,bsharma-tavisca,2,0.00046,83382,19.18203,434688
5809,burkeazbill,2,0.00046,83384,19.18249,434688
5810,bynare,2,0.00046,83386,19.18295,434688
5811,byunru,2,0.00046,83388,19.18341,434688
5812,bzolivereckle,2,0.00046,83390,19.18387,434688
5813,cal5barton,2,0.00046,83392,19.18433,434688
5814,Calabor-Hoc,2,0.00046,83394,19.18479,434688
5815,calaway,2,0.00046,83396,19.18525,434688
5816,callumj,2,0.00046,83398,19.18571,434688
5817,calvh,2,0.00046,83400,19.18617,434688
5818,cambierr,2,0.00046,83402,19.18664,434688
5819,camhine,2,0.00046,83404,19.18710,434688
5820,candreso,2,0.00046,83406,19.18756,434688
5821,caoxuexi,2,0.00046,83408,19.18802,434688
5822,Caprowni,2,0.00046,83410,19.18848,434688
5823,carehart,2,0.00046,83412,19.18894,434688
5824,carlocab,2,0.00046,83414,19.18940,434688
5825,CarloColumna,2,0.00046,83416,19.18986,434688
5826,carloscarnero,2,0.00046,83418,19.19032,434688
5827,carlostaffe,2,0.00046,83420,19.19078,434688
5828,carsten-langer,2,0.00046,83422,19.19124,434688
5829,caryjpaepen,2,0.00046,83424,19.19170,434688
5830,case-k-git,2,0.00046,83426,19.19216,434688
5831,CatsMiaow,2,0.00046,83428,19.19262,434688
5832,cawoodm,2,0.00046,83430,19.19308,434688
5833,cb-manick,2,0.00046,83432,19.19354,434688
5834,cccdy,2,0.00046,83434,19.19400,434688
5835,cccfs,2,0.00046,83436,19.19446,434688
5836,ccqy66,2,0.00046,83438,19.19492,434688
5837,cdmetcalf,2,0.00046,83440,19.19538,434688
5838,cebernardi,2,0.00046,83442,19.19584,434688
5839,celiawa,2,0.00046,83444,19.19630,434688
5840,cesarkohl-voxie,2,0.00046,83446,19.19676,434688
5841,cfandrich,2,0.00046,83448,19.19722,434688
5842,cfredri4,2,0.00046,83450,19.19768,434688
5843,cgchinmay,2,0.00046,83452,19.19814,434688
5844,chaitushiva,2,0.00046,83454,19.19860,434688
5845,chaliy,2,0.00046,83456,19.19906,434688
5846,Champ-Goblem,2,0.00046,83458,19.19952,434688
5847,chandrab-on,2,0.00046,83460,19.19998,434688
5848,chandu484,2,0.00046,83462,19.20044,434688
5849,changhuaixin,2,0.00046,83464,19.20090,434688
5850,CharlesMasson,2,0.00046,83466,19.20136,434688
5851,charlesoconor,2,0.00046,83468,19.20182,434688
5852,charlesvg,2,0.00046,83470,19.20228,434688
5853,Charliekenney23,2,0.00046,83472,19.20274,434688
5854,charnet1019,2,0.00046,83474,19.20320,434688
5855,chasestech,2,0.00046,83476,19.20366,434688
5856,CheesyFeet,2,0.00046,83478,19.20412,434688
5857,chenchongyu,2,0.00046,83480,19.20458,434688
5858,CheneyCookie,2,0.00046,83482,19.20504,434688
5859,chengyaxue,2,0.00046,83484,19.20550,434688
5860,chenqianfzh,2,0.00046,83486,19.20596,434688
5861,chenyhd,2,0.00046,83488,19.20642,434688
5862,cherrylzhao,2,0.00046,83490,19.20688,434688
5863,chetak123,2,0.00046,83492,19.20734,434688
5864,chienfuchen32,2,0.00046,83494,19.20780,434688
5865,china-live,2,0.00046,83496,19.20826,434688
5866,chinglinwen,2,0.00046,83498,19.20872,434688
5867,chingyi-lin,2,0.00046,83500,19.20918,434688
5868,chirupan,2,0.00046,83502,19.20964,434688
5869,choo-stripe,2,0.00046,83504,19.21010,434688
5870,Chris113113,2,0.00046,83506,19.21056,434688
5871,chris2k20,2,0.00046,83508,19.21102,434688
5872,chrism417,2,0.00046,83510,19.21148,434688
5873,chrisob,2,0.00046,83512,19.21194,434688
5874,chris-peerman,2,0.00046,83514,19.21240,434688
5875,chrisprijic,2,0.00046,83516,19.21286,434688
5876,ChristianAvila,2,0.00046,83518,19.21332,434688
5877,chtourou-youssef,2,0.00046,83520,19.21378,434688
5878,ChuckGithub,2,0.00046,83522,19.21424,434688
5879,chuckthompsonprofisee,2,0.00046,83524,19.21470,434688
5880,chukka,2,0.00046,83526,19.21516,434688
5881,cielavenir,2,0.00046,83528,19.21562,434688
5882,Ciggzy1312,2,0.00046,83530,19.21608,434688
5883,cihantas,2,0.00046,83532,19.21654,434688
5884,cinash,2,0.00046,83534,19.21700,434688
5885,ckuduvalli,2,0.00046,83536,19.21746,434688
5886,clambin,2,0.00046,83538,19.21792,434688
5887,clarkzinzow,2,0.00046,83540,19.21838,434688
5888,clayvan,2,0.00046,83542,19.21884,434688
5889,cldmnky,2,0.00046,83544,19.21930,434688
5890,cledavid,2,0.00046,83546,19.21976,434688
5891,clock21am,2,0.00046,83548,19.22022,434688
5892,closetool,2,0.00046,83550,19.22068,434688
5893,cloudxperts,2,0.00046,83552,19.22114,434688
5894,clsater,2,0.00046,83554,19.22160,434688
5895,clushie,2,0.00046,83556,19.22206,434688
5896,cmanzur,2,0.00046,83558,19.22252,434688
5897,cmd-werner,2,0.00046,83560,19.22298,434688
5898,cmonty14,2,0.00046,83562,19.22344,434688
5899,cnnaik,2,0.00046,83564,19.22390,434688
5900,coachcalvi,2,0.00046,83566,19.22436,434688
5901,Coconut105,2,0.00046,83568,19.22482,434688
5902,codematix,2,0.00046,83570,19.22528,434688
5903,coeuvre,2,0.00046,83572,19.22574,434688
5904,colinblack,2,0.00046,83574,19.22620,434688
5905,collinbowers,2,0.00046,83576,19.22666,434688
5906,collivier,2,0.00046,83578,19.22712,434688
5907,colltoaction,2,0.00046,83580,19.22758,434688
5908,colynn,2,0.00046,83582,19.22804,434688
5909,com30n,2,0.00046,83584,19.22850,434688
5910,comerford,2,0.00046,83586,19.22896,434688
5911,Congelli501,2,0.00046,83588,19.22942,434688
5912,conman2305,2,0.00046,83590,19.22988,434688
5913,containeers,2,0.00046,83592,19.23034,434688
5914,contributorpw,2,0.00046,83594,19.23080,434688
5915,cookbook87,2,0.00046,83596,19.23126,434688
5916,cookiefission,2,0.00046,83598,19.23172,434688
5917,corbosman,2,0.00046,83600,19.23218,434688
5918,corpix,2,0.00046,83602,19.23265,434688
5919,cosmonova,2,0.00046,83604,19.23311,434688
5920,cpressland,2,0.00046,83606,19.23357,434688
5921,craqs,2,0.00046,83608,19.23403,434688
5922,crazy-max,2,0.00046,83610,19.23449,434688
5923,CrazyMushu,2,0.00046,83612,19.23495,434688
5924,creganFL,2,0.00046,83614,19.23541,434688
5925,Crespalvaro,2,0.00046,83616,19.23587,434688
5926,crikke,2,0.00046,83618,19.23633,434688
5927,crimson-gao,2,0.00046,83620,19.23679,434688
5928,cristiamu,2,0.00046,83622,19.23725,434688
5929,crossphoton,2,0.00046,83624,19.23771,434688
5930,cspwizard,2,0.00046,83626,19.23817,434688
5931,cten,2,0.00046,83628,19.23863,434688
5932,ctison,2,0.00046,83630,19.23909,434688
5933,ctnkaan,2,0.00046,83632,19.23955,434688
5934,currybullen,2,0.00046,83634,19.24001,434688
5935,currypapi,2,0.00046,83636,19.24047,434688
5936,cutiechi,2,0.00046,83638,19.24093,434688
5937,CVEDetect,2,0.00046,83640,19.24139,434688
5938,cxx1799,2,0.00046,83642,19.24185,434688
5939,cy-ddg,2,0.00046,83644,19.24231,434688
5940,czerasz-allianz,2,0.00046,83646,19.24277,434688
5941,D2C-Cai,2,0.00046,83648,19.24323,434688
5942,d3vpasha,2,0.00046,83650,19.24369,434688
5943,daDangminh,2,0.00046,83652,19.24415,434688
5944,DaemonDude23,2,0.00046,83654,19.24461,434688
5945,dafenko,2,0.00046,83656,19.24507,434688
5946,dajeffers,2,0.00046,83658,19.24553,434688
5947,daliaezt,2,0.00046,83660,19.24599,434688
5948,damarvin,2,0.00046,83662,19.24645,434688
5949,dan1el-k,2,0.00046,83664,19.24691,434688
5950,dandeshsanshi,2,0.00046,83666,19.24737,434688
5951,danfinn,2,0.00046,83668,19.24783,434688
5952,dangviettuan,2,0.00046,83670,19.24829,434688
5953,DanHam,2,0.00046,83672,19.24875,434688
5954,danielbecroft,2,0.00046,83674,19.24921,434688
5955,Daniel-Huff,2,0.00046,83676,19.24967,434688
5956,DanielJoyce,2,0.00046,83678,19.25013,434688
5957,danieloateslee,2,0.00046,83680,19.25059,434688
5958,dan-lepage,2,0.00046,83682,19.25105,434688
5959,dano0b,2,0.00046,83684,19.25151,434688
5960,danquack,2,0.00046,83686,19.25197,434688
5961,danseo-reisys,2,0.00046,83688,19.25243,434688
5962,DanStough,2,0.00046,83690,19.25289,434688
5963,DanSu93,2,0.00046,83692,19.25335,434688
5964,dantingl,2,0.00046,83694,19.25381,434688
5965,DanWard,2,0.00046,83696,19.25427,434688
5966,darekg11,2,0.00046,83698,19.25473,434688
5967,DarkmatterVale,2,0.00046,83700,19.25519,434688
5968,darren,2,0.00046,83702,19.25565,434688
5969,databasedav,2,0.00046,83704,19.25611,434688
5970,data-ghoti,2,0.00046,83706,19.25657,434688
5971,DatanoiseTV,2,0.00046,83708,19.25703,434688
5972,datthu119,2,0.00046,83710,19.25749,434688
5973,dav178,2,0.00046,83712,19.25795,434688
5974,Dave0412,2,0.00046,83714,19.25841,434688
5975,davedavedavid,2,0.00046,83716,19.25887,434688
5976,davidbartos,2,0.00046,83718,19.25933,434688
5977,DavidCMulder,2,0.00046,83720,19.25979,434688
5978,davidjward30,2,0.00046,83722,19.26025,434688
5979,davidmirror-ops,2,0.00046,83724,19.26071,434688
5980,davidmirza408,2,0.00046,83726,19.26117,434688
5981,davidshtian,2,0.00046,83728,19.26163,434688
5982,DavidSimner,2,0.00046,83730,19.26209,434688
5983,davidtnorth,2,0.00046,83732,19.26255,434688
5984,davidtseng,2,0.00046,83734,19.26301,434688
5985,davinchia,2,0.00046,83736,19.26347,434688
5986,Dawgwe1gm,2,0.00046,83738,19.26393,434688
5987,DawnGuoDev,2,0.00046,83740,19.26439,434688
5988,DaytonG,2,0.00046,83742,19.26485,434688
5989,dbaumgarten,2,0.00046,83744,19.26531,434688
5990,dc-weizhenhua,2,0.00046,83746,19.26577,434688
5991,ddzero2c,2,0.00046,83748,19.26623,434688
5992,debasis09,2,0.00046,83750,19.26669,434688
5993,debu99,2,0.00046,83752,19.26715,434688
5994,deeghuge,2,0.00046,83754,19.26761,434688
5995,deepanverma19,2,0.00046,83756,19.26807,434688
5996,deepeshdeomurari,2,0.00046,83758,19.26853,434688
5997,deepskyblue86,2,0.00046,83760,19.26899,434688
5998,defo89,2,0.00046,83762,19.26945,434688
5999,deirdresmMS,2,0.00046,83764,19.26991,434688
6000,dejan9393,2,0.00046,83766,19.27037,434688
6001,delokman,2,0.00046,83768,19.27083,434688
6002,denispilon,2,0.00046,83770,19.27129,434688
6003,dennisotugo,2,0.00046,83772,19.27175,434688
6004,derdanne,2,0.00046,83774,19.27221,434688
6005,deskoh,2,0.00046,83776,19.27267,434688
6006,DestyNova,2,0.00046,83778,19.27313,434688
6007,deut-erium,2,0.00046,83780,19.27359,434688
6008,dev-hana,2,0.00046,83782,19.27405,434688
6009,devillove084,2,0.00046,83784,19.27451,434688
6010,devjoes,2,0.00046,83786,19.27497,434688
6011,devonwarren,2,0.00046,83788,19.27543,434688
6012,devopsn3rd,2,0.00046,83790,19.27589,434688
6013,deyanp,2,0.00046,83792,19.27635,434688
6014,Dgadavin,2,0.00046,83794,19.27681,434688
6015,dgdevops,2,0.00046,83796,19.27727,434688
6016,dggneubert,2,0.00046,83798,19.27773,434688
6017,DgoNascimento,2,0.00046,83800,19.27819,434688
6018,dhaiducek,2,0.00046,83802,19.27866,434688
6019,dhuang,2,0.00046,83804,19.27912,434688
6020,dianqihanwangzi,2,0.00046,83806,19.27958,434688
6021,diepes,2,0.00046,83808,19.28004,434688
6022,digglife,2,0.00046,83810,19.28050,434688
6023,digihunch,2,0.00046,83812,19.28096,434688
6024,DimitrijeManic,2,0.00046,83814,19.28142,434688
6025,dimitriosstander,2,0.00046,83816,19.28188,434688
6026,dimkk,2,0.00046,83818,19.28234,434688
6027,Dines97,2,0.00046,83820,19.28280,434688
6028,dinpau,2,0.00046,83822,19.28326,434688
6029,dirk-olmes,2,0.00046,83824,19.28372,434688
6030,divyamadala30,2,0.00046,83826,19.28418,434688
6031,djboris9,2,0.00046,83828,19.28464,434688
6032,djcass44,2,0.00046,83830,19.28510,434688
6033,djedjethai,2,0.00046,83832,19.28556,434688
6034,djshow832,2,0.00046,83834,19.28602,434688
6035,dloucasfx,2,0.00046,83836,19.28648,434688
6036,dmitriishaburov,2,0.00046,83838,19.28694,434688
6037,dmndru,2,0.00046,83840,19.28740,434688
6038,dol,2,0.00046,83842,19.28786,434688
6039,domgold-keleo,2,0.00046,83844,19.28832,434688
6040,donnyv12,2,0.00046,83846,19.28878,434688
6041,douglasnaphas,2,0.00046,83848,19.28924,434688
6042,dragoscalinescu,2,0.00046,83850,19.28970,434688
6043,dreamer820,2,0.00046,83852,19.29016,434688
6044,drewfreyling,2,0.00046,83854,19.29062,434688
6045,driftertest,2,0.00046,83856,19.29108,434688
6046,driosalido,2,0.00046,83858,19.29154,434688
6047,DrJackilD,2,0.00046,83860,19.29200,434688
6048,dsafont,2,0.00046,83862,19.29246,434688
6049,dsiddy,2,0.00046,83864,19.29292,434688
6050,dspeck1,2,0.00046,83866,19.29338,434688
6051,dspurandare,2,0.00046,83868,19.29384,434688
6052,dstjahjono,2,0.00046,83870,19.29430,434688
6053,dtest11,2,0.00046,83872,19.29476,434688
6054,dthuering,2,0.00046,83874,19.29522,434688
6055,dtinth,2,0.00046,83876,19.29568,434688
6056,DuC-cnZj,2,0.00046,83878,19.29614,434688
6057,dufcrule,2,0.00046,83880,19.29660,434688
6058,dundee,2,0.00046,83882,19.29706,434688
6059,Dunge,2,0.00046,83884,19.29752,434688
6060,dustinvanbuskirk,2,0.00046,83886,19.29798,434688
6061,dwannamaker-onr,2,0.00046,83888,19.29844,434688
6062,Dweston88,2,0.00046,83890,19.29890,434688
6063,dwillist,2,0.00046,83892,19.29936,434688
6064,dxlr8r,2,0.00046,83894,19.29982,434688
6065,DZakh,2,0.00046,83896,19.30028,434688
6066,eaglexiang,2,0.00046,83898,19.30074,434688
6067,ebattat,2,0.00046,83900,19.30120,434688
6068,ebcarty,2,0.00046,83902,19.30166,434688
6069,EchoZhaoH,2,0.00046,83904,19.30212,434688
6070,eckra,2,0.00046,83906,19.30258,434688
6071,edboffical,2,0.00046,83908,19.30304,434688
6072,eddumelendez,2,0.00046,83910,19.30350,434688
6073,edentsai,2,0.00046,83912,19.30396,434688
6074,edhjer,2,0.00046,83914,19.30442,434688
6075,edussx,2,0.00046,83916,19.30488,434688
6076,edwardzjl,2,0.00046,83918,19.30534,434688
6077,eero-t,2,0.00046,83920,19.30580,434688
6078,Eikykun,2,0.00046,83922,19.30626,434688
6079,einfachnuralex,2,0.00046,83924,19.30672,434688
6080,ekamdz,2,0.00046,83926,19.30718,434688
6081,eladm26,2,0.00046,83928,19.30764,434688
6082,elchead,2,0.00046,83930,19.30810,434688
6083,elenigen,2,0.00046,83932,19.30856,434688
6084,elenz97,2,0.00046,83934,19.30902,434688
6085,elgamal2020,2,0.00046,83936,19.30948,434688
6086,eli-halych,2,0.00046,83938,19.30994,434688
6087,elKei24,2,0.00046,83940,19.31040,434688
6088,elmehdisaniss,2,0.00046,83942,19.31086,434688
6089,elocke,2,0.00046,83944,19.31132,434688
6090,elvisbort,2,0.00046,83946,19.31178,434688
6091,eminalemdar,2,0.00046,83948,19.31224,434688
6092,emmansun,2,0.00046,83950,19.31270,434688
6093,emoreth,2,0.00046,83952,19.31316,434688
6094,EnlightenedOne,2,0.00046,83954,19.31362,434688
6095,enordberg,2,0.00046,83956,19.31408,434688
6096,eobianwu,2,0.00046,83958,19.31454,434688
6097,eosfor,2,0.00046,83960,19.31500,434688
6098,ephesused,2,0.00046,83962,19.31546,434688
6099,EpicStep,2,0.00046,83964,19.31592,434688
6100,eramoto,2,0.00046,83966,19.31638,434688
6101,EricHorst,2,0.00046,83968,19.31684,434688
6102,erickpeirson,2,0.00046,83970,19.31730,434688
6103,ericonr,2,0.00046,83972,19.31776,434688
6104,erictg,2,0.00046,83974,19.31822,434688
6105,ericwolf08-wp,2,0.00046,83976,19.31868,434688
6106,erlangera,2,0.00046,83978,19.31914,434688
6107,eroshiva,2,0.00046,83980,19.31960,434688
6108,esalberg,2,0.00046,83982,19.32006,434688
6109,Escaflow,2,0.00046,83984,19.32052,434688
6110,estebanreyl,2,0.00046,83986,19.32098,434688
6111,esune,2,0.00046,83988,19.32144,434688
6112,etcshad0vv,2,0.00046,83990,19.32190,434688
6113,etho201,2,0.00046,83992,19.32236,434688
6114,Euthpic,2,0.00046,83994,19.32282,434688
6115,evandam,2,0.00046,83996,19.32328,434688
6116,evansheng,2,0.00046,83998,19.32374,434688
6117,everping,2,0.00046,84000,19.32420,434688
6118,ev-hines,2,0.00046,84002,19.32467,434688
6119,evindunn,2,0.00046,84004,19.32513,434688
6120,Excpt0r,2,0.00046,84006,19.32559,434688
6121,ExperimentalHypothesis,2,0.00046,84008,19.32605,434688
6122,ezeriver94,2,0.00046,84010,19.32651,434688
6123,f9n,2,0.00046,84012,19.32697,434688
6124,fabianishere,2,0.00046,84014,19.32743,434688
6125,FabianNiehaus,2,0.00046,84016,19.32789,434688
6126,f-adrian,2,0.00046,84018,19.32835,434688
6127,Faebs23,2,0.00046,84020,19.32881,434688
6128,FaHeymann,2,0.00046,84022,19.32927,434688
6129,falconcode16,2,0.00046,84024,19.32973,434688
6130,fams,2,0.00046,84026,19.33019,434688
6131,fangyi-zhou,2,0.00046,84028,19.33065,434688
6132,fanzhihai0215,2,0.00046,84030,19.33111,434688
6133,faroukellouze,2,0.00046,84032,19.33157,434688
6134,fatherlinux,2,0.00046,84034,19.33203,434688
6135,fbonin,2,0.00046,84036,19.33249,434688
6136,fbrier,2,0.00046,84038,19.33295,434688
6137,fcanovai,2,0.00046,84040,19.33341,434688
6138,fculpo,2,0.00046,84042,19.33387,434688
6139,felipefzdz,2,0.00046,84044,19.33433,434688
6140,feniljain,2,0.00046,84046,19.33479,434688
6141,fergalk,2,0.00046,84048,19.33525,434688
6142,FernFerret,2,0.00046,84050,19.33571,434688
6143,ffroliva,2,0.00046,84052,19.33617,434688
6144,fhuitelec,2,0.00046,84054,19.33663,434688
6145,fibbs,2,0.00046,84056,19.33709,434688
6146,fidelito,2,0.00046,84058,19.33755,434688
6147,fiftin,2,0.00046,84060,19.33801,434688
6148,fiibbb,2,0.00046,84062,19.33847,434688
6149,filipp-filippov,2,0.00046,84064,19.33893,434688
6150,Filirom1,2,0.00046,84066,19.33939,434688
6151,findmyway,2,0.00046,84068,19.33985,434688
6152,fire-ant,2,0.00046,84070,19.34031,434688
6153,fisdev6,2,0.00046,84072,19.34077,434688
6154,fitchtech,2,0.00046,84074,19.34123,434688
6155,fktkrt,2,0.00046,84076,19.34169,434688
6156,flabatut,2,0.00046,84078,19.34215,434688
6157,FLAGLORD,2,0.00046,84080,19.34261,434688
6158,flashover,2,0.00046,84082,19.34307,434688
6159,flashyang,2,0.00046,84084,19.34353,434688
6160,flisak-robert,2,0.00046,84086,19.34399,434688
6161,f-loris,2,0.00046,84088,19.34445,434688
6162,floyola,2,0.00046,84090,19.34491,434688
6163,fluxens,2,0.00046,84092,19.34537,434688
6164,flxflx,2,0.00046,84094,19.34583,434688
6165,Foltik,2,0.00046,84096,19.34629,434688
6166,Folyd,2,0.00046,84098,19.34675,434688
6167,Fomalhauthmj,2,0.00046,84100,19.34721,434688
6168,foobaar,2,0.00046,84102,19.34767,434688
6169,forconz,2,0.00046,84104,19.34813,434688
6170,foreverm10,2,0.00046,84106,19.34859,434688
6171,forselli-stratio,2,0.00046,84108,19.34905,434688
6172,fosiul,2,0.00046,84110,19.34951,434688
6173,FPurchess,2,0.00046,84112,19.34997,434688
6174,Fram90,2,0.00046,84114,19.35043,434688
6175,francoisminaud,2,0.00046,84116,19.35089,434688
6176,frbk,2,0.00046,84118,19.35135,434688
6177,freddygv,2,0.00046,84120,19.35181,434688
6178,Frederik-Baetens,2,0.00046,84122,19.35227,434688
6179,FredyR4zox,2,0.00046,84124,19.35273,434688
6180,freshteapot,2,0.00046,84126,19.35319,434688
6181,FriedCircuits,2,0.00046,84128,19.35365,434688
6182,frightener,2,0.00046,84130,19.35411,434688
6183,frosiere,2,0.00046,84132,19.35457,434688
6184,fsarmien,2,0.00046,84134,19.35503,434688
6185,fuhry,2,0.00046,84136,19.35549,434688
6186,fuine6,2,0.00046,84138,19.35595,434688
6187,Furisto,2,0.00046,84140,19.35641,434688
6188,fxl0206,2,0.00046,84142,19.35687,434688
6189,fynrup,2,0.00046,84144,19.35733,434688
6190,fyxemmmm,2,0.00046,84146,19.35779,434688
6191,gabo1208,2,0.00046,84148,19.35825,434688
6192,gabrielpagu,2,0.00046,84150,19.35871,434688
6193,gaelbro,2,0.00046,84152,19.35917,434688
6194,gaganapplatix,2,0.00046,84154,19.35963,434688
6195,GagarinX,2,0.00046,84156,19.36009,434688
6196,Gajanana,2,0.00046,84158,19.36055,434688
6197,gandazgul,2,0.00046,84160,19.36101,434688
6198,gaofengliu0,2,0.00046,84162,19.36147,434688
6199,garciaolais,2,0.00046,84164,19.36193,434688
6200,garrygerber,2,0.00046,84166,19.36239,434688
6201,garyyang85,2,0.00046,84168,19.36285,434688
6202,gberenice,2,0.00046,84170,19.36331,434688
6203,gbudge,2,0.00046,84172,19.36377,434688
6204,gcjenkinson,2,0.00046,84174,19.36423,434688
6205,gdcplasf,2,0.00046,84176,19.36469,434688
6206,gennady-voronkov,2,0.00046,84178,19.36515,434688
6207,GeoffreyBooth,2,0.00046,84180,19.36561,434688
6208,georgephilif,2,0.00046,84182,19.36607,434688
6209,GeorgePony,2,0.00046,84184,19.36653,434688
6210,georglauterbach,2,0.00046,84186,19.36699,434688
6211,gerardborst,2,0.00046,84188,19.36745,434688
6212,geri-m,2,0.00046,84190,19.36791,434688
6213,geriom,2,0.00046,84192,19.36837,434688
6214,gezb,2,0.00046,84194,19.36883,434688
6215,ghilainm,2,0.00046,84196,19.36929,434688
6216,ghostpepper108,2,0.00046,84198,19.36975,434688
6217,ghostsquad,2,0.00046,84200,19.37021,434688
6218,GianOrtiz,2,0.00046,84202,19.37068,434688
6219,gidde8,2,0.00046,84204,19.37114,434688
6220,gidxl03,2,0.00046,84206,19.37160,434688
6221,gillsoftab,2,0.00046,84208,19.37206,434688
6222,giraffesyo,2,0.00046,84210,19.37252,434688
6223,GitHubAjit,2,0.00046,84212,19.37298,434688
6224,git-kundan,2,0.00046,84214,19.37344,434688
6225,gittripley,2,0.00046,84216,19.37390,434688
6226,gjmzj,2,0.00046,84218,19.37436,434688
6227,glightfoot,2,0.00046,84220,19.37482,434688
6228,glourenco,2,0.00046,84222,19.37528,434688
6229,gmaiztegi,2,0.00046,84224,19.37574,434688
6230,gmambro,2,0.00046,84226,19.37620,434688
6231,gnarl,2,0.00046,84228,19.37666,434688
6232,gnarlex,2,0.00046,84230,19.37712,434688
6233,gOATiful,2,0.00046,84232,19.37758,434688
6234,goatmale,2,0.00046,84234,19.37804,434688
6235,gojosatoru3,2,0.00046,84236,19.37850,434688
6236,GoneLikeAir,2,0.00046,84238,19.37896,434688
6237,gongqij,2,0.00046,84240,19.37942,434688
6238,gongzh,2,0.00046,84242,19.37988,434688
6239,googlebabaio,2,0.00046,84244,19.38034,434688
6240,goto100,2,0.00046,84246,19.38080,434688
6241,gourav287,2,0.00046,84248,19.38126,434688
6242,Gourds,2,0.00046,84250,19.38172,434688
6243,govilakshat1998,2,0.00046,84252,19.38218,434688
6244,gowrisankar22,2,0.00046,84254,19.38264,434688
6245,grafvonb,2,0.00046,84256,19.38310,434688
6246,grazius,2,0.00046,84258,19.38356,434688
6247,greatbn,2,0.00046,84260,19.38402,434688
6248,GreenShadeZhang,2,0.00046,84262,19.38448,434688
6249,greenweeds,2,0.00046,84264,19.38494,434688
6250,grexkin,2,0.00046,84266,19.38540,434688
6251,griffint61,2,0.00046,84268,19.38586,434688
6252,grtrout,2,0.00046,84270,19.38632,434688
6253,grumpyoldman-io,2,0.00046,84272,19.38678,434688
6254,gschmutz,2,0.00046,84274,19.38724,434688
6255,Gsealy,2,0.00046,84276,19.38770,434688
6256,gtorre,2,0.00046,84278,19.38816,434688
6257,gtourkas,2,0.00046,84280,19.38862,434688
6258,gtowey,2,0.00046,84282,19.38908,434688
6259,gt-yogan,2,0.00046,84284,19.38954,434688
6260,gufoe,2,0.00046,84286,19.39000,434688
6261,guidoilbaldo,2,0.00046,84288,19.39046,434688
6262,GuillaumeDesforges,2,0.00046,84290,19.39092,434688
6263,gulativishwas,2,0.00046,84292,19.39138,434688
6264,gunzy83,2,0.00046,84294,19.39184,434688
6265,guoyucheng,2,0.00046,84296,19.39230,434688
6266,gupf0719,2,0.00046,84298,19.39276,434688
6267,hacst,2,0.00046,84300,19.39322,434688
6268,hafkaM,2,0.00046,84302,19.39368,434688
6269,haingo-kenshjn,2,0.00046,84304,19.39414,434688
6270,haizaar,2,0.00046,84306,19.39460,434688
6271,haminhcong,2,0.00046,84308,19.39506,434688
6272,hancockjt,2,0.00046,84310,19.39552,434688
6273,hangsu-ma,2,0.00046,84312,19.39598,434688
6274,hannius,2,0.00046,84314,19.39644,434688
6275,haoxins,2,0.00046,84316,19.39690,434688
6276,happylucki,2,0.00046,84318,19.39736,434688
6277,haraldnh,2,0.00046,84320,19.39782,434688
6278,hardiksd,2,0.00046,84322,19.39828,434688
6279,hariprasadiit,2,0.00046,84324,19.39874,434688
6280,Harisrini2020,2,0.00046,84326,19.39920,434688
6281,harrishcris,2,0.00046,84328,19.39966,434688
6282,harsh-vishnoi,2,0.00046,84330,19.40012,434688
6283,hashishrajan,2,0.00046,84332,19.40058,434688
6284,hashwini-keysight,2,0.00046,84334,19.40104,434688
6285,hatfieldbrian,2,0.00046,84336,19.40150,434688
6286,hatharom,2,0.00046,84338,19.40196,434688
6287,Hawachurl,2,0.00046,84340,19.40242,434688
6288,hawk-liu,2,0.00046,84342,19.40288,434688
6289,hchouraria,2,0.00046,84344,19.40334,434688
6290,HeathKang,2,0.00046,84346,19.40380,434688
6291,HeCorr,2,0.00046,84348,19.40426,434688
6292,hedinasr,2,0.00046,84350,19.40472,434688
6293,hegderohit89,2,0.00046,84352,19.40518,434688
6294,hegemonic,2,0.00046,84354,19.40564,434688
6295,heidemn,2,0.00046,84356,19.40610,434688
6296,heisaman,2,0.00046,84358,19.40656,434688
6297,heiwais25,2,0.00046,84360,19.40702,434688
6298,hellolittlewei,2,0.00046,84362,19.40748,434688
6299,Hellslicer,2,0.00046,84364,19.40794,434688
6300,henrysecond1,2,0.00046,84366,19.40840,434688
6301,herrsergio,2,0.00046,84368,19.40886,434688
6302,hhstu,2,0.00046,84370,19.40932,434688
6303,hiberabyss,2,0.00046,84372,19.40978,434688
6304,hichamuntitled,2,0.00046,84374,19.41024,434688
6305,hichristo,2,0.00046,84376,19.41070,434688
6306,hidalgopl,2,0.00046,84378,19.41116,434688
6307,hjorth,2,0.00046,84380,19.41162,434688
6308,hkarshad,2,0.00046,84382,19.41208,434688
6309,hligit,2,0.00046,84384,19.41254,434688
6310,hoang-innomizetech,2,0.00046,84386,19.41300,434688
6311,hoangphan1509,2,0.00046,84388,19.41346,434688
6312,hoanpv3993,2,0.00046,84390,19.41392,434688
6313,hodorov,2,0.00046,84392,19.41438,434688
6314,hoffoo,2,0.00046,84394,19.41484,434688
6315,holdno,2,0.00046,84396,19.41530,434688
6316,honmaple,2,0.00046,84398,19.41576,434688
6317,honzakadlec,2,0.00046,84400,19.41622,434688
6318,hoodaajay1,2,0.00046,84402,19.41669,434688
6319,hopkiw,2,0.00046,84404,19.41715,434688
6320,horovits,2,0.00046,84406,19.41761,434688
6321,houlandong,2,0.00046,84408,19.41807,434688
6322,houstar,2,0.00046,84410,19.41853,434688
6323,hown3d,2,0.00046,84412,19.41899,434688
6324,hoyho,2,0.00046,84414,19.41945,434688
6325,hpcsc,2,0.00046,84416,19.41991,434688
6326,hrdcdr,2,0.00046,84418,19.42037,434688
6327,Hsn723,2,0.00046,84420,19.42083,434688
6328,HsuanTingLu,2,0.00046,84422,19.42129,434688
6329,htjain,2,0.00046,84424,19.42175,434688
6330,huangjiasingle,2,0.00046,84426,19.42221,434688
6331,huangjiecheng,2,0.00046,84428,19.42267,434688
6332,huayaoyue6,2,0.00046,84430,19.42313,434688
6333,hubkraft,2,0.00046,84432,19.42359,434688
6334,hudeldudel,2,0.00046,84434,19.42405,434688
6335,huornlmj,2,0.00046,84436,19.42451,434688
6336,hurrycane,2,0.00046,84438,19.42497,434688
6337,hydradan,2,0.00046,84440,19.42543,434688
6338,hyj-github,2,0.00046,84442,19.42589,434688
6339,hyserver,2,0.00046,84444,19.42635,434688
6340,HyunGook-Kim,2,0.00046,84446,19.42681,434688
6341,HZ89,2,0.00046,84448,19.42727,434688
6342,iamadotaer,2,0.00046,84450,19.42773,434688
6343,iamashwanth,2,0.00046,84452,19.42819,434688
6344,iamrsaravana,2,0.00046,84454,19.42865,434688
6345,ianroberts,2,0.00046,84456,19.42911,434688
6346,IanRobertson-wpe,2,0.00046,84458,19.42957,434688
6347,iatzmon,2,0.00046,84460,19.43003,434688
6348,IbraheemAlSaady,2,0.00046,84462,19.43049,434688
6349,ica10888,2,0.00046,84464,19.43095,434688
6350,ifelsefi,2,0.00046,84466,19.43141,434688
6351,igas,2,0.00046,84468,19.43187,434688
6352,igorcalabria,2,0.00046,84470,19.43233,434688
6353,igorlysak,2,0.00046,84472,19.43279,434688
6354,igorrenquin,2,0.00046,84474,19.43325,434688
6355,iguitton,2,0.00046,84476,19.43371,434688
6356,ikingye,2,0.00046,84478,19.43417,434688
6357,iliadmitriev,2,0.00046,84480,19.43463,434688
6358,illyaSlobozhanin,2,0.00046,84482,19.43509,434688
6359,ilujiez,2,0.00046,84484,19.43555,434688
6360,imbohyun1,2,0.00046,84486,19.43601,434688
6361,imcvampire,2,0.00046,84488,19.43647,434688
6362,infa-bapa,2,0.00046,84490,19.43693,434688
6363,inishchith,2,0.00046,84492,19.43739,434688
6364,inix,2,0.00046,84494,19.43785,434688
6365,inouekazu,2,0.00046,84496,19.43831,434688
6366,invent-lwj,2,0.00046,84498,19.43877,434688
6367,ipmb,2,0.00046,84500,19.43923,434688
6368,iRachana06,2,0.00046,84502,19.43969,434688
6369,isaac88,2,0.00046,84504,19.44015,434688
6370,iswbm,2,0.00046,84506,19.44061,434688
6371,itisguptak,2,0.00046,84508,19.44107,434688
6372,itmwiw,2,0.00046,84510,19.44153,434688
6373,itshikanov,2,0.00046,84512,19.44199,434688
6374,itskannanraj,2,0.00046,84514,19.44245,434688
6375,itsvshreyas,2,0.00046,84516,19.44291,434688
6376,IvanJosipovic,2,0.00046,84518,19.44337,434688
6377,ivarprudnikov,2,0.00046,84520,19.44383,434688
6378,ivyxjc,2,0.00046,84522,19.44429,434688
6379,iyurev,2,0.00046,84524,19.44475,434688
6380,j4ckofalltrades,2,0.00046,84526,19.44521,434688
6381,jack161641,2,0.00046,84528,19.44567,434688
6382,jack1902,2,0.00046,84530,19.44613,434688
6383,jackrsteiner,2,0.00046,84532,19.44659,434688
6384,jacobcrawford,2,0.00046,84534,19.44705,434688
6385,JaeGeunBang,2,0.00046,84536,19.44751,434688
6386,JaeguKim,2,0.00046,84538,19.44797,434688
6387,JakenVeina,2,0.00046,84540,19.44843,434688
6388,jakeonfire,2,0.00046,84542,19.44889,434688
6389,jamesgetx,2,0.00046,84544,19.44935,434688
6390,jammiemil,2,0.00046,84546,19.44981,434688
6391,janarthanandev,2,0.00046,84548,19.45027,434688
6392,JanBerktold,2,0.00046,84550,19.45073,434688
6393,Jancis,2,0.00046,84552,19.45119,434688
6394,Janesee3,2,0.00046,84554,19.45165,434688
6395,janesser,2,0.00046,84556,19.45211,434688
6396,janseris,2,0.00046,84558,19.45257,434688
6397,jaredclarke,2,0.00046,84560,19.45303,434688
6398,jaredoconnell,2,0.00046,84562,19.45349,434688
6399,jasenmh,2,0.00046,84564,19.45395,434688
6400,jasiam,2,0.00046,84566,19.45441,434688
6401,jaskeerat789,2,0.00046,84568,19.45487,434688
6402,jasonmcintosh,2,0.00046,84570,19.45533,434688
6403,jasonpaige,2,0.00046,84572,19.45579,434688
6404,jason-yolabs,2,0.00046,84574,19.45625,434688
6405,jayaddison,2,0.00046,84576,19.45671,434688
6406,jayanthvn,2,0.00046,84578,19.45717,434688
6407,jayars,2,0.00046,84580,19.45763,434688
6408,JayChanggithub,2,0.00046,84582,19.45809,434688
6409,Jaydee94,2,0.00046,84584,19.45855,434688
6410,jb185555,2,0.00046,84586,19.45901,434688
6411,jbpoint,2,0.00046,84588,19.45947,434688
6412,jceresini,2,0.00046,84590,19.45993,434688
6413,jcichonj,2,0.00046,84592,19.46039,434688
6414,jcogilvie,2,0.00046,84594,19.46085,434688
6415,jcreixell,2,0.00046,84596,19.46131,434688
6416,JCS-Enterprises-LLC-PRG,2,0.00046,84598,19.46177,434688
6417,jddcarreira,2,0.00046,84600,19.46223,434688
6418,jdgeisler,2,0.00046,84602,19.46270,434688
6419,jdrews,2,0.00046,84604,19.46316,434688
6420,Jeaniowang,2,0.00046,84606,19.46362,434688
6421,jeannieism,2,0.00046,84608,19.46408,434688
6422,jeanphilippeD,2,0.00046,84610,19.46454,434688
6423,jefflantz,2,0.00046,84612,19.46500,434688
6424,jeffrichie,2,0.00046,84614,19.46546,434688
6425,JeneferSuresh,2,0.00046,84616,19.46592,434688
6426,jenningsloy318,2,0.00046,84618,19.46638,434688
6427,jeremyrogers,2,0.00046,84620,19.46684,434688
6428,jerrywei116,2,0.00046,84622,19.46730,434688
6429,jessequinn,2,0.00046,84624,19.46776,434688
6430,jessicuzwhynot,2,0.00046,84626,19.46822,434688
6431,JethroMV,2,0.00046,84628,19.46868,434688
6432,jetora,2,0.00046,84630,19.46914,434688
6433,jferris,2,0.00046,84632,19.46960,434688
6434,jgerry2002,2,0.00046,84634,19.47006,434688
6435,jgunvalson,2,0.00046,84636,19.47052,434688
6436,jhanbo,2,0.00046,84638,19.47098,434688
6437,jhramey,2,0.00046,84640,19.47144,434688
6438,JianfuYang,2,0.00046,84642,19.47190,434688
6439,jiangchunlong597,2,0.00046,84644,19.47236,434688
6440,JianhuaGong,2,0.00046,84646,19.47282,434688
6441,jibanes,2,0.00046,84648,19.47328,434688
6442,jim-barber-he,2,0.00046,84650,19.47374,434688
6443,jindijamie,2,0.00046,84652,19.47420,434688
6444,jingcheng88,2,0.00046,84654,19.47466,434688
6445,JingCTyagi,2,0.00046,84656,19.47512,434688
6446,jingczhang,2,0.00046,84658,19.47558,434688
6447,jingslunt,2,0.00046,84660,19.47604,434688
6448,jinjiaw,2,0.00046,84662,19.47650,434688
6449,JinXingYoung,2,0.00046,84664,19.47696,434688
6450,jiribroulik,2,0.00046,84666,19.47742,434688
6451,jj891070,2,0.00046,84668,19.47788,434688
6452,jkl92,2,0.00046,84670,19.47834,434688
6453,jkupferer,2,0.00046,84672,19.47880,434688
6454,jkxplg,2,0.00046,84674,19.47926,434688
6455,jlevertov,2,0.00046,84676,19.47972,434688
6456,jls-0,2,0.00046,84678,19.48018,434688
6457,jmalkiew,2,0.00046,84680,19.48064,434688
6458,jmalmeid,2,0.00046,84682,19.48110,434688
6459,jmcclell,2,0.00046,84684,19.48156,434688
6460,jmdudley,2,0.00046,84686,19.48202,434688
6461,jmthackett,2,0.00046,84688,19.48248,434688
6462,joancafom,2,0.00046,84690,19.48294,434688
6463,joaoggnogueira,2,0.00046,84692,19.48340,434688
6464,joaopereirafarfetchcom,2,0.00046,84694,19.48386,434688
6465,joccau,2,0.00046,84696,19.48432,434688
6466,JodhwaniMadhur,2,0.00046,84698,19.48478,434688
6467,jodok,2,0.00046,84700,19.48524,434688
6468,JoeMarkov,2,0.00046,84702,19.48570,434688
6469,jogindercc,2,0.00046,84704,19.48616,434688
6470,john-livelyvideo,2,0.00046,84706,19.48662,434688
6471,johnnybaloney,2,0.00046,84708,19.48708,434688
6472,johnshearar,2,0.00046,84710,19.48754,434688
6473,johntostring,2,0.00046,84712,19.48800,434688
6474,john-yick,2,0.00046,84714,19.48846,434688
6475,jojoti,2,0.00046,84716,19.48892,434688
6476,jomasti,2,0.00046,84718,19.48938,434688
6477,Jonaskowalczyk,2,0.00046,84720,19.48984,434688
6478,jonas-weismueller-by,2,0.00046,84722,19.49030,434688
6479,jonathanio,2,0.00046,84724,19.49076,434688
6480,jonwtech,2,0.00046,84726,19.49122,434688
6481,JoschuaA4,2,0.00046,84728,19.49168,434688
6482,josephmcasey,2,0.00046,84730,19.49214,434688
6483,Joshi425,2,0.00046,84732,19.49260,434688
6484,joshuawhite929,2,0.00046,84734,19.49306,434688
6485,joshwlewis,2,0.00046,84736,19.49352,434688
6486,jphelton,2,0.00046,84738,19.49398,434688
6487,jpinkul,2,0.00046,84740,19.49444,434688
6488,jpmartins201,2,0.00046,84742,19.49490,434688
6489,jqmichael,2,0.00046,84744,19.49536,434688
6490,JRaver,2,0.00046,84746,19.49582,434688
6491,JRavi2,2,0.00046,84748,19.49628,434688
6492,jsalinas29,2,0.00046,84750,19.49674,434688
6493,jschnurr,2,0.00046,84752,19.49720,434688
6494,jshook,2,0.00046,84754,19.49766,434688
6495,jsm222,2,0.00046,84756,19.49812,434688
6496,jswantek,2,0.00046,84758,19.49858,434688
6497,jtnz,2,0.00046,84760,19.49904,434688
6498,jtorkkel,2,0.00046,84762,19.49950,434688
6499,jtougas,2,0.00046,84764,19.49996,434688
6500,jtwill98,2,0.00046,84766,19.50042,434688
6501,juancoen,2,0.00046,84768,19.50088,434688
6502,juanma-cvega,2,0.00046,84770,19.50134,434688
6503,juanyque,2,0.00046,84772,19.50180,434688
6504,julianocosta89-dt,2,0.00046,84774,19.50226,434688
6505,julianokassner31,2,0.00046,84776,19.50272,434688
6506,jumakasy,2,0.00046,84778,19.50318,434688
6507,junior,2,0.00046,84780,19.50364,434688
6508,junpengl,2,0.00046,84782,19.50410,434688
6509,justabaka,2,0.00046,84784,19.50456,434688
6510,justaverylee,2,0.00046,84786,19.50502,434688
6511,JustDoItSascha,2,0.00046,84788,19.50548,434688
6512,justinabrahms,2,0.00046,84790,19.50594,434688
6513,justinko,2,0.00046,84792,19.50640,434688
6514,JustUse,2,0.00046,84794,19.50686,434688
6515,juzhiyuan,2,0.00046,84796,19.50732,434688
6516,jvanhorenbeke,2,0.00046,84798,19.50778,434688
6517,jverhounik,2,0.00046,84800,19.50824,434688
6518,jwangatabsolute,2,0.00046,84802,19.50871,434688
6519,K12609,2,0.00046,84804,19.50917,434688
6520,k1ng440,2,0.00046,84806,19.50963,434688
6521,k72550,2,0.00046,84808,19.51009,434688
6522,kacerr,2,0.00046,84810,19.51055,434688
6523,kaihil,2,0.00046,84812,19.51101,434688
6524,kailunshi,2,0.00046,84814,19.51147,434688
6525,kaitoy,2,0.00046,84816,19.51193,434688
6526,kakireddyp,2,0.00046,84818,19.51239,434688
6527,kamikazechaser,2,0.00046,84820,19.51285,434688
6528,kamyar,2,0.00046,84822,19.51331,434688
6529,karan07krs,2,0.00046,84824,19.51377,434688
6530,karlism,2,0.00046,84826,19.51423,434688
6531,karolzmijewski,2,0.00046,84828,19.51469,434688
6532,karthikc911,2,0.00046,84830,19.51515,434688
6533,kavyabgowda,2,0.00046,84832,19.51561,434688
6534,kawabatas,2,0.00046,84834,19.51607,434688
6535,kbc8894,2,0.00046,84836,19.51653,434688
6536,kcheriyath,2,0.00046,84838,19.51699,434688
6537,keattang,2,0.00046,84840,19.51745,434688
6538,KeemoLV,2,0.00046,84842,19.51791,434688
6539,KelvinAkpobome,2,0.00046,84844,19.51837,434688
6540,kemega,2,0.00046,84846,19.51883,434688
6541,kennytrytek,2,0.00046,84848,19.51929,434688
6542,kenorb,2,0.00046,84850,19.51975,434688
6543,kentquirk,2,0.00046,84852,19.52021,434688
6544,kernelpanic77,2,0.00046,84854,19.52067,434688
6545,kesavkolla,2,0.00046,84856,19.52113,434688
6546,kev1n11,2,0.00046,84858,19.52159,434688
6547,kevinjm39,2,0.00046,84860,19.52205,434688
6548,kevinmatthews-kpmg,2,0.00046,84862,19.52251,434688
6549,kevinniu666,2,0.00046,84864,19.52297,434688
6550,kevinvalk,2,0.00046,84866,19.52343,434688
6551,Kevinwoolworth,2,0.00046,84868,19.52389,434688
6552,khanazad,2,0.00046,84870,19.52435,434688
6553,khapp,2,0.00046,84872,19.52481,434688
6554,khowling,2,0.00046,84874,19.52527,434688
6555,khushboo121,2,0.00046,84876,19.52573,434688
6556,KiddHsieh,2,0.00046,84878,19.52619,434688
6557,kien-truong,2,0.00046,84880,19.52665,434688
6558,kilingzhang,2,0.00046,84882,19.52711,434688
6559,kimcore,2,0.00046,84884,19.52757,434688
6560,kimkybuom123,2,0.00046,84886,19.52803,434688
6561,KingCrunch,2,0.00046,84888,19.52849,434688
6562,kingledion,2,0.00046,84890,19.52895,434688
6563,kiruthi006,2,0.00046,84892,19.52941,434688
6564,kishorkk91,2,0.00046,84894,19.52987,434688
6565,kittylyst,2,0.00046,84896,19.53033,434688
6566,kladiv,2,0.00046,84898,19.53079,434688
6567,klboke,2,0.00046,84900,19.53125,434688
6568,kli-abine,2,0.00046,84902,19.53171,434688
6569,klvchen,2,0.00046,84904,19.53217,434688
6570,Knappek,2,0.00046,84906,19.53263,434688
6571,knowlengr,2,0.00046,84908,19.53309,434688
6572,koanplaned,2,0.00046,84910,19.53355,434688
6573,KolinHuang,2,0.00046,84912,19.53401,434688
6574,komalarg2010,2,0.00046,84914,19.53447,434688
6575,kondas,2,0.00046,84916,19.53493,434688
6576,konekoya,2,0.00046,84918,19.53539,434688
6577,konstantin-tkachuk,2,0.00046,84920,19.53585,434688
6578,korncola,2,0.00046,84922,19.53631,434688
6579,kosportel,2,0.00046,84924,19.53677,434688
6580,KosukeKondo0527,2,0.00046,84926,19.53723,434688
6581,kraangprime,2,0.00046,84928,19.53769,434688
6582,kramarz,2,0.00046,84930,19.53815,434688
6583,krbcmt,2,0.00046,84932,19.53861,434688
6584,krish7919,2,0.00046,84934,19.53907,434688
6585,krvaibhaw,2,0.00046,84936,19.53953,434688
6586,Krzysztof-Lempicki,2,0.00046,84938,19.53999,434688
6587,ksa-real,2,0.00046,84940,19.54045,434688
6588,ksliu58,2,0.00046,84942,19.54091,434688
6589,kstinster,2,0.00046,84944,19.54137,434688
6590,ksuwarna,2,0.00046,84946,19.54183,434688
6591,ktarow,2,0.00046,84948,19.54229,434688
6592,ktroyer,2,0.00046,84950,19.54275,434688
6593,kuizhiqing,2,0.00046,84952,19.54321,434688
6594,kumarvin123,2,0.00046,84954,19.54367,434688
6595,kunalfleethawks,2,0.00046,84956,19.54413,434688
6596,kunaljain0212,2,0.00046,84958,19.54459,434688
6597,kupson,2,0.00046,84960,19.54505,434688
6598,kuroneko25,2,0.00046,84962,19.54551,434688
6599,kururuken,2,0.00046,84964,19.54597,434688
6600,kutysam,2,0.00046,84966,19.54643,434688
6601,kylinxiang70,2,0.00046,84968,19.54689,434688
6602,kyoiora,2,0.00046,84970,19.54735,434688
6603,labyu,2,0.00046,84972,19.54781,434688
6604,lackhoa,2,0.00046,84974,19.54827,434688
6605,laebshade,2,0.00046,84976,19.54873,434688
6606,lanasalameh1,2,0.00046,84978,19.54919,434688
6607,langecode,2,0.00046,84980,19.54965,434688
6608,lassebomh,2,0.00046,84982,19.55011,434688
6609,laurieontech,2,0.00046,84984,19.55057,434688
6610,Laworigin,2,0.00046,84986,19.55103,434688
6611,lazyo666,2,0.00046,84988,19.55149,434688
6612,lazystone,2,0.00046,84990,19.55195,434688
6613,lazywhite,2,0.00046,84992,19.55241,434688
6614,lchimbili,2,0.00046,84994,19.55287,434688
6615,leandrocostam,2,0.00046,84996,19.55333,434688
6616,leandroscardua,2,0.00046,84998,19.55379,434688
6617,leewoobin789,2,0.00046,85000,19.55426,434688
6618,Lehnart,2,0.00046,85002,19.55472,434688
6619,lejard-h,2,0.00046,85004,19.55518,434688
6620,Leo069,2,0.00046,85006,19.55564,434688
6621,leo8a,2,0.00046,85008,19.55610,434688
6622,leolikescoding,2,0.00046,85010,19.55656,434688
6623,leoncard,2,0.00046,85012,19.55702,434688
6624,leonids2005,2,0.00046,85014,19.55748,434688
6625,leontastic,2,0.00046,85016,19.55794,434688
6626,leon-vg,2,0.00046,85018,19.55840,434688
6627,LeonYanghaha,2,0.00046,85020,19.55886,434688
6628,leroy-chen,2,0.00046,85022,19.55932,434688
6629,lewislbr,2,0.00046,85024,19.55978,434688
6630,lfuelling,2,0.00046,85026,19.56024,434688
6631,lfz757077613,2,0.00046,85028,19.56070,434688
6632,li0641hang,2,0.00046,85030,19.56116,434688
6633,LiamStorkey,2,0.00046,85032,19.56162,434688
6634,libsamek,2,0.00046,85034,19.56208,434688
6635,lichuan6,2,0.00046,85036,19.56254,434688
6636,lihongbj,2,0.00046,85038,19.56300,434688
6637,LINDA4042,2,0.00046,85040,19.56346,434688
6638,link89,2,0.00046,85042,19.56392,434688
6639,linuraj,2,0.00046,85044,19.56438,434688
6640,linxuyalun,2,0.00046,85046,19.56484,434688
6641,linyang0625,2,0.00046,85048,19.56530,434688
6642,linzhaoken,2,0.00046,85050,19.56576,434688
6643,lionstack,2,0.00046,85052,19.56622,434688
6644,LittleAaron,2,0.00046,85054,19.56668,434688
6645,LittleChimera,2,0.00046,85056,19.56714,434688
6646,little-guy-lxr,2,0.00046,85058,19.56760,434688
6647,liu0013,2,0.00046,85060,19.56806,434688
6648,liuboaibc,2,0.00046,85062,19.56852,434688
6649,liubo-it,2,0.00046,85064,19.56898,434688
6650,liupengfeiCk,2,0.00046,85066,19.56944,434688
6651,lixia755324,2,0.00046,85068,19.56990,434688
6652,liyangau,2,0.00046,85070,19.57036,434688
6653,liyilun1994,2,0.00046,85072,19.57082,434688
6654,lizfeed,2,0.00046,85074,19.57128,434688
6655,llambiel,2,0.00046,85076,19.57174,434688
6656,lloydchang,2,0.00046,85078,19.57220,434688
6657,lmakarov,2,0.00046,85080,19.57266,434688
6658,lmejbar,2,0.00046,85082,19.57312,434688
6659,lmsurpre,2,0.00046,85084,19.57358,434688
6660,lmzuccarelli,2,0.00046,85086,19.57404,434688
6661,Lobstrosity,2,0.00046,85088,19.57450,434688
6662,logabot,2,0.00046,85090,19.57496,434688
6663,loganmzz,2,0.00046,85092,19.57542,434688
6664,logileifs,2,0.00046,85094,19.57588,434688
6665,longXboy,2,0.00046,85096,19.57634,434688
6666,lordofsystem,2,0.00046,85098,19.57680,434688
6667,Lord-Y,2,0.00046,85100,19.57726,434688
6668,lorenz,2,0.00046,85102,19.57772,434688
6669,lorenzodonini,2,0.00046,85104,19.57818,434688
6670,lorenzomenajem,2,0.00046,85106,19.57864,434688
6671,LostZG,2,0.00046,85108,19.57910,434688
6672,Louhwz,2,0.00046,85110,19.57956,434688
6673,louiewh,2,0.00046,85112,19.58002,434688
6674,LouisStAmour,2,0.00046,85114,19.58048,434688
6675,lovelly,2,0.00046,85116,19.58094,434688
6676,lowkeyliesmyth,2,0.00046,85118,19.58140,434688
6677,lrochette,2,0.00046,85120,19.58186,434688
6678,lrstanley,2,0.00046,85122,19.58232,434688
6679,lsoon3,2,0.00046,85124,19.58278,434688
6680,ltamasi,2,0.00046,85126,19.58324,434688
6681,ltdeoliveira,2,0.00046,85128,19.58370,434688
6682,Luap99,2,0.00046,85130,19.58416,434688
6683,luc99hen,2,0.00046,85132,19.58462,434688
6684,lucasbemol,2,0.00046,85134,19.58508,434688
6685,Luis-TT,2,0.00046,85136,19.58554,434688
6686,lukadriel7,2,0.00046,85138,19.58600,434688
6687,LukasGentele,2,0.00046,85140,19.58646,434688
6688,LukasRupprecht,2,0.00046,85142,19.58692,434688
6689,LukeLaScala,2,0.00046,85144,19.58738,434688
6690,LukeMauldin,2,0.00046,85146,19.58784,434688
6691,Lumiond,2,0.00046,85148,19.58830,434688
6692,Lunartist,2,0.00046,85150,19.58876,434688
6693,luneo7,2,0.00046,85152,19.58922,434688
6694,lunhuijie,2,0.00046,85154,19.58968,434688
6695,LuPan2015,2,0.00046,85156,19.59014,434688
6696,lushenle,2,0.00046,85158,19.59060,434688
6697,lusson-luo,2,0.00046,85160,19.59106,434688
6698,luxaritas,2,0.00046,85162,19.59152,434688
6699,lxd5866,2,0.00046,85164,19.59198,434688
6700,ly123-liu,2,0.00046,85166,19.59244,434688
6701,lyman9966,2,0.00046,85168,19.59290,434688
6702,LYMI2771,2,0.00046,85170,19.59336,434688
6703,lywyue,2,0.00046,85172,19.59382,434688
6704,lyzs90,2,0.00046,85174,19.59428,434688
6705,lz000,2,0.00046,85176,19.59474,434688
6706,lzj47010,2,0.00046,85178,19.59520,434688
6707,m3llo96,2,0.00046,85180,19.59566,434688
6708,m4dm4rtig4n,2,0.00046,85182,19.59612,434688
6709,m4ver1k,2,0.00046,85184,19.59658,434688
6710,mab,2,0.00046,85186,19.59704,434688
6711,mabis,2,0.00046,85188,19.59750,434688
6712,machinly,2,0.00046,85190,19.59796,434688
6713,maciekwisniewski,2,0.00046,85192,19.59842,434688
6714,macon,2,0.00046,85194,19.59888,434688
6715,macrotex,2,0.00046,85196,19.59934,434688
6716,macxs,2,0.00046,85198,19.59980,434688
6717,madhukark,2,0.00046,85200,19.60027,434688
6718,MagicJohnJang,2,0.00046,85202,19.60073,434688
6719,mahadevan-k,2,0.00046,85204,19.60119,434688
6720,Mahalakshmi-HPE,2,0.00046,85206,19.60165,434688
6721,mahendra77024,2,0.00046,85208,19.60211,434688
6722,maheshwariak,2,0.00046,85210,19.60257,434688
6723,mahomedalid,2,0.00046,85212,19.60303,434688
6724,mahtoji,2,0.00046,85214,19.60349,434688
6725,MaiSao,2,0.00046,85216,19.60395,434688
6726,malacoss,2,0.00046,85218,19.60441,434688
6727,maliyan,2,0.00046,85220,19.60487,434688
6728,mamachanko,2,0.00046,85222,19.60533,434688
6729,Manasi25,2,0.00046,85224,19.60579,434688
6730,manedurphy,2,0.00046,85226,19.60625,434688
6731,manelpb,2,0.00046,85228,19.60671,434688
6732,mangokingTW,2,0.00046,85230,19.60717,434688
6733,manju-v,2,0.00046,85232,19.60763,434688
6734,manor-parmar,2,0.00046,85234,19.60809,434688
6735,manosoft,2,0.00046,85236,19.60855,434688
6736,mansing2,2,0.00046,85238,19.60901,434688
6737,mapmiss,2,0.00046,85240,19.60947,434688
6738,marco-developer,2,0.00046,85242,19.60993,434688
6739,marcominetti,2,0.00046,85244,19.61039,434688
6740,margus,2,0.00046,85246,19.61085,434688
6741,marianafranco,2,0.00046,85248,19.61131,434688
6742,mariusvniekerk,2,0.00046,85250,19.61177,434688
6743,markcartertm,2,0.00046,85252,19.61223,434688
6744,markmcgookin,2,0.00046,85254,19.61269,434688
6745,markmsmith,2,0.00046,85256,19.61315,434688
6746,markoposavec,2,0.00046,85258,19.61361,434688
6747,markterm,2,0.00046,85260,19.61407,434688
6748,marlinpierce,2,0.00046,85262,19.61453,434688
6749,marquis-wang,2,0.00046,85264,19.61499,434688
6750,MartinDai,2,0.00046,85266,19.61545,434688
6751,martinohmann,2,0.00046,85268,19.61591,434688
6752,Martyr211,2,0.00046,85270,19.61637,434688
6753,marv254,2,0.00046,85272,19.61683,434688
6754,marx-freedom,2,0.00046,85274,19.61729,434688
6755,masa213f,2,0.00046,85276,19.61775,434688
6756,MaskRay,2,0.00046,85278,19.61821,434688
6757,masonwoodford,2,0.00046,85280,19.61867,434688
6758,masterwishx,2,0.00046,85282,19.61913,434688
6759,mastery-sanket-nagare,2,0.00046,85284,19.61959,434688
6760,masterZSH,2,0.00046,85286,19.62005,434688
6761,mathieu-lemay,2,0.00046,85288,19.62051,434688
6762,mathnitin,2,0.00046,85290,19.62097,434688
6763,matihost,2,0.00046,85292,19.62143,434688
6764,matlegit,2,0.00046,85294,19.62189,434688
6765,Matroxt,2,0.00046,85296,19.62235,434688
6766,mattcopas,2,0.00046,85298,19.62281,434688
6767,MatteoGioioso,2,0.00046,85300,19.62327,434688
6768,matthieu-eck,2,0.00046,85302,19.62373,434688
6769,mattmichal,2,0.00046,85304,19.62419,434688
6770,mattops,2,0.00046,85306,19.62465,434688
6771,mattpr,2,0.00046,85308,19.62511,434688
6772,mattstep,2,0.00046,85310,19.62557,434688
6773,maxcountryman,2,0.00046,85312,19.62603,434688
6774,maxfyk,2,0.00046,85314,19.62649,434688
6775,maxhuebler,2,0.00046,85316,19.62695,434688
6776,maxice8,2,0.00046,85318,19.62741,434688
6777,maxlager13,2,0.00046,85320,19.62787,434688
6778,maxnitze,2,0.00046,85322,19.62833,434688
6779,MaxTaggart,2,0.00046,85324,19.62879,434688
6780,MaxThom,2,0.00046,85326,19.62925,434688
6781,maxvt-tonal,2,0.00046,85328,19.62971,434688
6782,max-wittig,2,0.00046,85330,19.63017,434688
6783,mayankkhullar,2,0.00046,85332,19.63063,434688
6784,mayocream,2,0.00046,85334,19.63109,434688
6785,mbaglole,2,0.00046,85336,19.63155,434688
6786,mbleichner,2,0.00046,85338,19.63201,434688
6787,mbrg,2,0.00046,85340,19.63247,434688
6788,mbt-test,2,0.00046,85342,19.63293,434688
6789,mburumaxwell,2,0.00046,85344,19.63339,434688
6790,mcginne,2,0.00046,85346,19.63385,434688
6791,mcoberly2,2,0.00046,85348,19.63431,434688
6792,mconner,2,0.00046,85350,19.63477,434688
6793,mdehollander,2,0.00046,85352,19.63523,434688
6794,mdiianni,2,0.00046,85354,19.63569,434688
6795,mdnyeemakhtar,2,0.00046,85356,19.63615,434688
6796,meabed,2,0.00046,85358,19.63661,434688
6797,medgar-nitric,2,0.00046,85360,19.63707,434688
6798,megha1906,2,0.00046,85362,19.63753,434688
6799,mehrankamal,2,0.00046,85364,19.63799,434688
6800,meidlinga,2,0.00046,85366,19.63845,434688
6801,meilihao,2,0.00046,85368,19.63891,434688
6802,menezesbrindon,2,0.00046,85370,19.63937,434688
6803,menglong21,2,0.00046,85372,19.63983,434688
6804,mengxifl,2,0.00046,85374,19.64029,434688
6805,menih,2,0.00046,85376,19.64075,434688
6806,mevech,2,0.00046,85378,19.64121,434688
6807,mfbieber,2,0.00046,85380,19.64167,434688
6808,mfinelli,2,0.00046,85382,19.64213,434688
6809,mgronst,2,0.00046,85384,19.64259,434688
6810,mhaley-tignis,2,0.00046,85386,19.64305,434688
6811,michaelandrepearce,2,0.00046,85388,19.64351,434688
6812,michael-doubez,2,0.00046,85390,19.64397,434688
6813,michaeljmarshall,2,0.00046,85392,19.64443,434688
6814,michaelkotelnikov,2,0.00046,85394,19.64489,434688
6815,michalbiesek,2,0.00046,85396,19.64535,434688
6816,michlch,2,0.00046,85398,19.64581,434688
6817,micimize,2,0.00046,85400,19.64628,434688
6818,mick1627,2,0.00046,85402,19.64674,434688
6819,mickael-carl,2,0.00046,85404,19.64720,434688
6820,miguepintor,2,0.00046,85406,19.64766,434688
6821,mihaisee,2,0.00046,85408,19.64812,434688
6822,mikegajda,2,0.00046,85410,19.64858,434688
6823,MikolajMGT,2,0.00046,85412,19.64904,434688
6824,milakosc,2,0.00046,85414,19.64950,434688
6825,milindw96,2,0.00046,85416,19.64996,434688
6826,millermatt,2,0.00046,85418,19.65042,434688
6827,ming08108,2,0.00046,85420,19.65088,434688
6828,ming535,2,0.00046,85422,19.65134,434688
6829,mingqiangyin,2,0.00046,85424,19.65180,434688
6830,mingqishao,2,0.00046,85426,19.65226,434688
6831,miraculixx,2,0.00046,85428,19.65272,434688
6832,miraculli,2,0.00046,85430,19.65318,434688
6833,mirespace,2,0.00046,85432,19.65364,434688
6834,mirii1994,2,0.00046,85434,19.65410,434688
6835,misanthropicat,2,0.00046,85436,19.65456,434688
6836,MischaWeerwag,2,0.00046,85438,19.65502,434688
6837,missedone,2,0.00046,85440,19.65548,434688
6838,misteruly,2,0.00046,85442,19.65594,434688
6839,mitchese,2,0.00046,85444,19.65640,434688
6840,mityayak,2,0.00046,85446,19.65686,434688
6841,mizunos,2,0.00046,85448,19.65732,434688
6842,mjkota,2,0.00046,85450,19.65778,434688
6843,mkroening,2,0.00046,85452,19.65824,434688
6844,mkustermann,2,0.00046,85454,19.65870,434688
6845,mlromramse,2,0.00046,85456,19.65916,434688
6846,mnp,2,0.00046,85458,19.65962,434688
6847,mohalahmad,2,0.00046,85460,19.66008,434688
6848,mohanrajatnetapp,2,0.00046,85462,19.66054,434688
6849,mohitsaxenaknoldus,2,0.00046,85464,19.66100,434688
6850,monali-2210,2,0.00046,85466,19.66146,434688
6851,monkey1016,2,0.00046,85468,19.66192,434688
6852,Monska85,2,0.00046,85470,19.66238,434688
6853,Monte-Christo,2,0.00046,85472,19.66284,434688
6854,mor619dx,2,0.00046,85474,19.66330,434688
6855,mostafaez,2,0.00046,85476,19.66376,434688
6856,Mostafakhedri,2,0.00046,85478,19.66422,434688
6857,MostafaNegim,2,0.00046,85480,19.66468,434688
6858,moswil,2,0.00046,85482,19.66514,434688
6859,Moulick,2,0.00046,85484,19.66560,434688
6860,MoYuanDan,2,0.00046,85486,19.66606,434688
6861,mpalczynski,2,0.00046,85488,19.66652,434688
6862,mpoitras,2,0.00046,85490,19.66698,434688
6863,mpomarole,2,0.00046,85492,19.66744,434688
6864,mpreu,2,0.00046,85494,19.66790,434688
6865,mprimi,2,0.00046,85496,19.66836,434688
6866,mqsoh,2,0.00046,85498,19.66882,434688
6867,mrmartan,2,0.00046,85500,19.66928,434688
6868,MrSsunlight,2,0.00046,85502,19.66974,434688
6869,msarvar,2,0.00046,85504,19.67020,434688
6870,mscottini,2,0.00046,85506,19.67066,434688
6871,msc-xdev,2,0.00046,85508,19.67112,434688
6872,msfidelis,2,0.00046,85510,19.67158,434688
6873,msiemens,2,0.00046,85512,19.67204,434688
6874,msmerc,2,0.00046,85514,19.67250,434688
6875,mstg,2,0.00046,85516,19.67296,434688
6876,mt185257,2,0.00046,85518,19.67342,434688
6877,mtalbot,2,0.00046,85520,19.67388,434688
6878,mtarng,2,0.00046,85522,19.67434,434688
6879,mtesseract,2,0.00046,85524,19.67480,434688
6880,mtiop,2,0.00046,85526,19.67526,434688
6881,mufaddal7,2,0.00046,85528,19.67572,434688
6882,muffl0n,2,0.00046,85530,19.67618,434688
6883,muhanator,2,0.00046,85532,19.67664,434688
6884,Mukhammadamin2002,2,0.00046,85534,19.67710,434688
6885,murki,2,0.00046,85536,19.67756,434688
6886,mushycode,2,0.00046,85538,19.67802,434688
6887,mustafacansevinc,2,0.00046,85540,19.67848,434688
6888,Mutantt,2,0.00046,85542,19.67894,434688
6889,mvoitko,2,0.00046,85544,19.67940,434688
6890,mwkroening,2,0.00046,85546,19.67986,434688
6891,MydroX,2,0.00046,85548,19.68032,434688
6892,myoung3,2,0.00046,85550,19.68078,434688
6893,MyoungHaSong,2,0.00046,85552,19.68124,434688
6894,MysteryBlokHed,2,0.00046,85554,19.68170,434688
6895,n27051538,2,0.00046,85556,19.68216,434688
6896,nairb774,2,0.00046,85558,19.68262,434688
6897,nanassito,2,0.00046,85560,19.68308,434688
6898,nandajavarma,2,0.00046,85562,19.68354,434688
6899,NaN-git,2,0.00046,85564,19.68400,434688
6900,Nanyte25,2,0.00046,85566,19.68446,434688
6901,NaraLuwan,2,0.00046,85568,19.68492,434688
6902,nareshpandianpc,2,0.00046,85570,19.68538,434688
6903,naude-r,2,0.00046,85572,19.68584,434688
6904,navarrothiago,2,0.00046,85574,19.68630,434688
6905,NaveenVastare,2,0.00046,85576,19.68676,434688
6906,navid-dada,2,0.00046,85578,19.68722,434688
6907,nayanex,2,0.00046,85580,19.68768,434688
6908,nazufel,2,0.00046,85582,19.68814,434688
6909,nbblum,2,0.00046,85584,19.68860,434688
6910,ndemeshchenko,2,0.00046,85586,19.68906,434688
6911,ndhanushkodi,2,0.00046,85588,19.68952,434688
6912,need2buy,2,0.00046,85590,19.68998,434688
6913,neeharreddy93,2,0.00046,85592,19.69044,434688
6914,neelayu,2,0.00046,85594,19.69090,434688
6915,neil465,2,0.00046,85596,19.69136,434688
6916,neinatu,2,0.00046,85598,19.69182,434688
6917,nelaaro,2,0.00046,85600,19.69229,434688
6918,nelson-wu,2,0.00046,85602,19.69275,434688
6919,nemacysts,2,0.00046,85604,19.69321,434688
6920,nervo,2,0.00046,85606,19.69367,434688
6921,netcho,2,0.00046,85608,19.69413,434688
6922,neWs1587,2,0.00046,85610,19.69459,434688
6923,nfoerster,2,0.00046,85612,19.69505,434688
6924,ngc104,2,0.00046,85614,19.69551,434688
6925,nhatfield,2,0.00046,85616,19.69597,434688
6926,nickcaballero,2,0.00046,85618,19.69643,434688
6927,NickEm,2,0.00046,85620,19.69689,434688
6928,NickHuangA,2,0.00046,85622,19.69735,434688
6929,nickmonad,2,0.00046,85624,19.69781,434688
6930,nickperry,2,0.00046,85626,19.69827,434688
6931,nickrandolph,2,0.00046,85628,19.69873,434688
6932,nicolass67,2,0.00046,85630,19.69919,434688
6933,nicoleyson,2,0.00046,85632,19.69965,434688
6934,niko2,2,0.00046,85634,19.70011,434688
6935,nikoncode,2,0.00046,85636,19.70057,434688
6936,nikskiz,2,0.00046,85638,19.70103,434688
6937,nilayasiktoprak,2,0.00046,85640,19.70149,434688
6938,niloc132,2,0.00046,85642,19.70195,434688
6939,niltongouveajr,2,0.00046,85644,19.70241,434688
6940,niltonvasques,2,0.00046,85646,19.70287,434688
6941,nitaliya,2,0.00046,85648,19.70333,434688
6942,Nitive,2,0.00046,85650,19.70379,434688
6943,nizarakbarm,2,0.00046,85652,19.70425,434688
6944,nkraemer-sysdig,2,0.00046,85654,19.70471,434688
6945,nmgeek,2,0.00046,85656,19.70517,434688
6946,nmiyake,2,0.00046,85658,19.70563,434688
6947,nneram,2,0.00046,85660,19.70609,434688
6948,nngo,2,0.00046,85662,19.70655,434688
6949,noahdav,2,0.00046,85664,19.70701,434688
6950,nohack,2,0.00046,85666,19.70747,434688
6951,nokernel,2,0.00046,85668,19.70793,434688
6952,Nold360,2,0.00046,85670,19.70839,434688
6953,noly,2,0.00046,85672,19.70885,434688
6954,nomcopter,2,0.00046,85674,19.70931,434688
6955,norbertkeri,2,0.00046,85676,19.70977,434688
6956,nosmolovskiy,2,0.00046,85678,19.71023,434688
6957,notchairmk,2,0.00046,85680,19.71069,434688
6958,nroose,2,0.00046,85682,19.71115,434688
6959,nsadeh,2,0.00046,85684,19.71161,434688
6960,nshekhar221,2,0.00046,85686,19.71207,434688
6961,ntkme,2,0.00046,85688,19.71253,434688
6962,nullps,2,0.00046,85690,19.71299,434688
6963,nuoyaneasy,2,0.00046,85692,19.71345,434688
6964,Nurlan199206,2,0.00046,85694,19.71391,434688
6965,nyuta01,2,0.00046,85696,19.71437,434688
6966,O-alpha,2,0.00046,85698,19.71483,434688
6967,oaudry,2,0.00046,85700,19.71529,434688
6968,ob,2,0.00046,85702,19.71575,434688
6969,OBess,2,0.00046,85704,19.71621,434688
6970,OceaneLonneux-CAL,2,0.00046,85706,19.71667,434688
6971,odedonato,2,0.00046,85708,19.71713,434688
6972,OferPRTZ,2,0.00046,85710,19.71759,434688
6973,oflisback,2,0.00046,85712,19.71805,434688
6974,oHanafi,2,0.00046,85714,19.71851,434688
6975,ohkinozomu,2,0.00046,85716,19.71897,434688
6976,ojaswa1942,2,0.00046,85718,19.71943,434688
6977,oleg-kulyk,2,0.00046,85720,19.71989,434688
6978,olegz-codefresh,2,0.00046,85722,19.72035,434688
6979,olivercodes,2,0.00046,85724,19.72081,434688
6980,OliverShang,2,0.00046,85726,19.72127,434688
6981,olivielpeau,2,0.00046,85728,19.72173,434688
6982,olivierk7,2,0.00046,85730,19.72219,434688
6983,omer2500,2,0.00046,85732,19.72265,434688
6984,OmerShahzadXoho,2,0.00046,85734,19.72311,434688
6985,omesser,2,0.00046,85736,19.72357,434688
6986,OmkarKirpan,2,0.00046,85738,19.72403,434688
6987,omron93,2,0.00046,85740,19.72449,434688
6988,oneiro-naut,2,0.00046,85742,19.72495,434688
6989,OnyekaIjeh,2,0.00046,85744,19.72541,434688
6990,opendba,2,0.00046,85746,19.72587,434688
6991,opsarno,2,0.00046,85748,19.72633,434688
6992,OranShuster,2,0.00046,85750,19.72679,434688
6993,ordonezf,2,0.00046,85752,19.72725,434688
6994,oreillymj,2,0.00046,85754,19.72771,434688
6995,oren-zohar,2,0.00046,85756,19.72817,434688
6996,origliante,2,0.00046,85758,19.72863,434688
6997,OscardR,2,0.00046,85760,19.72909,434688
6998,ospatil,2,0.00046,85762,19.72955,434688
6999,ossinkine,2,0.00046,85764,19.73001,434688
7000,ounijang,2,0.00046,85766,19.73047,434688
7001,ovidiubuligan,2,0.00046,85768,19.73093,434688
7002,oweise,2,0.00046,85770,19.73139,434688
7003,p4pramod,2,0.00046,85772,19.73185,434688
7004,paigerube14,2,0.00046,85774,19.73231,434688
7005,pallavgupta,2,0.00046,85776,19.73277,434688
7006,paltaa,2,0.00046,85778,19.73323,434688
7007,pankaj-dahiya,2,0.00046,85780,19.73369,434688
7008,paologallinaharbur,2,0.00046,85782,19.73415,434688
7009,Parcley,2,0.00046,85784,19.73461,434688
7010,parkzhou0527,2,0.00046,85786,19.73507,434688
7011,paroque28,2,0.00046,85788,19.73553,434688
7012,parsley42,2,0.00046,85790,19.73599,434688
7013,partsauthority,2,0.00046,85792,19.73645,434688
7014,parul5sahoo,2,0.00046,85794,19.73691,434688
7015,patrick-codaio,2,0.00046,85796,19.73737,434688
7016,patrickdappollonio,2,0.00046,85798,19.73783,434688
7017,Patrick-Remy,2,0.00046,85800,19.73830,434688
7018,PatTheSilent,2,0.00046,85802,19.73876,434688
7019,paulliss,2,0.00046,85804,19.73922,434688
7020,paulmaksimovich,2,0.00046,85806,19.73968,434688
7021,pavanshahm,2,0.00046,85808,19.74014,434688
7022,pawanyoda,2,0.00046,85810,19.74060,434688
7023,paxnil,2,0.00046,85812,19.74106,434688
7024,paymog,2,0.00046,85814,19.74152,434688
7025,pboennig,2,0.00046,85816,19.74198,434688
7026,pczora,2,0.00046,85818,19.74244,434688
7027,pdhar-tibco,2,0.00046,85820,19.74290,434688
7028,peang,2,0.00046,85822,19.74336,434688
7029,PearceDuan,2,0.00046,85824,19.74382,434688
7030,pearcemc,2,0.00046,85826,19.74428,434688
7031,pedro-mandeville,2,0.00046,85828,19.74474,434688
7032,PendaGTP,2,0.00046,85830,19.74520,434688
7033,perosb,2,0.00046,85832,19.74566,434688
7034,petegrimsdale,2,0.00046,85834,19.74612,434688
7035,petejespersqbe,2,0.00046,85836,19.74658,434688
7036,petermicuch,2,0.00046,85838,19.74704,434688
7037,peterpogorski,2,0.00046,85840,19.74750,434688
7038,Peter-Sh,2,0.00046,85842,19.74796,434688
7039,petreski,2,0.00046,85844,19.74842,434688
7040,petrkr,2,0.00046,85846,19.74888,434688
7041,petrosagg,2,0.00046,85848,19.74934,434688
7042,PetruGarstea,2,0.00046,85850,19.74980,434688
7043,petrukngantuk,2,0.00046,85852,19.75026,434688
7044,pettersv,2,0.00046,85854,19.75072,434688
7045,phalli,2,0.00046,85856,19.75118,434688
7046,phantomnat,2,0.00046,85858,19.75164,434688
7047,Phantsure,2,0.00046,85860,19.75210,434688
7048,phil777,2,0.00046,85862,19.75256,434688
7049,philipgloot,2,0.00046,85864,19.75302,434688
7050,philxiao,2,0.00046,85866,19.75348,434688
7051,phoolish,2,0.00046,85868,19.75394,434688
7052,phracek,2,0.00046,85870,19.75440,434688
7053,phumpal,2,0.00046,85872,19.75486,434688
7054,pierreyvesv,2,0.00046,85874,19.75532,434688
7055,pikodd,2,0.00046,85876,19.75578,434688
7056,pikrzysztof,2,0.00046,85878,19.75624,434688
7057,pinaki124,2,0.00046,85880,19.75670,434688
7058,pindamonhangaba,2,0.00046,85882,19.75716,434688
7059,pingcrosby,2,0.00046,85884,19.75762,434688
7060,pingsutw,2,0.00046,85886,19.75808,434688
7061,piotrbelina,2,0.00046,85888,19.75854,434688
7062,piyat,2,0.00046,85890,19.75900,434688
7063,piyush94,2,0.00046,85892,19.75946,434688
7064,pjshort22,2,0.00046,85894,19.75992,434688
7065,pkalever,2,0.00046,85896,19.76038,434688
7066,pkathro,2,0.00046,85898,19.76084,434688
7067,pkatira,2,0.00046,85900,19.76130,434688
7068,pkwarren,2,0.00046,85902,19.76176,434688
7069,plutino,2,0.00046,85904,19.76222,434688
7070,pmadhvi,2,0.00046,85906,19.76268,434688
7071,pmusa,2,0.00046,85908,19.76314,434688
7072,pnatraj,2,0.00046,85910,19.76360,434688
7073,poadhika,2,0.00046,85912,19.76406,434688
7074,polarG,2,0.00046,85914,19.76452,434688
7075,porg,2,0.00046,85916,19.76498,434688
7076,portertech,2,0.00046,85918,19.76544,434688
7077,pparshin,2,0.00046,85920,19.76590,434688
7078,pparth,2,0.00046,85922,19.76636,434688
7079,ppathard,2,0.00046,85924,19.76682,434688
7080,pposca,2,0.00046,85926,19.76728,434688
7081,prabhinmp,2,0.00046,85928,19.76774,434688
7082,pradeepgoldfields,2,0.00046,85930,19.76820,434688
7083,pradeepnnv,2,0.00046,85932,19.76866,434688
7084,prajwal72556,2,0.00046,85934,19.76912,434688
7085,Prakhar-FF13,2,0.00046,85936,19.76958,434688
7086,pranay202,2,0.00046,85938,19.77004,434688
7087,prasanna2692,2,0.00046,85940,19.77050,434688
7088,prateek0394,2,0.00046,85942,19.77096,434688
7089,prateekmali,2,0.00046,85944,19.77142,434688
7090,pratibha11197,2,0.00046,85946,19.77188,434688
7091,Pratikmehta1729,2,0.00046,85948,19.77234,434688
7092,preslavgerchev,2,0.00046,85950,19.77280,434688
7093,prince-melvin,2,0.00046,85952,19.77326,434688
7094,priyamshet,2,0.00046,85954,19.77372,434688
7095,prnvkv,2,0.00046,85956,19.77418,434688
7096,productml-ai,2,0.00046,85958,19.77464,434688
7097,project-administrator,2,0.00046,85960,19.77510,434688
7098,projx,2,0.00046,85962,19.77556,434688
7099,ps-19,2,0.00046,85964,19.77602,434688
7100,pschrey2,2,0.00046,85966,19.77648,434688
7101,pshendre1,2,0.00046,85968,19.77694,434688
7102,PSjoe,2,0.00046,85970,19.77740,434688
7103,psolarcz,2,0.00046,85972,19.77786,434688
7104,PulkitSinghDev,2,0.00046,85974,19.77832,434688
7105,pvsone,2,0.00046,85976,19.77878,434688
7106,PWaksman,2,0.00046,85978,19.77924,434688
7107,pzheng1025,2,0.00046,85980,19.77970,434688
7108,qalinn,2,0.00046,85982,19.78016,434688
7109,QaSajjad,2,0.00046,85984,19.78062,434688
7110,qdongxu,2,0.00046,85986,19.78108,434688
7111,qinxx108,2,0.00046,85988,19.78154,434688
7112,qkflies,2,0.00046,85990,19.78200,434688
7113,qpakzk,2,0.00046,85992,19.78246,434688
7114,qq772819554,2,0.00046,85994,19.78292,434688
7115,QQGoblin,2,0.00046,85996,19.78338,434688
7116,qsyqian,2,0.00046,85998,19.78384,434688
7117,quadrinho,2,0.00046,86000,19.78431,434688
7118,quantumsheep,2,0.00046,86002,19.78477,434688
7119,Queetinliu,2,0.00046,86004,19.78523,434688
7120,quentingodeau,2,0.00046,86006,19.78569,434688
7121,qugeppl,2,0.00046,86008,19.78615,434688
7122,quintesse,2,0.00046,86010,19.78661,434688
7123,qweeah,2,0.00046,86012,19.78707,434688
7124,r0zbot,2,0.00046,86014,19.78753,434688
7125,rachittshah,2,0.00046,86016,19.78799,434688
7126,radoslav-tomov,2,0.00046,86018,19.78845,434688
7127,raffis,2,0.00046,86020,19.78891,434688
7128,raghvenders,2,0.00046,86022,19.78937,434688
7129,rahdeck,2,0.00046,86024,19.78983,434688
7130,Rahul7171,2,0.00046,86026,19.79029,434688
7131,rahulinux,2,0.00046,86028,19.79075,434688
7132,rahulshinde11,2,0.00046,86030,19.79121,434688
7133,rajatgoyal247341,2,0.00046,86032,19.79167,434688
7134,rajeshnailwal,2,0.00046,86034,19.79213,434688
7135,rajuAhmed1705,2,0.00046,86036,19.79259,434688
7136,raminorujov,2,0.00046,86038,19.79305,434688
7137,ramondeklein,2,0.00046,86040,19.79351,434688
7138,ramshazar,2,0.00046,86042,19.79397,434688
7139,Rand-Random,2,0.00046,86044,19.79443,434688
7140,randysimplist,2,0.00046,86046,19.79489,434688
7141,rangsan,2,0.00046,86048,19.79535,434688
7142,raonelakurti,2,0.00046,86050,19.79581,434688
7143,raphaelauv,2,0.00046,86052,19.79627,434688
7144,RaSerge,2,0.00046,86054,19.79673,434688
7145,RashmiRam,2,0.00046,86056,19.79719,434688
7146,rasta-rocket,2,0.00046,86058,19.79765,434688
7147,RaulButuc,2,0.00046,86060,19.79811,434688
7148,raulsh,2,0.00046,86062,19.79857,434688
7149,raul-te,2,0.00046,86064,19.79903,434688
7150,rbalagopalakrishna,2,0.00046,86066,19.79949,434688
7151,rbounds,2,0.00046,86068,19.79995,434688
7152,rcreasey,2,0.00046,86070,19.80041,434688
7153,reasland,2,0.00046,86072,19.80087,434688
7154,RE-codes,2,0.00046,86074,19.80133,434688
7155,red-chen,2,0.00046,86076,19.80179,434688
7156,reduardo7,2,0.00046,86078,19.80225,434688
7157,RelyanceRachel,2,0.00046,86080,19.80271,434688
7158,remisauvat,2,0.00046,86082,19.80317,434688
7159,renatomjr,2,0.00046,86084,19.80363,434688
7160,Renaud009,2,0.00046,86086,19.80409,434688
7161,renjikari,2,0.00046,86088,19.80455,434688
7162,rensx5514,2,0.00046,86090,19.80501,434688
7163,resullar-vince,2,0.00046,86092,19.80547,434688
7164,Retna-Gjensidige,2,0.00046,86094,19.80593,434688
7165,RetWolf,2,0.00046,86096,19.80639,434688
7166,rfkeith,2,0.00046,86098,19.80685,434688
7167,rgroemmer,2,0.00046,86100,19.80731,434688
7168,rhavenn,2,0.00046,86102,19.80777,434688
7169,RHuehne,2,0.00046,86104,19.80823,434688
7170,riandyrn,2,0.00046,86106,19.80869,434688
7171,ricardf,2,0.00046,86108,19.80915,434688
7172,ricardojdsilva87,2,0.00046,86110,19.80961,434688
7173,ricardotasso,2,0.00046,86112,19.81007,434688
7174,richard77,2,0.00046,86114,19.81053,434688
7175,richard-bain,2,0.00046,86116,19.81099,434688
7176,richardchen-db,2,0.00046,86118,19.81145,434688
7177,richardsonmbr,2,0.00046,86120,19.81191,434688
7178,rickiey,2,0.00046,86122,19.81237,434688
7179,rick-pri,2,0.00046,86124,19.81283,434688
7180,RileySohn,2,0.00046,86126,19.81329,434688
7181,rimager,2,0.00046,86128,19.81375,434688
7182,Rishantkr,2,0.00046,86130,19.81421,434688
7183,risinger,2,0.00046,86132,19.81467,434688
7184,ritikaaa17,2,0.00046,86134,19.81513,434688
7185,rjk2147,2,0.00046,86136,19.81559,434688
7186,rkailashramesh,2,0.00046,86138,19.81605,434688
7187,rkulow,2,0.00046,86140,19.81651,434688
7188,rmanny,2,0.00046,86142,19.81697,434688
7189,rmrf,2,0.00046,86144,19.81743,434688
7190,rnjudge,2,0.00046,86146,19.81789,434688
7191,robblovell,2,0.00046,86148,19.81835,434688
7192,robejfarr,2,0.00046,86150,19.81881,434688
7193,robert-csdisco,2,0.00046,86152,19.81927,434688
7194,robert-heinzmann-logmein,2,0.00046,86154,19.81973,434688
7195,robertjsullivan,2,0.00046,86156,19.82019,434688
7196,robertoriv,2,0.00046,86158,19.82065,434688
7197,robertprast,2,0.00046,86160,19.82111,434688
7198,RobertRosca,2,0.00046,86162,19.82157,434688
7199,robinshine,2,0.00046,86164,19.82203,434688
7200,robinwolny,2,0.00046,86166,19.82249,434688
7201,robzor92,2,0.00046,86168,19.82295,434688
7202,roderickm,2,0.00046,86170,19.82341,434688
7203,rodrigobercini,2,0.00046,86172,19.82387,434688
7204,roee88,2,0.00046,86174,19.82433,434688
7205,roguh,2,0.00046,86176,19.82479,434688
7206,RohanMishra97,2,0.00046,86178,19.82525,434688
7207,rohitChaware,2,0.00046,86180,19.82571,434688
7208,roimor,2,0.00046,86182,19.82617,434688
7209,roko99,2,0.00046,86184,19.82663,434688
7210,romankolpak,2,0.00046,86186,19.82709,434688
7211,ronaldslc,2,0.00046,86188,19.82755,434688
7212,roobre,2,0.00046,86190,19.82801,434688
7213,rootdeep,2,0.00046,86192,19.82847,434688
7214,Roshan13046,2,0.00046,86194,19.82893,434688
7215,rosmo,2,0.00046,86196,19.82939,434688
7216,roson9527,2,0.00046,86198,19.82985,434688
7217,ross211,2,0.00046,86200,19.83032,434688
7218,rotskyi,2,0.00046,86202,19.83078,434688
7219,Rovanion,2,0.00046,86204,19.83124,434688
7220,roygabriel,2,0.00046,86206,19.83170,434688
7221,rr-aakash-chandarana,2,0.00046,86208,19.83216,434688
7222,rsalmond,2,0.00046,86210,19.83262,434688
7223,RSE132,2,0.00046,86212,19.83308,434688
7224,rsteube,2,0.00046,86214,19.83354,434688
7225,rt-13,2,0.00046,86216,19.83400,434688
7226,rupelu,2,0.00046,86218,19.83446,434688
7227,ruslan-byondxr,2,0.00046,86220,19.83492,434688
7228,rvalle,2,0.00046,86222,19.83538,434688
7229,rwbergstrom,2,0.00046,86224,19.83584,434688
7230,rwilliams0331,2,0.00046,86226,19.83630,434688
7231,ryadavdevSecOps,2,0.00046,86228,19.83676,434688
7232,rychuhardy,2,0.00046,86230,19.83722,434688
7233,RyuunoAelia,2,0.00046,86232,19.83768,434688
7234,saba-bakhshi,2,0.00046,86234,19.83814,434688
7235,sabir-piludiya,2,0.00046,86236,19.83860,434688
7236,sachet-synapsefi,2,0.00046,86238,19.83906,434688
7237,SachinVarghese,2,0.00046,86240,19.83952,434688
7238,SahilPatidar,2,0.00046,86242,19.83998,434688
7239,saidben7243,2,0.00046,86244,19.84044,434688
7240,saikalyan551,2,0.00046,86246,19.84090,434688
7241,Saikiranbelana,2,0.00046,86248,19.84136,434688
7242,saikrishna4d8,2,0.00046,86250,19.84182,434688
7243,SaintDubious,2,0.00046,86252,19.84228,434688
7244,saintmalik,2,0.00046,86254,19.84274,434688
7245,Saipavan018,2,0.00046,86256,19.84320,434688
7246,sairamvoggu1007,2,0.00046,86258,19.84366,434688
7247,saiyidi,2,0.00046,86260,19.84412,434688
7248,sajjadG,2,0.00046,86262,19.84458,434688
7249,sakshamb2113,2,0.00046,86264,19.84504,434688
7250,salmanisd,2,0.00046,86266,19.84550,434688
7251,SaltedEggIndomee,2,0.00046,86268,19.84596,434688
7252,samarth1029,2,0.00046,86270,19.84642,434688
7253,samatharkar,2,0.00046,86272,19.84688,434688
7254,samhuangszu,2,0.00046,86274,19.84734,434688
7255,samirparhi-dev,2,0.00046,86276,19.84780,434688
7256,sami-tin,2,0.00046,86278,19.84826,434688
7257,samouss,2,0.00046,86280,19.84872,434688
7258,SamWheating,2,0.00046,86282,19.84918,434688
7259,sanchayanghosh,2,0.00046,86284,19.84964,434688
7260,sanderdam,2,0.00046,86286,19.85010,434688
7261,SanggoroZX2C4,2,0.00046,86288,19.85056,434688
7262,sanjeevpandey19,2,0.00046,86290,19.85102,434688
7263,sanjimoh,2,0.00046,86292,19.85148,434688
7264,santoshankr,2,0.00046,86294,19.85194,434688
7265,sarangrana,2,0.00046,86296,19.85240,434688
7266,saranyaeu2987,2,0.00046,86298,19.85286,434688
7267,sarathkgit,2,0.00046,86300,19.85332,434688
7268,sarthak40,2,0.00046,86302,19.85378,434688
7269,sata,2,0.00046,86304,19.85424,434688
7270,satishreddys,2,0.00046,86306,19.85470,434688
7271,satrushn,2,0.00046,86308,19.85516,434688
7272,SatyKrish,2,0.00046,86310,19.85562,434688
7273,savilesupgrade,2,0.00046,86312,19.85608,434688
7274,sbensdorp,2,0.00046,86314,19.85654,434688
7275,sbussard,2,0.00046,86316,19.85700,434688
7276,SchrodingerZhu,2,0.00046,86318,19.85746,434688
7277,sci110680,2,0.00046,86320,19.85792,434688
7278,scjudd,2,0.00046,86322,19.85838,434688
7279,SDedik,2,0.00046,86324,19.85884,434688
7280,sdelrio,2,0.00046,86326,19.85930,434688
7281,sealneaward,2,0.00046,86328,19.85976,434688
7282,sean-nixon,2,0.00046,86330,19.86022,434688
7283,Seanspt,2,0.00046,86332,19.86068,434688
7284,sebastianbrosch,2,0.00046,86334,19.86114,434688
7285,sebastianbuechler,2,0.00046,86336,19.86160,434688
7286,sebastian-mora,2,0.00046,86338,19.86206,434688
7287,SebastianStehle,2,0.00046,86340,19.86252,434688
7288,sebt3,2,0.00046,86342,19.86298,434688
7289,SenCoder,2,0.00046,86344,19.86344,434688
7290,senorsmile,2,0.00046,86346,19.86390,434688
7291,seraphlive,2,0.00046,86348,19.86436,434688
7292,sergelogvinov,2,0.00046,86350,19.86482,434688
7293,serihiro,2,0.00046,86352,19.86528,434688
7294,Serk72,2,0.00046,86354,19.86574,434688
7295,seshness,2,0.00046,86356,19.86620,434688
7296,sey,2,0.00046,86358,19.86666,434688
7297,sfc-gh-ddebny,2,0.00046,86360,19.86712,434688
7298,sfuerte,2,0.00046,86362,19.86758,434688
7299,Shabbirm21,2,0.00046,86364,19.86804,434688
7300,Shackelford-Arden,2,0.00046,86366,19.86850,434688
7301,shad2y,2,0.00046,86368,19.86896,434688
7302,shadihh9,2,0.00046,86370,19.86942,434688
7303,ShadowJonathan,2,0.00046,86372,19.86988,434688
7304,Shadowraze228,2,0.00046,86374,19.87034,434688
7305,shadowshot-x,2,0.00046,86376,19.87080,434688
7306,shahriak,2,0.00046,86378,19.87126,434688
7307,Shaked,2,0.00046,86380,19.87172,434688
7308,shamigor,2,0.00046,86382,19.87218,434688
7309,shane-kearns,2,0.00046,86384,19.87264,434688
7310,shankerwangmiao,2,0.00046,86386,19.87310,434688
7311,shanzy20,2,0.00046,86388,19.87356,434688
7312,sharathbabupulumati,2,0.00046,86390,19.87402,434688
7313,shashank0004,2,0.00046,86392,19.87448,434688
7314,shaynevanasperen,2,0.00046,86394,19.87494,434688
7315,sheetaljoshi,2,0.00046,86396,19.87540,434688
7316,shenshouer,2,0.00046,86398,19.87586,434688
7317,sherlockshao,2,0.00046,86400,19.87633,434688
7318,shihaohems,2,0.00046,86402,19.87679,434688
7319,ShinnZhang,2,0.00046,86404,19.87725,434688
7320,shirlyf,2,0.00046,86406,19.87771,434688
7321,shlomitk1,2,0.00046,86408,19.87817,434688
7322,shokerplz,2,0.00046,86410,19.87863,434688
7323,shon-phand,2,0.00046,86412,19.87909,434688
7324,shreevatsa,2,0.00046,86414,19.87955,434688
7325,shshanmu,2,0.00046,86416,19.88001,434688
7326,shuaiqidechuan,2,0.00046,86418,19.88047,434688
7327,shubhindia,2,0.00046,86420,19.88093,434688
7328,shuebner,2,0.00046,86422,19.88139,434688
7329,shvmbisht,2,0.00046,86424,19.88185,434688
7330,shyim,2,0.00046,86426,19.88231,434688
7331,sichan-vonage,2,0.00046,86428,19.88277,434688
7332,sichapman,2,0.00046,86430,19.88323,434688
7333,sidiney-crescencio,2,0.00046,86432,19.88369,434688
7334,SidneyShen,2,0.00046,86434,19.88415,434688
7335,simararneja,2,0.00046,86436,19.88461,434688
7336,simhnna,2,0.00046,86438,19.88507,434688
7337,simonspg,2,0.00046,86440,19.88553,434688
7338,simplyhappydude,2,0.00046,86442,19.88599,434688
7339,singh2005,2,0.00046,86444,19.88645,434688
7340,SingleThread,2,0.00046,86446,19.88691,434688
7341,sinhaashish,2,0.00046,86448,19.88737,434688
7342,sinsoku,2,0.00046,86450,19.88783,434688
7343,sirlori,2,0.00046,86452,19.88829,434688
7344,SirNexus,2,0.00046,86454,19.88875,434688
7345,sishuiliunian,2,0.00046,86456,19.88921,434688
7346,SivaTharun,2,0.00046,86458,19.88967,434688
7347,sixcorners,2,0.00046,86460,19.89013,434688
7348,SJ50,2,0.00046,86462,19.89059,434688
7349,skataboina,2,0.00046,86464,19.89105,434688
7350,skmuz001,2,0.00046,86466,19.89151,434688
7351,skorati,2,0.00046,86468,19.89197,434688
7352,Skreet2k,2,0.00046,86470,19.89243,434688
7353,skw0rm,2,0.00046,86472,19.89289,434688
7354,sky91,2,0.00046,86474,19.89335,434688
7355,skycyan,2,0.00046,86476,19.89381,434688
7356,SLavaLL,2,0.00046,86478,19.89427,434688
7357,SleepyBrett,2,0.00046,86480,19.89473,434688
7358,sljeff,2,0.00046,86482,19.89519,434688
7359,sluetze,2,0.00046,86484,19.89565,434688
7360,smarsh-gregj,2,0.00046,86486,19.89611,434688
7361,smarsh-tim,2,0.00046,86488,19.89657,434688
7362,smilax630,2,0.00046,86490,19.89703,434688
7363,smolkaj,2,0.00046,86492,19.89749,434688
7364,smsufyian,2,0.00046,86494,19.89795,434688
7365,snehal1797,2,0.00046,86496,19.89841,434688
7366,SnowmanCharles,2,0.00046,86498,19.89887,434688
7367,snowsword,2,0.00046,86500,19.89933,434688
7368,sobrinho,2,0.00046,86502,19.89979,434688
7369,sombochea,2,0.00046,86504,19.90025,434688
7370,sonali-mishra-94,2,0.00046,86506,19.90071,434688
7371,sonu-mina,2,0.00046,86508,19.90117,434688
7372,sooheng,2,0.00046,86510,19.90163,434688
7373,sorensonpragmatics,2,0.00046,86512,19.90209,434688
7374,SourMango,2,0.00046,86514,19.90255,434688
7375,souviknsl07,2,0.00046,86516,19.90301,434688
7376,spaivaras,2,0.00046,86518,19.90347,434688
7377,spanktar,2,0.00046,86520,19.90393,434688
7378,sparty02,2,0.00046,86522,19.90439,434688
7379,speedfl,2,0.00046,86524,19.90485,434688
7380,Spikhalskiy,2,0.00046,86526,19.90531,434688
7381,spiritman1990,2,0.00046,86528,19.90577,434688
7382,splooge,2,0.00046,86530,19.90623,434688
7383,spookiej,2,0.00046,86532,19.90669,434688
7384,squashedlime,2,0.00046,86534,19.90715,434688
7385,sravya-a,2,0.00046,86536,19.90761,434688
7386,sreenandan,2,0.00046,86538,19.90807,434688
7387,Sridhar-42,2,0.00046,86540,19.90853,434688
7388,ss1208,2,0.00046,86542,19.90899,434688
7389,sschne,2,0.00046,86544,19.90945,434688
7390,ssivaprathee,2,0.00046,86546,19.90991,434688
7391,ssplatt,2,0.00046,86548,19.91037,434688
7392,st9540808,2,0.00046,86550,19.91083,434688
7393,stanssh,2,0.00046,86552,19.91129,434688
7394,starleaffff,2,0.00046,86554,19.91175,434688
7395,stefan-kolev,2,0.00046,86556,19.91221,434688
7396,stefannegrea,2,0.00046,86558,19.91267,434688
7397,stefanvangastel,2,0.00046,86560,19.91313,434688
7398,steffenb91,2,0.00046,86562,19.91359,434688
7399,stellarpower,2,0.00046,86564,19.91405,434688
7400,stepa-ict,2,0.00046,86566,19.91451,434688
7401,stephanmiehe,2,0.00046,86568,19.91497,434688
7402,stephen-dexda,2,0.00046,86570,19.91543,434688
7403,stephenhatch,2,0.00046,86572,19.91589,434688
7404,Stetchy,2,0.00046,86574,19.91635,434688
7405,steve-bitdotio,2,0.00046,86576,19.91681,434688
7406,Stevecaboose,2,0.00046,86578,19.91727,434688
7407,stevenhorsman,2,0.00046,86580,19.91773,434688
7408,steveniemitz,2,0.00046,86582,19.91819,434688
7409,stevo-f3,2,0.00046,86584,19.91865,434688
7410,stewbernetes,2,0.00046,86586,19.91911,434688
7411,stg609,2,0.00046,86588,19.91957,434688
7412,stockholmux,2,0.00046,86590,19.92003,434688
7413,stolsma,2,0.00046,86592,19.92049,434688
7414,ston1th,2,0.00046,86594,19.92095,434688
7415,stonepd,2,0.00046,86596,19.92141,434688
7416,stormbard,2,0.00046,86598,19.92188,434688
7417,straussb,2,0.00046,86600,19.92234,434688
7418,StreetStrider,2,0.00046,86602,19.92280,434688
7419,striver619,2,0.00046,86604,19.92326,434688
7420,stsully,2,0.00046,86606,19.92372,434688
7421,Subel19,2,0.00046,86608,19.92418,434688
7422,Subhajit-Dutta,2,0.00046,86610,19.92464,434688
7423,sudeep-ib,2,0.00046,86612,19.92510,434688
7424,sudheerpodila,2,0.00046,86614,19.92556,434688
7425,sudo-NithishKarthik,2,0.00046,86616,19.92602,434688
7426,SudoNova,2,0.00046,86618,19.92648,434688
7427,sujeet-agrahari,2,0.00046,86620,19.92694,434688
7428,Sullivan12138,2,0.00046,86622,19.92740,434688
7429,sumitbhagwani,2,0.00046,86624,19.92786,434688
7430,Summpot,2,0.00046,86626,19.92832,434688
7431,summylight,2,0.00046,86628,19.92878,434688
7432,sunshineo,2,0.00046,86630,19.92924,434688
7433,superfly-git,2,0.00046,86632,19.92970,434688
7434,supermqB,2,0.00046,86634,19.93016,434688
7435,suresh-sivanantham-irm,2,0.00046,86636,19.93062,434688
7436,suryart,2,0.00046,86638,19.93108,434688
7437,sushilkumarsah,2,0.00046,86640,19.93154,434688
7438,svallala,2,0.00046,86642,19.93200,434688
7439,svdb-ncc,2,0.00046,86644,19.93246,434688
7440,SvenMW,2,0.00046,86646,19.93292,434688
7441,sveronese,2,0.00046,86648,19.93338,434688
7442,svrc,2,0.00046,86650,19.93384,434688
7443,Svuibes6,2,0.00046,86652,19.93430,434688
7444,sxnguyen,2,0.00046,86654,19.93476,434688
7445,SydMusavi,2,0.00046,86656,19.93522,434688
7446,sylvain-combe-sonarsource,2,0.00046,86658,19.93568,434688
7447,SylvainMachard,2,0.00046,86660,19.93614,434688
7448,syslogic,2,0.00046,86662,19.93660,434688
7449,syy6,2,0.00046,86664,19.93706,434688
7450,szentesik,2,0.00046,86666,19.93752,434688
7451,sziegler-skyhook,2,0.00046,86668,19.93798,434688
7452,TaharInfo,2,0.00046,86670,19.93844,434688
7453,Takmo,2,0.00046,86672,19.93890,434688
7454,TakuKaneda,2,0.00046,86674,19.93936,434688
7455,TalkingQuickly,2,0.00046,86676,19.93982,434688
7456,Tamas-Biro1,2,0.00046,86678,19.94028,434688
7457,tanertopal,2,0.00046,86680,19.94074,434688
7458,tangyang9464,2,0.00046,86682,19.94120,434688
7459,tanmaymoghe,2,0.00046,86684,19.94166,434688
7460,taocnrut,2,0.00046,86686,19.94212,434688
7461,taozix,2,0.00046,86688,19.94258,434688
7462,tapaskapadia,2,0.00046,86690,19.94304,434688
7463,taragurung,2,0.00046,86692,19.94350,434688
7464,Tarasovych,2,0.00046,86694,19.94396,434688
7465,tarioch,2,0.00046,86696,19.94442,434688
7466,tbao2011,2,0.00046,86698,19.94488,434688
7467,tbbharaj,2,0.00046,86700,19.94534,434688
7468,tcnt,2,0.00046,86702,19.94580,434688
7469,technicool,2,0.00046,86704,19.94626,434688
7470,tedhexaflow,2,0.00046,86706,19.94672,434688
7471,tengfeisun,2,0.00046,86708,19.94718,434688
7472,tenstad,2,0.00046,86710,19.94764,434688
7473,Tenzer,2,0.00046,86712,19.94810,434688
7474,teodora-sandu,2,0.00046,86714,19.94856,434688
7475,teonsean-dm,2,0.00046,86716,19.94902,434688
7476,teo-tsou,2,0.00046,86718,19.94948,434688
7477,terefang,2,0.00046,86720,19.94994,434688
7478,testfile2,2,0.00046,86722,19.95040,434688
7479,tfussell,2,0.00046,86724,19.95086,434688
7480,Th0masL,2,0.00046,86726,19.95132,434688
7481,th3M1ke,2,0.00046,86728,19.95178,434688
7482,thakurso,2,0.00046,86730,19.95224,434688
7483,thanaratjaruenying,2,0.00046,86732,19.95270,434688
7484,thatGreekGuy96,2,0.00046,86734,19.95316,434688
7485,TheAschr,2,0.00046,86736,19.95362,434688
7486,TheCodingLab,2,0.00046,86738,19.95408,434688
7487,thedag,2,0.00046,86740,19.95454,434688
7488,Thefy21,2,0.00046,86742,19.95500,434688
7489,thejosephstevens,2,0.00046,86744,19.95546,434688
7490,The-M1k3y,2,0.00046,86746,19.95592,434688
7491,the-papi,2,0.00046,86748,19.95638,434688
7492,thevibhu,2,0.00046,86750,19.95684,434688
7493,thg-adamdean,2,0.00046,86752,19.95730,434688
7494,thglz,2,0.00046,86754,19.95776,434688
7495,ThiboKay,2,0.00046,86756,19.95822,434688
7496,ThisIsNotTheUserYouAreLookingFor,2,0.00046,86758,19.95868,434688
7497,thiyagu247,2,0.00046,86760,19.95914,434688
7498,thomasdziedzic-census,2,0.00046,86762,19.95960,434688
7499,ThomasHenckel,2,0.00046,86764,19.96006,434688
7500,ThoughtHopper,2,0.00046,86766,19.96052,434688
7501,thunder-coding,2,0.00046,86768,19.96098,434688
7502,Tibor17,2,0.00046,86770,19.96144,434688
7503,Tiemma,2,0.00046,86772,19.96190,434688
7504,timcosta,2,0.00046,86774,19.96236,434688
7505,timgriffiths,2,0.00046,86776,19.96282,434688
7506,timmydo,2,0.00046,86778,19.96328,434688
7507,tim-nussbaumer,2,0.00046,86780,19.96374,434688
7508,timothyaws,2,0.00046,86782,19.96420,434688
7509,timox,2,0.00046,86784,19.96466,434688
7510,timricese,2,0.00046,86786,19.96512,434688
7511,tim-sendible,2,0.00046,86788,19.96558,434688
7512,Timvissers,2,0.00046,86790,19.96604,434688
7513,tinder-terrychu,2,0.00046,86792,19.96650,434688
7514,tjkirch,2,0.00046,86794,19.96696,434688
7515,tkbits9,2,0.00046,86796,19.96742,434688
7516,tkielan,2,0.00046,86798,19.96789,434688
7517,tman5,2,0.00046,86800,19.96835,434688
7518,tmeckel,2,0.00046,86802,19.96881,434688
7519,tmojlupo,2,0.00046,86804,19.96927,434688
7520,tmus-brett,2,0.00046,86806,19.96973,434688
7521,tmytlovych-perfectial,2,0.00046,86808,19.97019,434688
7522,tndyd5390,2,0.00046,86810,19.97065,434688
7523,tniessen,2,0.00046,86812,19.97111,434688
7524,TobiasGoerke,2,0.00046,86814,19.97157,434688
7525,tobias-zeptio,2,0.00046,86816,19.97203,434688
7526,Tolsto,2,0.00046,86818,19.97249,434688
7527,tom0010,2,0.00046,86820,19.97295,434688
7528,tomasgareau,2,0.00046,86822,19.97341,434688
7529,TomMD,2,0.00046,86824,19.97387,434688
7530,tommyja,2,0.00046,86826,19.97433,434688
7531,tommylindgren-plejd,2,0.00046,86828,19.97479,434688
7532,tompoch,2,0.00046,86830,19.97525,434688
7533,tompsh,2,0.00046,86832,19.97571,434688
7534,TomSDEVSN,2,0.00046,86834,19.97617,434688
7535,tonyredondo,2,0.00046,86836,19.97663,434688
7536,toohsk,2,0.00046,86838,19.97709,434688
7537,torgeirl,2,0.00046,86840,19.97755,434688
7538,torkelrogstad,2,0.00046,86842,19.97801,434688
7539,toshokan,2,0.00046,86844,19.97847,434688
7540,totogtr,2,0.00046,86846,19.97893,434688
7541,Towerthousand,2,0.00046,86848,19.97939,434688
7542,towfeeqfayaz11,2,0.00046,86850,19.97985,434688
7543,TravelingLex,2,0.00046,86852,19.98031,434688
7544,travisspencer,2,0.00046,86854,19.98077,434688
7545,treeguard,2,0.00046,86856,19.98123,434688
7546,trhr,2,0.00046,86858,19.98169,434688
7547,trinhpham,2,0.00046,86860,19.98215,434688
7548,triThirty,2,0.00046,86862,19.98261,434688
7549,trombini77,2,0.00046,86864,19.98307,434688
7550,trondhindenes-nomono,2,0.00046,86866,19.98353,434688
7551,trotro,2,0.00046,86868,19.98399,434688
7552,TroyThompson1023,2,0.00046,86870,19.98445,434688
7553,true64gurus,2,0.00046,86872,19.98491,434688
7554,trungtranwata,2,0.00046,86874,19.98537,434688
7555,tschmidt64-SC,2,0.00046,86876,19.98583,434688
7556,ttulka,2,0.00046,86878,19.98629,434688
7557,ttyS0,2,0.00046,86880,19.98675,434688
7558,tuananh2508,2,0.00046,86882,19.98721,434688
7559,tudor-turcu,2,0.00046,86884,19.98767,434688
7560,tungdam,2,0.00046,86886,19.98813,434688
7561,tuninger,2,0.00046,86888,19.98859,434688
7562,tuobraun,2,0.00046,86890,19.98905,434688
7563,tusharsappal,2,0.00046,86892,19.98951,434688
7564,tusharsonawanes,2,0.00046,86894,19.98997,434688
7565,tuxinaut,2,0.00046,86896,19.99043,434688
7566,tuxknight,2,0.00046,86898,19.99089,434688
7567,twendt,2,0.00046,86900,19.99135,434688
7568,twghu,2,0.00046,86902,19.99181,434688
7569,TwoStone,2,0.00046,86904,19.99227,434688
7570,TxGVNN,2,0.00046,86906,19.99273,434688
7571,txj-xyz,2,0.00046,86908,19.99319,434688
7572,txsutton,2,0.00046,86910,19.99365,434688
7573,tyichye19,2,0.00046,86912,19.99411,434688
7574,tylerharpool,2,0.00046,86914,19.99457,434688
7575,tynril,2,0.00046,86916,19.99503,434688
7576,tyrone-anz,2,0.00046,86918,19.99549,434688
7577,tzabbi,2,0.00046,86920,19.99595,434688
7578,tzifudzi,2,0.00046,86922,19.99641,434688
7579,uderik,2,0.00046,86924,19.99687,434688
7580,Udit107710,2,0.00046,86926,19.99733,434688
7581,uditanshu23,2,0.00046,86928,19.99779,434688
7582,udleinati,2,0.00046,86930,19.99825,434688
7583,udoyen,2,0.00046,86932,19.99871,434688
7584,ufcurmcginty,2,0.00046,86934,19.99917,434688
7585,uhziel,2,0.00046,86936,19.99963,434688
7586,ukd1,2,0.00046,86938,20.00009,434688
7587,UliKu,2,0.00046,86940,20.00055,434688
7588,Ultrafenrir,2,0.00046,86942,20.00101,434688
7589,umesh-cloudside,2,0.00046,86944,20.00147,434688
7590,umeshkumhar,2,0.00046,86946,20.00193,434688
7591,umutpiri,2,0.00046,86948,20.00239,434688
7592,unb9rn,2,0.00046,86950,20.00285,434688
7593,unleashed,2,0.00046,86952,20.00331,434688
7594,unni-kr,2,0.00046,86954,20.00377,434688
7595,upstream-dmahlberg,2,0.00046,86956,20.00423,434688
7596,urpyLLIKa,2,0.00046,86958,20.00469,434688
7597,Ursanon,2,0.00046,86960,20.00515,434688
7598,usrbinkat,2,0.00046,86962,20.00561,434688
7599,ussu,2,0.00046,86964,20.00607,434688
7600,utamas,2,0.00046,86966,20.00653,434688
7601,utk9,2,0.00046,86968,20.00699,434688
7602,uutest74,2,0.00046,86970,20.00745,434688
7603,Vaccano,2,0.00046,86972,20.00791,434688
7604,Vack15109141348,2,0.00046,86974,20.00837,434688
7605,vaibhavdugar,2,0.00046,86976,20.00883,434688
7606,vaibhavvvi,2,0.00046,86978,20.00929,434688
7607,ValClarkson,2,0.00046,86980,20.00975,434688
7608,Vamsi0473,2,0.00046,86982,20.01021,434688
7609,vavdoshka,2,0.00046,86984,20.01067,434688
7610,vedarths,2,0.00046,86986,20.01113,434688
7611,VeitSanner,2,0.00046,86988,20.01159,434688
7612,VengefulAncient,2,0.00046,86990,20.01205,434688
7613,VenkateshSrini,2,0.00046,86992,20.01251,434688
7614,vepo,2,0.00046,86994,20.01297,434688
7615,vgeorgik,2,0.00046,86996,20.01343,434688
7616,vicky-liu,2,0.00046,86998,20.01390,434688
7617,vignesh-goutham,2,0.00046,87000,20.01436,434688
7618,vikborisov,2,0.00046,87002,20.01482,434688
7619,vikram301093,2,0.00046,87004,20.01528,434688
7620,vikramSpringBootApp,2,0.00046,87006,20.01574,434688
7621,villesau,2,0.00046,87008,20.01620,434688
7622,Vilsol,2,0.00046,87010,20.01666,434688
7623,vinnnyr,2,0.00046,87012,20.01712,434688
7624,vinod-trilio,2,0.00046,87014,20.01758,434688
7625,Virajbhise,2,0.00046,87016,20.01804,434688
7626,vishalk-rafay,2,0.00046,87018,20.01850,434688
7627,VishalSharma94,2,0.00046,87020,20.01896,434688
7628,vishaltripathi24,2,0.00046,87022,20.01942,434688
7629,vishu029,2,0.00046,87024,20.01988,434688
7630,vivienfricadelamadeus,2,0.00046,87026,20.02034,434688
7631,vlad-Berg408,2,0.00046,87028,20.02080,434688
7632,VladyslavKurmaz,2,0.00046,87030,20.02126,434688
7633,vmasule,2,0.00046,87032,20.02172,434688
7634,vogtph,2,0.00046,87034,20.02218,434688
7635,VoVAllen,2,0.00046,87036,20.02264,434688
7636,vparchas,2,0.00046,87038,20.02310,434688
7637,vrachok-sc,2,0.00046,87040,20.02356,434688
7638,vrichv,2,0.00046,87042,20.02402,434688
7639,vsuzdaltsev,2,0.00046,87044,20.02448,434688
7640,vsychov,2,0.00046,87046,20.02494,434688
7641,vtomasr5,2,0.00046,87048,20.02540,434688
7642,vumdao,2,0.00046,87050,20.02586,434688
7643,vvdvortsova,2,0.00046,87052,20.02632,434688
7644,w4,2,0.00046,87054,20.02678,434688
7645,wagneripjr,2,0.00046,87056,20.02724,434688
7646,wajdi-datalvo,2,0.00046,87058,20.02770,434688
7647,wajika,2,0.00046,87060,20.02816,434688
7648,wangkang,2,0.00046,87062,20.02862,434688
7649,wangxw666,2,0.00046,87064,20.02908,434688
7650,wangyx1992,2,0.00046,87066,20.02954,434688
7651,wangzhipeng,2,0.00046,87068,20.03000,434688
7652,wangzishuo111,2,0.00046,87070,20.03046,434688
7653,WarlenRodrigues,2,0.00046,87072,20.03092,434688
7654,warlockdn,2,0.00046,87074,20.03138,434688
7655,watkinsmike,2,0.00046,87076,20.03184,434688
7656,waynesi,2,0.00046,87078,20.03230,434688
7657,wdv4758h,2,0.00046,87080,20.03276,434688
7658,wdwangcumt,2,0.00046,87082,20.03322,434688
7659,wdy-0205,2,0.00046,87084,20.03368,434688
7660,weiqingy,2,0.00046,87086,20.03414,434688
7661,weiyuanke,2,0.00046,87088,20.03460,434688
7662,wenjun001,2,0.00046,87090,20.03506,434688
7663,Wenliang-CHEN,2,0.00046,87092,20.03552,434688
7664,wentwog,2,0.00046,87094,20.03598,434688
7665,wernich-vg,2,0.00046,87096,20.03644,434688
7666,wesleyhillyext,2,0.00046,87098,20.03690,434688
7667,wfsly,2,0.00046,87100,20.03736,434688
7668,wfxr,2,0.00046,87102,20.03782,434688
7669,wGEric,2,0.00046,87104,20.03828,434688
7670,WGH-,2,0.00046,87106,20.03874,434688
7671,WhiteBahamut,2,0.00046,87108,20.03920,434688
7672,whytoe,2,0.00046,87110,20.03966,434688
7673,wildone,2,0.00046,87112,20.04012,434688
7674,WillNilges,2,0.00046,87114,20.04058,434688
7675,willyrgf,2,0.00046,87116,20.04104,434688
7676,wind0r,2,0.00046,87118,20.04150,434688
7677,Windrow14,2,0.00046,87120,20.04196,434688
7678,winshenting,2,0.00046,87122,20.04242,434688
7679,wiredin,2,0.00046,87124,20.04288,434688
7680,wjtracey,2,0.00046,87126,20.04334,434688
7681,woaiso,2,0.00046,87128,20.04380,434688
7682,WojciechKarpiel,2,0.00046,87130,20.04426,434688
7683,wojtekmach,2,0.00046,87132,20.04472,434688
7684,woli,2,0.00046,87134,20.04518,434688
7685,Wolskie,2,0.00046,87136,20.04564,434688
7686,woniusnai,2,0.00046,87138,20.04610,434688
7687,woodsongem,2,0.00046,87140,20.04656,434688
7688,wshuler-cfa,2,0.00046,87142,20.04702,434688
7689,wstarzak,2,0.00046,87144,20.04748,434688
7690,wtfacoconut,2,0.00046,87146,20.04794,434688
7691,wt-l00,2,0.00046,87148,20.04840,434688
7692,wufunc,2,0.00046,87150,20.04886,434688
7693,wzzrd,2,0.00046,87152,20.04932,434688
7694,xabinapal,2,0.00046,87154,20.04978,434688
7695,xaionaro,2,0.00046,87156,20.05024,434688
7696,x-debug,2,0.00046,87158,20.05070,434688
7697,xelatirdan,2,0.00046,87160,20.05116,434688
7698,Xendar,2,0.00046,87162,20.05162,434688
7699,Xenorith,2,0.00046,87164,20.05208,434688
7700,xens,2,0.00046,87166,20.05254,434688
7701,xfzen,2,0.00046,87168,20.05300,434688
7702,xhken,2,0.00046,87170,20.05346,434688
7703,xianglin130,2,0.00046,87172,20.05392,434688
7704,XiangyuZhu,2,0.00046,87174,20.05438,434688
7705,xianshun163,2,0.00046,87176,20.05484,434688
7706,xiaofhe,2,0.00046,87178,20.05530,434688
7707,xiaoxiaojx,2,0.00046,87180,20.05576,434688
7708,xiaozhangzhang1,2,0.00046,87182,20.05622,434688
7709,xinfeingxia85,2,0.00046,87184,20.05668,434688
7710,xinfengliu,2,0.00046,87186,20.05714,434688
7711,xing0821,2,0.00046,87188,20.05760,434688
7712,xingyong,2,0.00046,87190,20.05806,434688
7713,xiongleio,2,0.00046,87192,20.05852,434688
7714,xiujuanx,2,0.00046,87194,20.05898,434688
7715,xlejo,2,0.00046,87196,20.05944,434688
7716,xLitil,2,0.00046,87198,20.05991,434688
7717,xonvanetta,2,0.00046,87200,20.06037,434688
7718,xoob,2,0.00046,87202,20.06083,434688
7719,xTeare,2,0.00046,87204,20.06129,434688
7720,xucan4pony,2,0.00046,87206,20.06175,434688
7721,xuchenCN,2,0.00046,87208,20.06221,434688
7722,XuJianxu,2,0.00046,87210,20.06267,434688
7723,xujingjing-cmss,2,0.00046,87212,20.06313,434688
7724,xunfeng1980,2,0.00046,87214,20.06359,434688
7725,xxSkyy,2,0.00046,87216,20.06405,434688
7726,y0zg,2,0.00046,87218,20.06451,434688
7727,y25ean,2,0.00046,87220,20.06497,434688
7728,YahuiAn,2,0.00046,87222,20.06543,434688
7729,yakirgb,2,0.00046,87224,20.06589,434688
7730,YAMASHITAHiroki,2,0.00046,87226,20.06635,434688
7731,YamenSarah,2,0.00046,87228,20.06681,434688
7732,yanbowang1,2,0.00046,87230,20.06727,434688
7733,YangHuiFor,2,0.00046,87232,20.06773,434688
7734,yanglilangqun,2,0.00046,87234,20.06819,434688
7735,yangtaoran,2,0.00046,87236,20.06865,434688
7736,yangyang919,2,0.00046,87238,20.06911,434688
7737,yanjunli76,2,0.00046,87240,20.06957,434688
7738,yankunsam,2,0.00046,87242,20.07003,434688
7739,yannick-peyrotau,2,0.00046,87244,20.07049,434688
7740,yanrez,2,0.00046,87246,20.07095,434688
7741,yanxingponyai,2,0.00046,87248,20.07141,434688
7742,yaobo-lab,2,0.00046,87250,20.07187,434688
7743,yarozen,2,0.00046,87252,20.07233,434688
7744,Yashvardhan21,2,0.00046,87254,20.07279,434688
7745,YasuhiroABE,2,0.00046,87256,20.07325,434688
7746,yazbekhe,2,0.00046,87258,20.07371,434688
7747,ybykov-a9s,2,0.00046,87260,20.07417,434688
7748,yichingwu,2,0.00046,87262,20.07463,434688
7749,yifeikong,2,0.00046,87264,20.07509,434688
7750,yimtcode,2,0.00046,87266,20.07555,434688
7751,yogeshgadge,2,0.00046,87268,20.07601,434688
7752,yogeshlonkar,2,0.00046,87270,20.07647,434688
7753,yonimoses,2,0.00046,87272,20.07693,434688
7754,yorkijr,2,0.00046,87274,20.07739,434688
7755,youvegotmoxie,2,0.00046,87276,20.07785,434688
7756,yrro,2,0.00046,87278,20.07831,434688
7757,ysharma-dev,2,0.00046,87280,20.07877,434688
7758,yueyongyue,2,0.00046,87282,20.07923,434688
7759,yufuluo,2,0.00046,87284,20.07969,434688
7760,yulianedyalkova,2,0.00046,87286,20.08015,434688
7761,yuri-tceretian,2,0.00046,87288,20.08061,434688
7762,yvanadamov,2,0.00046,87290,20.08107,434688
7763,yvespp,2,0.00046,87292,20.08153,434688
7764,YYashwanth,2,0.00046,87294,20.08199,434688
7765,yydzhou,2,0.00046,87296,20.08245,434688
7766,yzsfly,2,0.00046,87298,20.08291,434688
7767,zachfeldman-koneksahealth,2,0.00046,87300,20.08337,434688
7768,Zak-Anderson,2,0.00046,87302,20.08383,434688
7769,zamonia500,2,0.00046,87304,20.08429,434688
7770,Zauxst,2,0.00046,87306,20.08475,434688
7771,zawi99,2,0.00046,87308,20.08521,434688
7772,zdkhan,2,0.00046,87310,20.08567,434688
7773,zeed-w-beez,2,0.00046,87312,20.08613,434688
7774,zek,2,0.00046,87314,20.08659,434688
7775,zekaluo,2,0.00046,87316,20.08705,434688
7776,zekisong,2,0.00046,87318,20.08751,434688
7777,Zenithar,2,0.00046,87320,20.08797,434688
7778,zffocussss,2,0.00046,87322,20.08843,434688
7779,zhamdoctor,2,0.00046,87324,20.08889,434688
7780,zhaminglei,2,0.00046,87326,20.08935,434688
7781,zhanggbj,2,0.00046,87328,20.08981,434688
7782,zhangjaycee,2,0.00046,87330,20.09027,434688
7783,zhangnaifan,2,0.00046,87332,20.09073,434688
7784,zhangziren1988,2,0.00046,87334,20.09119,434688
7785,zhaocheng173,2,0.00046,87336,20.09165,434688
7786,zhaoyii,2,0.00046,87338,20.09211,434688
7787,zhiqiang-yu,2,0.00046,87340,20.09257,434688
7788,zhj-hx,2,0.00046,87342,20.09303,434688
7789,zhoub,2,0.00046,87344,20.09349,434688
7790,zhoushuke,2,0.00046,87346,20.09395,434688
7791,ZhuoSiChen,2,0.00046,87348,20.09441,434688
7792,zhuwenxing,2,0.00046,87350,20.09487,434688
7793,zhyyu,2,0.00046,87352,20.09533,434688
7794,Ziphone,2,0.00046,87354,20.09579,434688
7795,zisha,2,0.00046,87356,20.09625,434688
7796,ziyanakthar,2,0.00046,87358,20.09671,434688
7797,zloidemon,2,0.00046,87360,20.09717,434688
7798,zoetrope,2,0.00046,87362,20.09763,434688
7799,zorulo,2,0.00046,87364,20.09809,434688
7800,ztgoto,2,0.00046,87366,20.09855,434688
7801,zulgey,2,0.00046,87368,20.09901,434688
7802,Zumium,2,0.00046,87370,20.09947,434688
7803,ZZG5220,2,0.00046,87372,20.09993,434688
7804,00123aakd,1,0.00023,87373,20.10016,434688
7805,011d,1,0.00023,87374,20.10039,434688
7806,030,1,0.00023,87375,20.10062,434688
7807,08mohit08,1,0.00023,87376,20.10085,434688
7808,0Ams,1,0.00023,87377,20.10108,434688
7809,0dragosh,1,0.00023,87378,20.10131,434688
7810,0x1991babe,1,0.00023,87379,20.10154,434688
7811,0x1ee7,1,0.00023,87380,20.10177,434688
7812,0x53A,1,0.00023,87381,20.10200,434688
7813,0xdco,1,0.00023,87382,20.10223,434688
7814,0xERR0R,1,0.00023,87383,20.10246,434688
7815,0xMH,1,0.00023,87384,20.10269,434688
7816,0xSc0ut,1,0.00023,87385,20.10292,434688
7817,1026237416,1,0.00023,87386,20.10315,434688
7818,1032231418,1,0.00023,87387,20.10338,434688
7819,1093358332,1,0.00023,87388,20.10361,434688
7820,110y,1,0.00023,87389,20.10384,434688
7821,1123183721,1,0.00023,87390,20.10407,434688
7822,123BLiN,1,0.00023,87391,20.10430,434688
7823,19byte,1,0.00023,87392,20.10453,434688
7824,2610aayushi,1,0.00023,87393,20.10476,434688
7825,2nd-half,1,0.00023,87394,20.10499,434688
7826,308066400,1,0.00023,87395,20.10522,434688
7827,3ch01c,1,0.00023,87396,20.10545,434688
7828,3n-mb,1,0.00023,87397,20.10568,434688
7829,4bo,1,0.00023,87398,20.10592,434688
7830,4lt1,1,0.00023,87399,20.10615,434688
7831,4mig4,1,0.00023,87400,20.10638,434688
7832,4nass,1,0.00023,87401,20.10661,434688
7833,51qzpw,1,0.00023,87402,20.10684,434688
7834,549064368,1,0.00023,87403,20.10707,434688
7835,5suitaitou,1,0.00023,87404,20.10730,434688
7836,616b2f,1,0.00023,87405,20.10753,434688
7837,634750802,1,0.00023,87406,20.10776,434688
7838,64bit,1,0.00023,87407,20.10799,434688
7839,760515805,1,0.00023,87408,20.10822,434688
7840,7echno,1,0.00023,87409,20.10845,434688
7841,7FA49AAC-93BF-411A-A56B-7F0416652D1F,1,0.00023,87410,20.10868,434688
7842,7imo,1,0.00023,87411,20.10891,434688
7843,7yyo,1,0.00023,87412,20.10914,434688
7844,814HiManny,1,0.00023,87413,20.10937,434688
7845,83bytes,1,0.00023,87414,20.10960,434688
7846,91jme,1,0.00023,87415,20.10983,434688
7847,9547,1,0.00023,87416,20.11006,434688
7848,982186883,1,0.00023,87417,20.11029,434688
7849,9maf4you,1,0.00023,87418,20.11052,434688
7850,a21152,1,0.00023,87419,20.11075,434688
7851,a30004053,1,0.00023,87420,20.11098,434688
7852,a4099181,1,0.00023,87421,20.11121,434688
7853,a5a5a9,1,0.00023,87422,20.11144,434688
7854,a67586646,1,0.00023,87423,20.11167,434688
7855,aaa8141,1,0.00023,87424,20.11190,434688
7856,aaaaahaaaaa,1,0.00023,87425,20.11213,434688
7857,aajimal,1,0.00023,87426,20.11236,434688
7858,aakashgarg-19,1,0.00023,87427,20.11259,434688
7859,aaliomer,1,0.00023,87428,20.11282,434688
7860,aallrd,1,0.00023,87429,20.11305,434688
7861,aalsabag,1,0.00023,87430,20.11328,434688
7862,aaltat,1,0.00023,87431,20.11351,434688
7863,aantono,1,0.00023,87432,20.11374,434688
7864,aaqaishtyaq,1,0.00023,87433,20.11397,434688
7865,aarepuu,1,0.00023,87434,20.11420,434688
7866,aaronlidman,1,0.00023,87435,20.11443,434688
7867,aasraoui,1,0.00023,87436,20.11466,434688
7868,AayushSaini101,1,0.00023,87437,20.11489,434688
7869,abangser,1,0.00023,87438,20.11512,434688
7870,abdelrazekrizk,1,0.00023,87439,20.11535,434688
7871,abdialeh,1,0.00023,87440,20.11558,434688
7872,abdulhaseeb2,1,0.00023,87441,20.11581,434688
7873,Abdulrhman-max,1,0.00023,87442,20.11604,434688
7874,AbelTaylor,1,0.00023,87443,20.11627,434688
7875,abeltre1,1,0.00023,87444,20.11650,434688
7876,abertonica,1,0.00023,87445,20.11673,434688
7877,abezard,1,0.00023,87446,20.11696,434688
7878,abhiatmsit,1,0.00023,87447,20.11719,434688
7879,abhideodhar-coder,1,0.00023,87448,20.11742,434688
7880,abhilash93,1,0.00023,87449,20.11765,434688
7881,Abhimanyu-Jana,1,0.00023,87450,20.11788,434688
7882,abhimanyukumar94,1,0.00023,87451,20.11811,434688
7883,abhinaybyrisetty,1,0.00023,87452,20.11834,434688
7884,Abhishek-Srivastava,1,0.00023,87453,20.11857,434688
7885,abierbaum,1,0.00023,87454,20.11880,434688
7886,abinkowski94,1,0.00023,87455,20.11903,434688
7887,Abir-2021,1,0.00023,87456,20.11926,434688
7888,abjinugu,1,0.00023,87457,20.11949,434688
7889,abnoumaru,1,0.00023,87458,20.11972,434688
7890,ab-pm,1,0.00023,87459,20.11995,434688
7891,abrahamhwj,1,0.00023,87460,20.12018,434688
7892,abrahammartin,1,0.00023,87461,20.12041,434688
7893,abrakhim,1,0.00023,87462,20.12064,434688
7894,AbstractVersion,1,0.00023,87463,20.12087,434688
7895,acacrni,1,0.00023,87464,20.12110,434688
7896,accnops,1,0.00023,87465,20.12133,434688
7897,ace03uec,1,0.00023,87466,20.12156,434688
7898,acejam,1,0.00023,87467,20.12179,434688
7899,acekingke,1,0.00023,87468,20.12202,434688
7900,achetronic,1,0.00023,87469,20.12225,434688
7901,achimbode,1,0.00023,87470,20.12248,434688
7902,ac-obair,1,0.00023,87471,20.12271,434688
7903,acornett21,1,0.00023,87472,20.12294,434688
7904,acsdkquery,1,0.00023,87473,20.12317,434688
7905,activescott,1,0.00023,87474,20.12340,434688
7906,adamantivm,1,0.00023,87475,20.12363,434688
7907,adam-azarchs,1,0.00023,87476,20.12386,434688
7908,AdamHollow49,1,0.00023,87477,20.12409,434688
7909,adamjyounger,1,0.00023,87478,20.12432,434688
7910,AdamSLevy,1,0.00023,87479,20.12455,434688
7911,adamxy,1,0.00023,87480,20.12478,434688
7912,addreas,1,0.00023,87481,20.12501,434688
7913,Addyvan,1,0.00023,87482,20.12524,434688
7914,adeal,1,0.00023,87483,20.12547,434688
7915,AdemCanCertel,1,0.00023,87484,20.12570,434688
7916,adgelp,1,0.00023,87485,20.12593,434688
7917,AdiGhidel,1,0.00023,87486,20.12616,434688
7918,adindabudi,1,0.00023,87487,20.12639,434688
7919,adipmeesse,1,0.00023,87488,20.12662,434688
7920,adirmatzkin,1,0.00023,87489,20.12685,434688
7921,adiseshan,1,0.00023,87490,20.12708,434688
7922,aditiagarw4722,1,0.00023,87491,20.12731,434688
7923,aditj95,1,0.00023,87492,20.12754,434688
7924,aditya7041,1,0.00023,87493,20.12777,434688
7925,adityamaru,1,0.00023,87494,20.12800,434688
7926,admilazz,1,0.00023,87495,20.12823,434688
7927,admin-zoujing,1,0.00023,87496,20.12846,434688
7928,admoca60,1,0.00023,87497,20.12869,434688
7929,adonaiarruda,1,0.00023,87498,20.12892,434688
7930,adonig,1,0.00023,87499,20.12915,434688
7931,adonovan,1,0.00023,87500,20.12938,434688
7932,adorableS,1,0.00023,87501,20.12961,434688
7933,adorkkk,1,0.00023,87502,20.12984,434688
7934,adou0510,1,0.00023,87503,20.13007,434688
7935,adrafiq,1,0.00023,87504,20.13030,434688
7936,adri,1,0.00023,87505,20.13053,434688
7937,adriananeci,1,0.00023,87506,20.13076,434688
7938,adrianflutur,1,0.00023,87507,20.13099,434688
7939,adriankostrubiak-tomtom,1,0.00023,87508,20.13122,434688
7940,Aelentel,1,0.00023,87509,20.13145,434688
7941,aemann2,1,0.00023,87510,20.13168,434688
7942,Aeris126,1,0.00023,87511,20.13191,434688
7943,aesa-dr,1,0.00023,87512,20.13214,434688
7944,aevenot,1,0.00023,87513,20.13237,434688
7945,afdesk,1,0.00023,87514,20.13260,434688
7946,afsanjar,1,0.00023,87515,20.13283,434688
7947,ag2s20150909,1,0.00023,87516,20.13306,434688
7948,agaldemas,1,0.00023,87517,20.13329,434688
7949,Agentscreech,1,0.00023,87518,20.13352,434688
7950,aghandoura,1,0.00023,87519,20.13375,434688
7951,a-glanville,1,0.00023,87520,20.13398,434688
7952,AGoretti,1,0.00023,87521,20.13421,434688
7953,agradous,1,0.00023,87522,20.13444,434688
7954,agrevtcev,1,0.00023,87523,20.13467,434688
7955,ahached,1,0.00023,87524,20.13490,434688
7956,ahaid,1,0.00023,87525,20.13513,434688
7957,ahasnaini,1,0.00023,87526,20.13536,434688
7958,aheng-ch,1,0.00023,87527,20.13559,434688
7959,ahern2018,1,0.00023,87528,20.13582,434688
7960,ahfuzhang,1,0.00023,87529,20.13605,434688
7961,AhHa45,1,0.00023,87530,20.13628,434688
7962,AhmadMS1988,1,0.00023,87531,20.13651,434688
7963,ahmadrgb1,1,0.00023,87532,20.13674,434688
7964,ahmed-adam,1,0.00023,87533,20.13697,434688
7965,ahmedsmhs,1,0.00023,87534,20.13720,434688
7966,ahmetkotan,1,0.00023,87535,20.13743,434688
7967,aholler,1,0.00023,87536,20.13766,434688
7968,ahsan13jan,1,0.00023,87537,20.13789,434688
7969,aiaicaow,1,0.00023,87538,20.13812,434688
7970,AidanWenzel,1,0.00023,87539,20.13835,434688
7971,aierui,1,0.00023,87540,20.13858,434688
7972,aikoven,1,0.00023,87541,20.13881,434688
7973,Airblader,1,0.00023,87542,20.13904,434688
7974,aireilly,1,0.00023,87543,20.13927,434688
7975,AiRrRock,1,0.00023,87544,20.13950,434688
7976,aishwariyajay,1,0.00023,87545,20.13973,434688
7977,Aishwarya-Hebbar,1,0.00023,87546,20.13996,434688
7978,aitorpazos,1,0.00023,87547,20.14019,434688
7979,aiyengar2,1,0.00023,87548,20.14042,434688
7980,ajaikumarcs,1,0.00023,87549,20.14065,434688
7981,ajain0811,1,0.00023,87550,20.14088,434688
7982,ajasonwang,1,0.00023,87551,20.14111,434688
7983,ajayanaj,1,0.00023,87552,20.14134,434688
7984,ajayjangu0001,1,0.00023,87553,20.14157,434688
7985,ajaysourcedigital,1,0.00023,87554,20.14180,434688
7986,ajchiarello,1,0.00023,87555,20.14203,434688
7987,ajendrex,1,0.00023,87556,20.14226,434688
7988,AjithKumar1702,1,0.00023,87557,20.14249,434688
7989,AjithPanneerselvam,1,0.00023,87558,20.14272,434688
7990,ajkr,1,0.00023,87559,20.14295,434688
7991,ajohanssonwalder,1,0.00023,87560,20.14318,434688
7992,ajsharma,1,0.00023,87561,20.14341,434688
7993,AkaiNoCat,1,0.00023,87562,20.14364,434688
7994,akantak,1,0.00023,87563,20.14387,434688
7995,akaroth,1,0.00023,87564,20.14410,434688
7996,akashkeshari,1,0.00023,87565,20.14433,434688
7997,akashpatel2,1,0.00023,87566,20.14456,434688
7998,akazakou-incomm,1,0.00023,87567,20.14479,434688
7999,akbhuker,1,0.00023,87568,20.14502,434688
8000,akelsch,1,0.00023,87569,20.14525,434688
8001,akhalyavka,1,0.00023,87570,20.14548,434688
8002,akhilasankar,1,0.00023,87571,20.14571,434688
8003,AkhilRaja,1,0.00023,87572,20.14594,434688
8004,akibabu,1,0.00023,87573,20.14617,434688
8005,akifkhan01,1,0.00023,87574,20.14640,434688
8006,akirn,1,0.00023,87575,20.14663,434688
8007,akoeb-dkb,1,0.00023,87576,20.14686,434688
8008,aksdb,1,0.00023,87577,20.14709,434688
8009,akselleirv,1,0.00023,87578,20.14732,434688
8010,akshatdalton,1,0.00023,87579,20.14755,434688
8011,al3pht,1,0.00023,87580,20.14778,434688
8012,al8ba,1,0.00023,87581,20.14801,434688
8013,alagesh146,1,0.00023,87582,20.14824,434688
8014,alainhenryt,1,0.00023,87583,20.14847,434688
8015,alaneuler,1,0.00023,87584,20.14870,434688
8016,alanj853,1,0.00023,87585,20.14893,434688
8017,Alan-LOL,1,0.00023,87586,20.14916,434688
8018,alanmcg,1,0.00023,87587,20.14939,434688
8019,alanpeng,1,0.00023,87588,20.14962,434688
8020,alanssitis,1,0.00023,87589,20.14985,434688
8021,AlbertWigmore,1,0.00023,87590,20.15008,434688
8022,alchemist123,1,0.00023,87591,20.15031,434688
8023,alchemistake,1,0.00023,87592,20.15054,434688
8024,alcorf-mizar,1,0.00023,87593,20.15077,434688
8025,Aldjinn,1,0.00023,87594,20.15100,434688
8026,aldor007,1,0.00023,87595,20.15123,434688
8027,alecb-stripe,1,0.00023,87596,20.15146,434688
8028,aledegano,1,0.00023,87597,20.15170,434688
8029,aleewade,1,0.00023,87598,20.15193,434688
8030,alekseinovikov,1,0.00023,87599,20.15216,434688
8031,aleksey-novikov,1,0.00023,87600,20.15239,434688
8032,aleks-m,1,0.00023,87601,20.15262,434688
8033,Alenjojo,1,0.00023,87602,20.15285,434688
8034,aleon1220,1,0.00023,87603,20.15308,434688
8035,alertedsnake,1,0.00023,87604,20.15331,434688
8036,aleskovets,1,0.00023,87605,20.15354,434688
8037,Alestrix,1,0.00023,87606,20.15377,434688
8038,Alex0Lihach,1,0.00023,87607,20.15400,434688
8039,Alexander-Bartosh,1,0.00023,87608,20.15423,434688
8040,AlexanderEllis,1,0.00023,87609,20.15446,434688
8041,alexanderjung-sdxag,1,0.00023,87610,20.15469,434688
8042,alexanderturner,1,0.00023,87611,20.15492,434688
8043,alexandre-girard-maif,1,0.00023,87612,20.15515,434688
8044,alexandrupetrini,1,0.00023,87613,20.15538,434688
8045,alexarnoldy,1,0.00023,87614,20.15561,434688
8046,alexbrina,1,0.00023,87615,20.15584,434688
8047,alexcanar95,1,0.00023,87616,20.15607,434688
8048,AlexChung1995,1,0.00023,87617,20.15630,434688
8049,alexcristi,1,0.00023,87618,20.15653,434688
8050,alex-dixon,1,0.00023,87619,20.15676,434688
8051,alexespejoch,1,0.00023,87620,20.15699,434688
8052,alexey907,1,0.00023,87621,20.15722,434688
8053,alexey-nextreason,1,0.00023,87622,20.15745,434688
8054,alexgleith,1,0.00023,87623,20.15768,434688
8055,alexhwoods,1,0.00023,87624,20.15791,434688
8056,alexInhert,1,0.00023,87625,20.15814,434688
8057,alexisbel1,1,0.00023,87626,20.15837,434688
8058,alexiseaguirre,1,0.00023,87627,20.15860,434688
8059,AlexisJasso,1,0.00023,87628,20.15883,434688
8060,alexispires,1,0.00023,87629,20.15906,434688
8061,AlexJMohr,1,0.00023,87630,20.15929,434688
8062,alexlev2004,1,0.00023,87631,20.15952,434688
8063,alex-lx,1,0.00023,87632,20.15975,434688
8064,AlexMihalev,1,0.00023,87633,20.15998,434688
8065,alexmojo,1,0.00023,87634,20.16021,434688
8066,alexpirine,1,0.00023,87635,20.16044,434688
8067,alexrogach,1,0.00023,87636,20.16067,434688
8068,alexshavelev44,1,0.00023,87637,20.16090,434688
8069,alexvaque,1,0.00023,87638,20.16113,434688
8070,AlexWang-CN,1,0.00023,87639,20.16136,434688
8071,aleybovich,1,0.00023,87640,20.16159,434688
8072,alfonsomunozpomer,1,0.00023,87641,20.16182,434688
8073,AlfredHudson,1,0.00023,87642,20.16205,434688
8074,alfsch,1,0.00023,87643,20.16228,434688
8075,alialperak,1,0.00023,87644,20.16251,434688
8076,alicepaixao,1,0.00023,87645,20.16274,434688
8077,aliche123,1,0.00023,87646,20.16297,434688
8078,alimravac,1,0.00023,87647,20.16320,434688
8079,alirezaamiri,1,0.00023,87648,20.16343,434688
8080,alisade,1,0.00023,87649,20.16366,434688
8081,alison199,1,0.00023,87650,20.16389,434688
8082,aliusmiles,1,0.00023,87651,20.16412,434688
8083,alizard0,1,0.00023,87652,20.16435,434688
8084,AljoschaP,1,0.00023,87653,20.16458,434688
8085,allanvmat,1,0.00023,87654,20.16481,434688
8086,allentv,1,0.00023,87655,20.16504,434688
8087,allupaku,1,0.00023,87656,20.16527,434688
8088,alonm-totango,1,0.00023,87657,20.16550,434688
8089,alopsing,1,0.00023,87658,20.16573,434688
8090,alpana17,1,0.00023,87659,20.16596,434688
8091,alphashaw,1,0.00023,87660,20.16619,434688
8092,alphaX86,1,0.00023,87661,20.16642,434688
8093,alterEgo123,1,0.00023,87662,20.16665,434688
8094,AlviseSembenico,1,0.00023,87663,20.16688,434688
8095,alysonfranklin,1,0.00023,87664,20.16711,434688
8096,amatveyev-gh,1,0.00023,87665,20.16734,434688
8097,amaury-d,1,0.00023,87666,20.16757,434688
8098,ambar-centric,1,0.00023,87667,20.16780,434688
8099,AMBHEER-SRIKANTH,1,0.00023,87668,20.16803,434688
8100,ameeet,1,0.00023,87669,20.16826,434688
8101,AmeerAssi,1,0.00023,87670,20.16849,434688
8102,ameir,1,0.00023,87671,20.16872,434688
8103,aminebelroulccie,1,0.00023,87672,20.16895,434688
8104,amir-enote,1,0.00023,87673,20.16918,434688
8105,amirkhonov,1,0.00023,87674,20.16941,434688
8106,amit19811981,1,0.00023,87675,20.16964,434688
8107,amitdrana,1,0.00023,87676,20.16987,434688
8108,amithapa,1,0.00023,87677,20.17010,434688
8109,amithkk,1,0.00023,87678,20.17033,434688
8110,AmitKarnam,1,0.00023,87679,20.17056,434688
8111,amitverma80,1,0.00023,87680,20.17079,434688
8112,amityagov,1,0.00023,87681,20.17102,434688
8113,ammar-mik,1,0.00023,87682,20.17125,434688
8114,ammggm,1,0.00023,87683,20.17148,434688
8115,amora-uz,1,0.00023,87684,20.17171,434688
8116,amrit-35,1,0.00023,87685,20.17194,434688
8117,anaconda2196,1,0.00023,87686,20.17217,434688
8118,ananditabhatt,1,0.00023,87687,20.17240,434688
8119,Anant99-sys,1,0.00023,87688,20.17263,434688
8120,anantadwi13,1,0.00023,87689,20.17286,434688
8121,anban-wuxi,1,0.00023,87690,20.17309,434688
8122,and-1,1,0.00023,87691,20.17332,434688
8123,andazk0555,1,0.00023,87692,20.17355,434688
8124,Andersonfrfilho,1,0.00023,87693,20.17378,434688
8125,andreafy,1,0.00023,87694,20.17401,434688
8126,andreas-ahman,1,0.00023,87695,20.17424,434688
8127,andreasjansson,1,0.00023,87696,20.17447,434688
8128,andreas-schroeder,1,0.00023,87697,20.17470,434688
8129,andreee94,1,0.00023,87698,20.17493,434688
8130,andrein,1,0.00023,87699,20.17516,434688
8131,andrei-n-cosma,1,0.00023,87700,20.17539,434688
8132,andrembpontes,1,0.00023,87701,20.17562,434688
8133,andrevtg,1,0.00023,87702,20.17585,434688
8134,andrew-g-za,1,0.00023,87703,20.17608,434688
8135,andrewjstone,1,0.00023,87704,20.17631,434688
8136,andrewmwhite,1,0.00023,87705,20.17654,434688
8137,andrewpurdin,1,0.00023,87706,20.17677,434688
8138,andrewrotherham,1,0.00023,87707,20.17700,434688
8139,andrewscarlos,1,0.00023,87708,20.17723,434688
8140,andrewsjg,1,0.00023,87709,20.17746,434688
8141,andrey-dubnik,1,0.00023,87710,20.17769,434688
8142,andrey-gava,1,0.00023,87711,20.17792,434688
8143,AndreyKrupskii,1,0.00023,87712,20.17815,434688
8144,AndreyLevchenko,1,0.00023,87713,20.17838,434688
8145,andreymal,1,0.00023,87714,20.17861,434688
8146,AndriPL,1,0.00023,87715,20.17884,434688
8147,andriyfomenko,1,0.00023,87716,20.17907,434688
8148,androna-xm,1,0.00023,87717,20.17930,434688
8149,andruwa13,1,0.00023,87718,20.17953,434688
8150,andrzej-natzka,1,0.00023,87719,20.17976,434688
8151,andtheysay,1,0.00023,87720,20.17999,434688
8152,andy88566y,1,0.00023,87721,20.18022,434688
8153,AndyBevan,1,0.00023,87722,20.18045,434688
8154,andyfleming-shopify,1,0.00023,87723,20.18068,434688
8155,andy-maier,1,0.00023,87724,20.18091,434688
8156,AndyMender,1,0.00023,87725,20.18114,434688
8157,anemptyair,1,0.00023,87726,20.18137,434688
8158,angelincb,1,0.00023,87727,20.18160,434688
8159,angeloskaltsikis,1,0.00023,87728,20.18183,434688
8160,angie1148,1,0.00023,87729,20.18206,434688
8161,AniekanAkai,1,0.00023,87730,20.18229,434688
8162,anil-dongol29,1,0.00023,87731,20.18252,434688
8163,AnilKumarBandi27,1,0.00023,87732,20.18275,434688
8164,anindya6,1,0.00023,87733,20.18298,434688
8165,anishdhar,1,0.00023,87734,20.18321,434688
8166,anisjonischkeit,1,0.00023,87735,20.18344,434688
8167,ankit131087,1,0.00023,87736,20.18367,434688
8168,ankit302,1,0.00023,87737,20.18390,434688
8169,ankit9787,1,0.00023,87738,20.18413,434688
8170,ankitbko,1,0.00023,87739,20.18436,434688
8171,ankitnigam1987,1,0.00023,87740,20.18459,434688
8172,Ankit-Pankaj,1,0.00023,87741,20.18482,434688
8173,ankurchoubeymsft,1,0.00023,87742,20.18505,434688
8174,annabellegoth2boss,1,0.00023,87743,20.18528,434688
8175,annanya-mathur,1,0.00023,87744,20.18551,434688
8176,annastoll,1,0.00023,87745,20.18574,434688
8177,annrajan,1,0.00023,87746,20.18597,434688
8178,anorm,1,0.00023,87747,20.18620,434688
8179,anothermh,1,0.00023,87748,20.18643,434688
8180,anpatellll,1,0.00023,87749,20.18666,434688
8181,anshkhandelwal12,1,0.00023,87750,20.18689,434688
8182,AnshumanDhiman,1,0.00023,87751,20.18712,434688
8183,ansjin,1,0.00023,87752,20.18735,434688
8184,anthonyolmillo,1,0.00023,87753,20.18758,434688
8185,Anthuang,1,0.00023,87754,20.18781,434688
8186,antimatter96,1,0.00023,87755,20.18804,434688
8187,antJack,1,0.00023,87756,20.18827,434688
8188,antoine-gaillard,1,0.00023,87757,20.18850,434688
8189,AntoineMerle,1,0.00023,87758,20.18873,434688
8190,antoinetran,1,0.00023,87759,20.18896,434688
8191,AntonDobshikov,1,0.00023,87760,20.18919,434688
8192,antoniodellelce,1,0.00023,87761,20.18942,434688
8193,antonioribezzi,1,0.00023,87762,20.18965,434688
8194,antoniosthanasisgit,1,0.00023,87763,20.18988,434688
8195,AntonOfTheWoods,1,0.00023,87764,20.19011,434688
8196,AntonPetrov83,1,0.00023,87765,20.19034,434688
8197,AntonRechkov,1,0.00023,87766,20.19057,434688
8198,AntPeixe,1,0.00023,87767,20.19080,434688
8199,Anubha13kumari,1,0.00023,87768,20.19103,434688
8200,anubhav201241,1,0.00023,87769,20.19126,434688
8201,anubhav-saurav,1,0.00023,87770,20.19149,434688
8202,anuj-8march,1,0.00023,87771,20.19172,434688
8203,anurag4516,1,0.00023,87772,20.19195,434688
8204,anuragvohraec,1,0.00023,87773,20.19218,434688
8205,Anusha-Gurajapu,1,0.00023,87774,20.19241,434688
8206,anviod,1,0.00023,87775,20.19264,434688
8207,Anynou,1,0.00023,87776,20.19287,434688
8208,anyyyy,1,0.00023,87777,20.19310,434688
8209,ao508,1,0.00023,87778,20.19333,434688
8210,apatilgtn,1,0.00023,87779,20.19356,434688
8211,apollodafoni,1,0.00023,87780,20.19379,434688
8212,Apollorion,1,0.00023,87781,20.19402,434688
8213,appcoders,1,0.00023,87782,20.19425,434688
8214,apptio-msobala,1,0.00023,87783,20.19448,434688
8215,aqubo,1,0.00023,87784,20.19471,434688
8216,AramshamFedaykin,1,0.00023,87785,20.19494,434688
8217,Aravin,1,0.00023,87786,20.19517,434688
8218,aravindakidambi,1,0.00023,87787,20.19540,434688
8219,Archer1A,1,0.00023,87788,20.19563,434688
8220,archi144,1,0.00023,87789,20.19586,434688
8221,archita-sarda,1,0.00023,87790,20.19609,434688
8222,arctouch-lauracarvalho,1,0.00023,87791,20.19632,434688
8223,areese,1,0.00023,87792,20.19655,434688
8224,arenstar,1,0.00023,87793,20.19678,434688
8225,Areturn,1,0.00023,87794,20.19701,434688
8226,ArgTang,1,0.00023,87795,20.19724,434688
8227,argvk,1,0.00023,87796,20.19747,434688
8228,ArielShup,1,0.00023,87797,20.19771,434688
8229,arihannu,1,0.00023,87798,20.19794,434688
8230,arindosCredible,1,0.00023,87799,20.19817,434688
8231,aristosvo,1,0.00023,87800,20.19840,434688
8232,arizon-dread,1,0.00023,87801,20.19863,434688
8233,ArjunBhushan,1,0.00023,87802,20.19886,434688
8234,arlindhoxhaa,1,0.00023,87803,20.19909,434688
8235,ar-mi6,1,0.00023,87804,20.19932,434688
8236,ArminMW,1,0.00023,87805,20.19955,434688
8237,ArmitageW,1,0.00023,87806,20.19978,434688
8238,armourshield,1,0.00023,87807,20.20001,434688
8239,arnab-code,1,0.00023,87808,20.20024,434688
8240,Arnatious,1,0.00023,87809,20.20047,434688
8241,Arning627,1,0.00023,87810,20.20070,434688
8242,arnitkun,1,0.00023,87811,20.20093,434688
8243,arosh,1,0.00023,87812,20.20116,434688
8244,arpitzn,1,0.00023,87813,20.20139,434688
8245,arpl,1,0.00023,87814,20.20162,434688
8246,arren-ru,1,0.00023,87815,20.20185,434688
8247,arrow2012,1,0.00023,87816,20.20208,434688
8248,arrowfeng,1,0.00023,87817,20.20231,434688
8249,ArrowRaider,1,0.00023,87818,20.20254,434688
8250,arruda,1,0.00023,87819,20.20277,434688
8251,arsnyder16,1,0.00023,87820,20.20300,434688
8252,artem888881,1,0.00023,87821,20.20323,434688
8253,ArtemGorev,1,0.00023,87822,20.20346,434688
8254,artemlive,1,0.00023,87823,20.20369,434688
8255,artem-tomyuk,1,0.00023,87824,20.20392,434688
8256,ArtGangsta,1,0.00023,87825,20.20415,434688
8257,arthemis911222,1,0.00023,87826,20.20438,434688
8258,Artiax,1,0.00023,87827,20.20461,434688
8259,artisticcheese,1,0.00023,87828,20.20484,434688
8260,arturk9,1,0.00023,87829,20.20507,434688
8261,artursapek,1,0.00023,87830,20.20530,434688
8262,arulmeiyappan,1,0.00023,87831,20.20553,434688
8263,Arun-KumarH,1,0.00023,87832,20.20576,434688
8264,arvincong,1,0.00023,87833,20.20599,434688
8265,aryansaraf018,1,0.00023,87834,20.20622,434688
8266,asaaki,1,0.00023,87835,20.20645,434688
8267,asafm,1,0.00023,87836,20.20668,434688
8268,Asarew,1,0.00023,87837,20.20691,434688
8269,ashdon4u,1,0.00023,87838,20.20714,434688
8270,ashgit301,1,0.00023,87839,20.20737,434688
8271,ashish493,1,0.00023,87840,20.20760,434688
8272,AshishJainMSRIT,1,0.00023,87841,20.20783,434688
8273,ashishsanjaysharma,1,0.00023,87842,20.20806,434688
8274,ashisht99x,1,0.00023,87843,20.20829,434688
8275,ashishwigwag,1,0.00023,87844,20.20852,434688
8276,ashleeferguson,1,0.00023,87845,20.20875,434688
8277,ashleystendel,1,0.00023,87846,20.20898,434688
8278,ashmortar,1,0.00023,87847,20.20921,434688
8279,ashu27483,1,0.00023,87848,20.20944,434688
8280,ashu658,1,0.00023,87849,20.20967,434688
8281,ashutosh887,1,0.00023,87850,20.20990,434688
8282,ashwinkupatkar,1,0.00023,87851,20.21013,434688
8283,asimhon,1,0.00023,87852,20.21036,434688
8284,asinitson,1,0.00023,87853,20.21059,434688
8285,askidmobile,1,0.00023,87854,20.21082,434688
8286,asmeikal,1,0.00023,87855,20.21105,434688
8287,asmexcaliburwoods,1,0.00023,87856,20.21128,434688
8288,asok-mirror,1,0.00023,87857,20.21151,434688
8289,asonnleitner,1,0.00023,87858,20.21174,434688
8290,aspnet4you,1,0.00023,87859,20.21197,434688
8291,assapir,1,0.00023,87860,20.21220,434688
8292,astraios,1,0.00023,87861,20.21243,434688
8293,ast-sf-tok,1,0.00023,87862,20.21266,434688
8294,Asturias-sam,1,0.00023,87863,20.21289,434688
8295,aswinjayaji,1,0.00023,87864,20.21312,434688
8296,ataetsy,1,0.00023,87865,20.21335,434688
8297,atanev,1,0.00023,87866,20.21358,434688
8298,atarax665,1,0.00023,87867,20.21381,434688
8299,AtaS,1,0.00023,87868,20.21404,434688
8300,atennapel,1,0.00023,87869,20.21427,434688
8301,Athosone,1,0.00023,87870,20.21450,434688
8302,ati46,1,0.00023,87871,20.21473,434688
8303,atifsayeedi,1,0.00023,87872,20.21496,434688
8304,atoy3731,1,0.00023,87873,20.21519,434688
8305,atrakic,1,0.00023,87874,20.21542,434688
8306,atsai1220,1,0.00023,87875,20.21565,434688
8307,aturetta,1,0.00023,87876,20.21588,434688
8308,atzawada,1,0.00023,87877,20.21611,434688
8309,audriusbla,1,0.00023,87878,20.21634,434688
8310,augi,1,0.00023,87879,20.21657,434688
8311,aupadh12,1,0.00023,87880,20.21680,434688
8312,AurelianTicusan,1,0.00023,87881,20.21703,434688
8313,aurelienlegrand,1,0.00023,87882,20.21726,434688
8314,austinhquinn,1,0.00023,87883,20.21749,434688
8315,auswells,1,0.00023,87884,20.21772,434688
8316,automano,1,0.00023,87885,20.21795,434688
8317,avanthakkar,1,0.00023,87886,20.21818,434688
8318,aveshag,1,0.00023,87887,20.21841,434688
8319,avibha28,1,0.00023,87888,20.21864,434688
8320,AvihuuGoren,1,0.00023,87889,20.21887,434688
8321,AvijitD22,1,0.00023,87890,20.21910,434688
8322,avikatgithub,1,0.00023,87891,20.21933,434688
8323,avillela-tc,1,0.00023,87892,20.21956,434688
8324,AviMoto,1,0.00023,87893,20.21979,434688
8325,avinashpancham,1,0.00023,87894,20.22002,434688
8326,avocadomaster,1,0.00023,87895,20.22025,434688
8327,aweeks,1,0.00023,87896,20.22048,434688
8328,awelsman,1,0.00023,87897,20.22071,434688
8329,AWinterman,1,0.00023,87898,20.22094,434688
8330,AWKIF,1,0.00023,87899,20.22117,434688
8331,awsiv,1,0.00023,87900,20.22140,434688
8332,Axory,1,0.00023,87901,20.22163,434688
8333,ayaka-kms,1,0.00023,87902,20.22186,434688
8334,ayamGelo,1,0.00023,87903,20.22209,434688
8335,ayeganov,1,0.00023,87904,20.22232,434688
8336,ayeks,1,0.00023,87905,20.22255,434688
8337,ayepRahman,1,0.00023,87906,20.22278,434688
8338,AymanMagdy,1,0.00023,87907,20.22301,434688
8339,aymericDD,1,0.00023,87908,20.22324,434688
8340,AymericPlanche,1,0.00023,87909,20.22347,434688
8341,ayoubeddafali,1,0.00023,87910,20.22370,434688
8342,ayr-ton,1,0.00023,87911,20.22393,434688
8343,aysylu,1,0.00023,87912,20.22416,434688
8344,Ayush7614,1,0.00023,87913,20.22439,434688
8345,ayushkr04,1,0.00023,87914,20.22462,434688
8346,Ayusinha,1,0.00023,87915,20.22485,434688
8347,ayz-lex,1,0.00023,87916,20.22508,434688
8348,azanar,1,0.00023,87917,20.22531,434688
8349,azelezni,1,0.00023,87918,20.22554,434688
8350,azertyfun,1,0.00023,87919,20.22577,434688
8351,Azhdar1990,1,0.00023,87920,20.22600,434688
8352,azman0101,1,0.00023,87921,20.22623,434688
8353,azmeuk,1,0.00023,87922,20.22646,434688
8354,B0ud,1,0.00023,87923,20.22669,434688
8355,babujii,1,0.00023,87924,20.22692,434688
8356,baconwaifu,1,0.00023,87925,20.22715,434688
8357,badabapidas,1,0.00023,87926,20.22738,434688
8358,Badawekoo,1,0.00023,87927,20.22761,434688
8359,badbruce,1,0.00023,87928,20.22784,434688
8360,baelen-git,1,0.00023,87929,20.22807,434688
8361,baigzeeshan,1,0.00023,87930,20.22830,434688
8362,BAIYIMING520,1,0.00023,87931,20.22853,434688
8363,balacc,1,0.00023,87932,20.22876,434688
8364,balan2010,1,0.00023,87933,20.22899,434688
8365,BalaNarvar,1,0.00023,87934,20.22922,434688
8366,balesz,1,0.00023,87935,20.22945,434688
8367,balixiao,1,0.00023,87936,20.22968,434688
8368,bang-le-sct,1,0.00023,87937,20.22991,434688
8369,baoervsdier,1,0.00023,87938,20.23014,434688
8370,Baoqiang-Zhang,1,0.00023,87939,20.23037,434688
8371,barbarajoost,1,0.00023,87940,20.23060,434688
8372,barhatesw09,1,0.00023,87941,20.23083,434688
8373,BaronStack,1,0.00023,87942,20.23106,434688
8374,bartekus,1,0.00023,87943,20.23129,434688
8375,BartoszKupiecki,1,0.00023,87944,20.23152,434688
8376,bartsqueezy,1,0.00023,87945,20.23175,434688
8377,barucoh,1,0.00023,87946,20.23198,434688
8378,based-template,1,0.00023,87947,20.23221,434688
8379,bashar94,1,0.00023,87948,20.23244,434688
8380,bateau84,1,0.00023,87949,20.23267,434688
8381,baudlord,1,0.00023,87950,20.23290,434688
8382,bayarcher,1,0.00023,87951,20.23313,434688
8383,baymax55,1,0.00023,87952,20.23336,434688
8384,bazingarj,1,0.00023,87953,20.23359,434688
8385,bbatarelo,1,0.00023,87954,20.23382,434688
8386,bbecker-te,1,0.00023,87955,20.23405,434688
8387,bbhenry,1,0.00023,87956,20.23428,434688
8388,bbker,1,0.00023,87957,20.23451,434688
8389,bbugh,1,0.00023,87958,20.23474,434688
8390,bcharna,1,0.00023,87959,20.23497,434688
8391,bcouetil,1,0.00023,87960,20.23520,434688
8392,bcui2020,1,0.00023,87961,20.23543,434688
8393,bdabelow,1,0.00023,87962,20.23566,434688
8394,bd-br,1,0.00023,87963,20.23589,434688
8395,bdobsonca,1,0.00023,87964,20.23612,434688
8396,bdzanko17,1,0.00023,87965,20.23635,434688
8397,Bearbrice,1,0.00023,87966,20.23658,434688
8398,beaudryj,1,0.00023,87967,20.23681,434688
8399,becki-at-luminal,1,0.00023,87968,20.23704,434688
8400,Becram,1,0.00023,87969,20.23727,434688
8401,beef9999,1,0.00023,87970,20.23750,434688
8402,beefsack,1,0.00023,87971,20.23773,434688
8403,beevee,1,0.00023,87972,20.23796,434688
8404,begemotik,1,0.00023,87973,20.23819,434688
8405,behradeslamifar,1,0.00023,87974,20.23842,434688
8406,beiluo97,1,0.00023,87975,20.23865,434688
8407,beingamarnath,1,0.00023,87976,20.23888,434688
8408,Belyenochi,1,0.00023,87977,20.23911,434688
8409,beneditomarques,1,0.00023,87978,20.23934,434688
8410,Ben-Epstein,1,0.00023,87979,20.23957,434688
8411,bengl,1,0.00023,87980,20.23980,434688
8412,BenjaminFarley,1,0.00023,87981,20.24003,434688
8413,benjaminjb,1,0.00023,87982,20.24026,434688
8414,benjsec,1,0.00023,87983,20.24049,434688
8415,ben-manes,1,0.00023,87984,20.24072,434688
8416,bennythejudge,1,0.00023,87985,20.24095,434688
8417,benpettman,1,0.00023,87986,20.24118,434688
8418,ben-wangz,1,0.00023,87987,20.24141,434688
8419,benze,1,0.00023,87988,20.24164,434688
8420,benzhonghai008,1,0.00023,87989,20.24187,434688
8421,bephinix,1,0.00023,87990,20.24210,434688
8422,bergeramit,1,0.00023,87991,20.24233,434688
8423,bergner,1,0.00023,87992,20.24256,434688
8424,berlinsaint,1,0.00023,87993,20.24279,434688
8425,beveradb,1,0.00023,87994,20.24302,434688
8426,BewareMyPower,1,0.00023,87995,20.24325,434688
8427,beyondyinjl2,1,0.00023,87996,20.24348,434688
8428,bforbis,1,0.00023,87997,20.24372,434688
8429,bforchhammer,1,0.00023,87998,20.24395,434688
8430,bhagya29m,1,0.00023,87999,20.24418,434688
8431,bhaibel,1,0.00023,88000,20.24441,434688
8432,Bhanukiran117,1,0.00023,88001,20.24464,434688
8433,bharat1847,1,0.00023,88002,20.24487,434688
8434,bharathi-subramanian,1,0.00023,88003,20.24510,434688
8435,bharathramaprasad-okta,1,0.00023,88004,20.24533,434688
8436,bhouston,1,0.00023,88005,20.24556,434688
8437,BhumikaJai,1,0.00023,88006,20.24579,434688
8438,bickerx2,1,0.00023,88007,20.24602,434688
8439,bienchu,1,0.00023,88008,20.24625,434688
8440,bigc2000,1,0.00023,88009,20.24648,434688
8441,billsmithatg,1,0.00023,88010,20.24671,434688
8442,billydh,1,0.00023,88011,20.24694,434688
8443,bin3377,1,0.00023,88012,20.24717,434688
8444,BinarSkugga,1,0.00023,88013,20.24740,434688
8445,Bingmang,1,0.00023,88014,20.24763,434688
8446,binguo-casa,1,0.00023,88015,20.24786,434688
8447,binhnguyenduc,1,0.00023,88016,20.24809,434688
8448,BinZhiZhu,1,0.00023,88017,20.24832,434688
8449,BioGeek,1,0.00023,88018,20.24855,434688
8450,birdiesanders,1,0.00023,88019,20.24878,434688
8451,bisha755,1,0.00023,88020,20.24901,434688
8452,bistaastha,1,0.00023,88021,20.24924,434688
8453,bitspradp,1,0.00023,88022,20.24947,434688
8454,bittrance,1,0.00023,88023,20.24970,434688
8455,bitwalker,1,0.00023,88024,20.24993,434688
8456,bixu,1,0.00023,88025,20.25016,434688
8457,bizrad,1,0.00023,88026,20.25039,434688
8458,Bizzl,1,0.00023,88027,20.25062,434688
8459,bjakubiak,1,0.00023,88028,20.25085,434688
8460,bjetal,1,0.00023,88029,20.25108,434688
8461,bjornbouetsmith,1,0.00023,88030,20.25131,434688
8462,BjornM111,1,0.00023,88031,20.25154,434688
8463,bkarakashev,1,0.00023,88032,20.25177,434688
8464,bkc,1,0.00023,88033,20.25200,434688
8465,bkhatri24,1,0.00023,88034,20.25223,434688
8466,bkinlaw1,1,0.00023,88035,20.25246,434688
8467,blaazetech,1,0.00023,88036,20.25269,434688
8468,Blackbaud-LeoWanderer,1,0.00023,88037,20.25292,434688
8469,blackgold,1,0.00023,88038,20.25315,434688
8470,blackluck,1,0.00023,88039,20.25338,434688
8471,blacksunshine,1,0.00023,88040,20.25361,434688
8472,blang,1,0.00023,88041,20.25384,434688
8473,blankburian,1,0.00023,88042,20.25407,434688
8474,blazejkrzak,1,0.00023,88043,20.25430,434688
8475,blc2,1,0.00023,88044,20.25453,434688
8476,Bliamoh,1,0.00023,88045,20.25476,434688
8477,blitzd,1,0.00023,88046,20.25499,434688
8478,blka,1,0.00023,88047,20.25522,434688
8479,Blobonat,1,0.00023,88048,20.25545,434688
8480,blondviper,1,0.00023,88049,20.25568,434688
8481,bloodbare,1,0.00023,88050,20.25591,434688
8482,Blorpy,1,0.00023,88051,20.25614,434688
8483,blueice123,1,0.00023,88052,20.25637,434688
8484,bluejam0303,1,0.00023,88053,20.25660,434688
8485,bluikko,1,0.00023,88054,20.25683,434688
8486,blurks,1,0.00023,88055,20.25706,434688
8487,bm424,1,0.00023,88056,20.25729,434688
8488,bmelanson,1,0.00023,88057,20.25752,434688
8489,bmerry,1,0.00023,88058,20.25775,434688
8490,bmmpp,1,0.00023,88059,20.25798,434688
8491,bmv126,1,0.00023,88060,20.25821,434688
8492,boarder7395,1,0.00023,88061,20.25844,434688
8493,BoardzMaster,1,0.00023,88062,20.25867,434688
8494,bobbymlp,1,0.00023,88063,20.25890,434688
8495,bobmcwhirter,1,0.00023,88064,20.25913,434688
8496,bobstead,1,0.00023,88065,20.25936,434688
8497,bochulindra,1,0.00023,88066,20.25959,434688
8498,bodz1lla,1,0.00023,88067,20.25982,434688
8499,bognerf,1,0.00023,88068,20.26005,434688
8500,bohdanborovskyi-ma,1,0.00023,88069,20.26028,434688
8501,bohlander,1,0.00023,88070,20.26051,434688
8502,BohuTANG,1,0.00023,88071,20.26074,434688
8503,boimler,1,0.00023,88072,20.26097,434688
8504,boindil,1,0.00023,88073,20.26120,434688
8505,bokysan,1,0.00023,88074,20.26143,434688
8506,BondarenkoIlya,1,0.00023,88075,20.26166,434688
8507,bonky42,1,0.00023,88076,20.26189,434688
8508,bonpapajosie,1,0.00023,88077,20.26212,434688
8509,boramalper,1,0.00023,88078,20.26235,434688
8510,boretom,1,0.00023,88079,20.26258,434688
8511,BoringCat,1,0.00023,88080,20.26281,434688
8512,boringuy,1,0.00023,88081,20.26304,434688
8513,BorisDr,1,0.00023,88082,20.26327,434688
8514,botieking98,1,0.00023,88083,20.26350,434688
8515,bouteillerAlan,1,0.00023,88084,20.26373,434688
8516,bovy89,1,0.00023,88085,20.26396,434688
8517,boxjan,1,0.00023,88086,20.26419,434688
8518,bozerkins,1,0.00023,88087,20.26442,434688
8519,bpschmitt,1,0.00023,88088,20.26465,434688
8520,bquantump,1,0.00023,88089,20.26488,434688
8521,bradfordcp,1,0.00023,88090,20.26511,434688
8522,bradleypettit,1,0.00023,88091,20.26534,434688
8523,brakthehack,1,0.00023,88092,20.26557,434688
8524,bram-abe,1,0.00023,88093,20.26580,434688
8525,branchvincent,1,0.00023,88094,20.26603,434688
8526,brandonpaiz,1,0.00023,88095,20.26626,434688
8527,BrandonWeng,1,0.00023,88096,20.26649,434688
8528,breunigs,1,0.00023,88097,20.26672,434688
8529,bri365,1,0.00023,88098,20.26695,434688
8530,brianatpu,1,0.00023,88099,20.26718,434688
8531,brian-groux-hs,1,0.00023,88100,20.26741,434688
8532,brianlieg,1,0.00023,88101,20.26764,434688
8533,brianmowens,1,0.00023,88102,20.26787,434688
8534,brianonn,1,0.00023,88103,20.26810,434688
8535,brianventuro,1,0.00023,88104,20.26833,434688
8536,brichins,1,0.00023,88105,20.26856,434688
8537,britoaldan,1,0.00023,88106,20.26879,434688
8538,brocaar,1,0.00023,88107,20.26902,434688
8539,brokencode64,1,0.00023,88108,20.26925,434688
8540,brsvpr,1,0.00023,88109,20.26948,434688
8541,brucedvgw,1,0.00023,88110,20.26971,434688
8542,brunojcm-vgw,1,0.00023,88111,20.26994,434688
8543,BrutalBirdie,1,0.00023,88112,20.27017,434688
8544,bruto1,1,0.00023,88113,20.27040,434688
8545,bry00,1,0.00023,88114,20.27063,434688
8546,bs444,1,0.00023,88115,20.27086,434688
8547,bschoenbach,1,0.00023,88116,20.27109,434688
8548,bschofield,1,0.00023,88117,20.27132,434688
8549,bsilver8192,1,0.00023,88118,20.27155,434688
8550,bsinggh,1,0.00023,88119,20.27178,434688
8551,bsloeserwij,1,0.00023,88120,20.27201,434688
8552,bspark8,1,0.00023,88121,20.27224,434688
8553,btalbot,1,0.00023,88122,20.27247,434688
8554,bt-lemery,1,0.00023,88123,20.27270,434688
8555,bubbleatgit,1,0.00023,88124,20.27293,434688
8556,buchheim,1,0.00023,88125,20.27316,434688
8557,bug-developer021,1,0.00023,88126,20.27339,434688
8558,buhuipao,1,0.00023,88127,20.27362,434688
8559,Bujail,1,0.00023,88128,20.27385,434688
8560,bukowa,1,0.00023,88129,20.27408,434688
8561,BulatSaif,1,0.00023,88130,20.27431,434688
8562,Bulbuc,1,0.00023,88131,20.27454,434688
8563,bullywhippet,1,0.00023,88132,20.27477,434688
8564,bunch-helen,1,0.00023,88133,20.27500,434688
8565,buvinghausen,1,0.00023,88134,20.27523,434688
8566,buzzdan,1,0.00023,88135,20.27546,434688
8567,bwenrich,1,0.00023,88136,20.27569,434688
8568,bwitt,1,0.00023,88137,20.27592,434688
8569,by211,1,0.00023,88138,20.27615,434688
8570,bzed,1,0.00023,88139,20.27638,434688
8571,c002910,1,0.00023,88140,20.27661,434688
8572,c0ffeec0der,1,0.00023,88141,20.27684,434688
8573,c0rv4x,1,0.00023,88142,20.27707,434688
8574,c23omega,1,0.00023,88143,20.27730,434688
8575,c2nes,1,0.00023,88144,20.27753,434688
8576,c4m4,1,0.00023,88145,20.27776,434688
8577,caddyshake,1,0.00023,88146,20.27799,434688
8578,cadiegoc,1,0.00023,88147,20.27822,434688
8579,caesuric,1,0.00023,88148,20.27845,434688
8580,caffeinism,1,0.00023,88149,20.27868,434688
8581,cainzhong,1,0.00023,88150,20.27891,434688
8582,CAIOFCP,1,0.00023,88151,20.27914,434688
8583,caiorcferreira,1,0.00023,88152,20.27937,434688
8584,caiwenhao,1,0.00023,88153,20.27960,434688
8585,cakhanif,1,0.00023,88154,20.27983,434688
8586,CalbeeMing0530,1,0.00023,88155,20.28006,434688
8587,calebplum,1,0.00023,88156,20.28029,434688
8588,calebwoofenden,1,0.00023,88157,20.28052,434688
8589,calinionesco1,1,0.00023,88158,20.28075,434688
8590,callum-tait-pbx,1,0.00023,88159,20.28098,434688
8591,calohmn,1,0.00023,88160,20.28121,434688
8592,calvin2021y,1,0.00023,88161,20.28144,434688
8593,calvinkarundu,1,0.00023,88162,20.28167,434688
8594,Camilo-TI,1,0.00023,88163,20.28190,434688
8595,campbel,1,0.00023,88164,20.28213,434688
8596,CannedFish,1,0.00023,88165,20.28236,434688
8597,cannonpalms,1,0.00023,88166,20.28259,434688
8598,CanRau,1,0.00023,88167,20.28282,434688
8599,CappuccinoCup,1,0.00023,88168,20.28305,434688
8600,Capr1sna,1,0.00023,88169,20.28328,434688
8601,capricornusx,1,0.00023,88170,20.28351,434688
8602,CaptainHulk23,1,0.00023,88171,20.28374,434688
8603,CaptAintHere,1,0.00023,88172,20.28397,434688
8604,captbirdsi,1,0.00023,88173,20.28420,434688
8605,CAR6807,1,0.00023,88174,20.28443,434688
8606,carldai0106,1,0.00023,88175,20.28466,434688
8607,carlito387,1,0.00023,88176,20.28489,434688
8608,carlosjpr-collab,1,0.00023,88177,20.28512,434688
8609,CarlosRDomin,1,0.00023,88178,20.28535,434688
8610,carlosrecuero,1,0.00023,88179,20.28558,434688
8611,CarmenAPuccio,1,0.00023,88180,20.28581,434688
8612,carpenterbees,1,0.00023,88181,20.28604,434688
8613,carrieyang1212,1,0.00023,88182,20.28627,434688
8614,carru93,1,0.00023,88183,20.28650,434688
8615,cartermckinnon,1,0.00023,88184,20.28673,434688
8616,CarTerr,1,0.00023,88185,20.28696,434688
8617,Carus11,1,0.00023,88186,20.28719,434688
8618,Cassianokunsch,1,0.00023,88187,20.28742,434688
8619,cassiofariasmachado,1,0.00023,88188,20.28765,434688
8620,cataglyphis,1,0.00023,88189,20.28788,434688
8621,catalinpan,1,0.00023,88190,20.28811,434688
8622,cater111,1,0.00023,88191,20.28834,434688
8623,catija,1,0.00023,88192,20.28857,434688
8624,ca-wvestjens,1,0.00023,88193,20.28880,434688
8625,cbron,1,0.00023,88194,20.28903,434688
8626,ccampo133,1,0.00023,88195,20.28926,434688
8627,ccc-56,1,0.00023,88196,20.28949,434688
8628,cccs-cat001,1,0.00023,88197,20.28973,434688
8629,cccswann,1,0.00023,88198,20.28996,434688
8630,ccifra,1,0.00023,88199,20.29019,434688
8631,cdc6d,1,0.00023,88200,20.29042,434688
8632,cdlliuy,1,0.00023,88201,20.29065,434688
8633,cdmadrigal,1,0.00023,88202,20.29088,434688
8634,cdoan1,1,0.00023,88203,20.29111,434688
8635,cdx7779,1,0.00023,88204,20.29134,434688
8636,cdzhangyong,1,0.00023,88205,20.29157,434688
8637,ced0ps,1,0.00023,88206,20.29180,434688
8638,cedarkuo,1,0.00023,88207,20.29203,434688
8639,celestialorb,1,0.00023,88208,20.29226,434688
8640,cellConnect,1,0.00023,88209,20.29249,434688
8641,cementfloor,1,0.00023,88210,20.29272,434688
8642,cenit,1,0.00023,88211,20.29295,434688
8643,cenkersoy,1,0.00023,88212,20.29318,434688
8644,ceroloy,1,0.00023,88213,20.29341,434688
8645,ceteongvanness,1,0.00023,88214,20.29364,434688
8646,cezarnicolescu,1,0.00023,88215,20.29387,434688
8647,cferber,1,0.00023,88216,20.29410,434688
8648,cfilleke,1,0.00023,88217,20.29433,434688
8649,cforce,1,0.00023,88218,20.29456,434688
8650,cgiraldo,1,0.00023,88219,20.29479,434688
8651,c-goldschmidt,1,0.00023,88220,20.29502,434688
8652,cgotfried,1,0.00023,88221,20.29525,434688
8653,ch42,1,0.00023,88222,20.29548,434688
8654,ch8zer,1,0.00023,88223,20.29571,434688
8655,chadbr,1,0.00023,88224,20.29594,434688
8656,chadgeary,1,0.00023,88225,20.29617,434688
8657,chainhead,1,0.00023,88226,20.29640,434688
8658,chakratn,1,0.00023,88227,20.29663,434688
8659,ChampiYann,1,0.00023,88228,20.29686,434688
8660,chanchal1987,1,0.00023,88229,20.29709,434688
8661,chandler14362,1,0.00023,88230,20.29732,434688
8662,chandlj,1,0.00023,88231,20.29755,434688
8663,chandramouleswaran,1,0.00023,88232,20.29778,434688
8664,chandru-kumar,1,0.00023,88233,20.29801,434688
8665,ChangJH-Mark,1,0.00023,88234,20.29824,434688
8666,changsheng1239,1,0.00023,88235,20.29847,434688
8667,chansonzhang,1,0.00023,88236,20.29870,434688
8668,chanvoyage,1,0.00023,88237,20.29893,434688
8669,chanxuehong,1,0.00023,88238,20.29916,434688
8670,CharlieBrownMx,1,0.00023,88239,20.29939,434688
8671,charlrvd,1,0.00023,88240,20.29962,434688
8672,chattarajoy,1,0.00023,88241,20.29985,434688
8673,chatterjeesunit,1,0.00023,88242,20.30008,434688
8674,chedim,1,0.00023,88243,20.30031,434688
8675,cheeseandcereal,1,0.00023,88244,20.30054,434688
8676,cheleb,1,0.00023,88245,20.30077,434688
8677,chenchangkuan,1,0.00023,88246,20.30100,434688
8678,chendelin1982,1,0.00023,88247,20.30123,434688
8679,chendw,1,0.00023,88248,20.30146,434688
8680,ChengDuYiyiyi,1,0.00023,88249,20.30169,434688
8681,chengyinwu-hash,1,0.00023,88250,20.30192,434688
8682,chengyuhui,1,0.00023,88251,20.30215,434688
8683,ChenhanXmu,1,0.00023,88252,20.30238,434688
8684,chenwenjun-github,1,0.00023,88253,20.30261,434688
8685,chenxianpao,1,0.00023,88254,20.30284,434688
8686,ChenZheOnePiece,1,0.00023,88255,20.30307,434688
8687,CherylFlowers,1,0.00023,88256,20.30330,434688
8688,cheslijones,1,0.00023,88257,20.30353,434688
8689,Chessray,1,0.00023,88258,20.30376,434688
8690,chet,1,0.00023,88259,20.30399,434688
8691,chibbert,1,0.00023,88260,20.30422,434688
8692,chichengchentaiwan,1,0.00023,88261,20.30445,434688
8693,chinasubbareddym,1,0.00023,88262,20.30468,434688
8694,chinky1,1,0.00023,88263,20.30491,434688
8695,chinmaykhare,1,0.00023,88264,20.30514,434688
8696,chitikenasatish,1,0.00023,88265,20.30537,434688
8697,chitralverma,1,0.00023,88266,20.30560,434688
8698,chloe88,1,0.00023,88267,20.30583,434688
8699,chmodrs,1,0.00023,88268,20.30606,434688
8700,choeyhao,1,0.00023,88269,20.30629,434688
8701,choihca,1,0.00023,88270,20.30652,434688
8702,Choongzai,1,0.00023,88271,20.30675,434688
8703,choover-broad,1,0.00023,88272,20.30698,434688
8704,choseh,1,0.00023,88273,20.30721,434688
8705,chowtin,1,0.00023,88274,20.30744,434688
8706,chpio,1,0.00023,88275,20.30767,434688
8707,chris922,1,0.00023,88276,20.30790,434688
8708,chris-ackerman-dentsu,1,0.00023,88277,20.30813,434688
8709,chrisbertsch,1,0.00023,88278,20.30836,434688
8710,chriscowley,1,0.00023,88279,20.30859,434688
8711,chrisdoherty4,1,0.00023,88280,20.30882,434688
8712,chrisfauerbach,1,0.00023,88281,20.30905,434688
8713,chris-gillatt,1,0.00023,88282,20.30928,434688
8714,chrishowell,1,0.00023,88283,20.30951,434688
8715,chrishyze,1,0.00023,88284,20.30974,434688
8716,chrisj-platform9,1,0.00023,88285,20.30997,434688
8717,chrisjune,1,0.00023,88286,20.31020,434688
8718,chris-mac,1,0.00023,88287,20.31043,434688
8719,chris-maclean,1,0.00023,88288,20.31066,434688
8720,ChrisMacNaughton,1,0.00023,88289,20.31089,434688
8721,chrismayday,1,0.00023,88290,20.31112,434688
8722,chris-parker-za,1,0.00023,88291,20.31135,434688
8723,chrispatmore,1,0.00023,88292,20.31158,434688
8724,chris-sanders,1,0.00023,88293,20.31181,434688
8725,chrisse74,1,0.00023,88294,20.31204,434688
8726,christian-2,1,0.00023,88295,20.31227,434688
8727,ChristianKippingKv-rlp,1,0.00023,88296,20.31250,434688
8728,ChristianTrolleMikkelsen,1,0.00023,88297,20.31273,434688
8729,christoph-buente,1,0.00023,88298,20.31296,434688
8730,christophebeling,1,0.00023,88299,20.31319,434688
8731,ChristopherLenz,1,0.00023,88300,20.31342,434688
8732,chrko,1,0.00023,88301,20.31365,434688
8733,chtime,1,0.00023,88302,20.31388,434688
8734,chuangxinyuan,1,0.00023,88303,20.31411,434688
8735,chudanie,1,0.00023,88304,20.31434,434688
8736,chukynax,1,0.00023,88305,20.31457,434688
8737,chunbos,1,0.00023,88306,20.31480,434688
8738,ciaracarey,1,0.00023,88307,20.31503,434688
8739,ciarancoffey,1,0.00023,88308,20.31526,434688
8740,Ci-Jie,1,0.00023,88309,20.31549,434688
8741,ciklista,1,0.00023,88310,20.31572,434688
8742,cipy,1,0.00023,88311,20.31595,434688
8743,cist,1,0.00023,88312,20.31618,434688
8744,civilizeddev,1,0.00023,88313,20.31641,434688
8745,cjcobb23,1,0.00023,88314,20.31664,434688
8746,Cjkjvfnby,1,0.00023,88315,20.31687,434688
8747,cjnchk,1,0.00023,88316,20.31710,434688
8748,cjohnstoniv,1,0.00023,88317,20.31733,434688
8749,ckanner,1,0.00023,88318,20.31756,434688
8750,CKarper,1,0.00023,88319,20.31779,434688
8751,CKJJ,1,0.00023,88320,20.31802,434688
8752,ckw017,1,0.00023,88321,20.31825,434688
8753,claenjoy,1,0.00023,88322,20.31848,434688
8754,clarkdoan,1,0.00023,88323,20.31871,434688
8755,clarkli86,1,0.00023,88324,20.31894,434688
8756,clausa20,1,0.00023,88325,20.31917,434688
8757,clavierpaul,1,0.00023,88326,20.31940,434688
8758,clbx,1,0.00023,88327,20.31963,434688
8759,clementnuss,1,0.00023,88328,20.31986,434688
8760,cleo2525,1,0.00023,88329,20.32009,434688
8761,cletustboone,1,0.00023,88330,20.32032,434688
8762,clincha,1,0.00023,88331,20.32055,434688
8763,Clivern,1,0.00023,88332,20.32078,434688
8764,CloudWise-Lukemiao,1,0.00023,88333,20.32101,434688
8765,CloudXiaobai,1,0.00023,88334,20.32124,434688
8766,clumsy456,1,0.00023,88335,20.32147,434688
8767,clwluvw,1,0.00023,88336,20.32170,434688
8768,cmacrae,1,0.00023,88337,20.32193,434688
8769,cmillani,1,0.00023,88338,20.32216,434688
8770,cmsax,1,0.00023,88339,20.32239,434688
8771,cnatan,1,0.00023,88340,20.32262,434688
8772,cnmill,1,0.00023,88341,20.32285,434688
8773,cnscud,1,0.00023,88342,20.32308,434688
8774,cnwangjie,1,0.00023,88343,20.32331,434688
8775,cobly,1,0.00023,88344,20.32354,434688
8776,cobookman,1,0.00023,88345,20.32377,434688
8777,codami,1,0.00023,88346,20.32400,434688
8778,Code7Bit,1,0.00023,88347,20.32423,434688
8779,codechennerator,1,0.00023,88348,20.32446,434688
8780,codernitish,1,0.00023,88349,20.32469,434688
8781,coderpatros,1,0.00023,88350,20.32492,434688
8782,codeWithUtkarsh,1,0.00023,88351,20.32515,434688
8783,codingconcepts,1,0.00023,88352,20.32538,434688
8784,codybuell,1,0.00023,88353,20.32561,434688
8785,cole-easton,1,0.00023,88354,20.32584,434688
8786,CO-lhagman,1,0.00023,88355,20.32607,434688
8787,colinbjohnson,1,0.00023,88356,20.32630,434688
8788,collardmsc,1,0.00023,88357,20.32653,434688
8789,ColleIsarco,1,0.00023,88358,20.32676,434688
8790,Colleoni,1,0.00023,88359,20.32699,434688
8791,collimarco,1,0.00023,88360,20.32722,434688
8792,collinjlesko,1,0.00023,88361,20.32745,434688
8793,com6056,1,0.00023,88362,20.32768,434688
8794,comdiv,1,0.00023,88363,20.32791,434688
8795,comdor,1,0.00023,88364,20.32814,434688
8796,comsky,1,0.00023,88365,20.32837,434688
8797,conradoverta,1,0.00023,88366,20.32860,434688
8798,Conrimaceogain,1,0.00023,88367,20.32883,434688
8799,constb,1,0.00023,88368,20.32906,434688
8800,coopbri,1,0.00023,88369,20.32929,434688
8801,cooperaj,1,0.00023,88370,20.32952,434688
8802,coopstools,1,0.00023,88371,20.32975,434688
8803,corbaejb,1,0.00023,88372,20.32998,434688
8804,corend,1,0.00023,88373,20.33021,434688
8805,CoreTechnologyAG,1,0.00023,88374,20.33044,434688
8806,CoReYeDe,1,0.00023,88375,20.33067,434688
8807,cortex93,1,0.00023,88376,20.33090,434688
8808,CosmosNi,1,0.00023,88377,20.33113,434688
8809,coufalja,1,0.00023,88378,20.33136,434688
8810,countablecloud,1,0.00023,88379,20.33159,434688
8811,couragecc,1,0.00023,88380,20.33182,434688
8812,cparedes,1,0.00023,88381,20.33205,434688
8813,cpflaume,1,0.00023,88382,20.33228,434688
8814,cpmoore,1,0.00023,88383,20.33251,434688
8815,cptkng23,1,0.00023,88384,20.33274,434688
8816,cpu601,1,0.00023,88385,20.33297,434688
8817,cpumanaz,1,0.00023,88386,20.33320,434688
8818,cpxPratik,1,0.00023,88387,20.33343,434688
8819,cq-z,1,0.00023,88388,20.33366,434688
8820,crablab,1,0.00023,88389,20.33389,434688
8821,craigjennings11,1,0.00023,88390,20.33412,434688
8822,craig-lancaster,1,0.00023,88391,20.33435,434688
8823,craig-seeman,1,0.00023,88392,20.33458,434688
8824,CRASH-Tech,1,0.00023,88393,20.33481,434688
8825,Creator1024,1,0.00023,88394,20.33504,434688
8826,crinjes,1,0.00023,88395,20.33527,434688
8827,CriProphet,1,0.00023,88396,20.33551,434688
8828,crispaulcastaneda,1,0.00023,88397,20.33574,434688
8829,cristinagrosu,1,0.00023,88398,20.33597,434688
8830,crn420,1,0.00023,88399,20.33620,434688
8831,cr-noamguy,1,0.00023,88400,20.33643,434688
8832,crockk,1,0.00023,88401,20.33666,434688
8833,crokobit,1,0.00023,88402,20.33689,434688
8834,crosvera,1,0.00023,88403,20.33712,434688
8835,crshumate,1,0.00023,88404,20.33735,434688
8836,cruikshj,1,0.00023,88405,20.33758,434688
8837,CruxBox,1,0.00023,88406,20.33781,434688
8838,Csaba-emnify,1,0.00023,88407,20.33804,434688
8839,CSchathuranga,1,0.00023,88408,20.33827,434688
8840,csdnkrue1,1,0.00023,88409,20.33850,434688
8841,CSimpiFoN,1,0.00023,88410,20.33873,434688
8842,csjiang,1,0.00023,88411,20.33896,434688
8843,cskarby,1,0.00023,88412,20.33919,434688
8844,cslanjian,1,0.00023,88413,20.33942,434688
8845,cslinuxfr,1,0.00023,88414,20.33965,434688
8846,cslovell,1,0.00023,88415,20.33988,434688
8847,csombok,1,0.00023,88416,20.34011,434688
8848,cswangzheng,1,0.00023,88417,20.34034,434688
8849,csweichel,1,0.00023,88418,20.34057,434688
8850,ctolon22,1,0.00023,88419,20.34080,434688
8851,ctr26,1,0.00023,88420,20.34103,434688
8852,CtrlAltDft,1,0.00023,88421,20.34126,434688
8853,cujo,1,0.00023,88422,20.34149,434688
8854,cuonglm,1,0.00023,88423,20.34172,434688
8855,cupdike,1,0.00023,88424,20.34195,434688
8856,Cuphinx,1,0.00023,88425,20.34218,434688
8857,curantes,1,0.00023,88426,20.34241,434688
8858,curusarn,1,0.00023,88427,20.34264,434688
8859,cvanhalt,1,0.00023,88428,20.34287,434688
8860,cvestre-cisco,1,0.00023,88429,20.34310,434688
8861,cve-team,1,0.00023,88430,20.34333,434688
8862,cvitaa11,1,0.00023,88431,20.34356,434688
8863,cweagans,1,0.00023,88432,20.34379,434688
8864,cybaj,1,0.00023,88433,20.34402,434688
8865,Cynocracy,1,0.00023,88434,20.34425,434688
8866,cyzcyzz,1,0.00023,88435,20.34448,434688
8867,cz150,1,0.00023,88436,20.34471,434688
8868,CzarMich,1,0.00023,88437,20.34494,434688
8869,czenker,1,0.00023,88438,20.34517,434688
8870,czomo,1,0.00023,88439,20.34540,434688
8871,d2e,1,0.00023,88440,20.34563,434688
8872,d3v-S,1,0.00023,88441,20.34586,434688
8873,dabljues,1,0.00023,88442,20.34609,434688
8874,dadrus,1,0.00023,88443,20.34632,434688
8875,dagan,1,0.00023,88444,20.34655,434688
8876,DaGeRe,1,0.00023,88445,20.34678,434688
8877,daheige,1,0.00023,88446,20.34701,434688
8878,daianamezdrea,1,0.00023,88447,20.34724,434688
8879,dalfos,1,0.00023,88448,20.34747,434688
8880,dambor,1,0.00023,88449,20.34770,434688
8881,DamianoChini,1,0.00023,88450,20.34793,434688
8882,damirda,1,0.00023,88451,20.34816,434688
8883,damnever,1,0.00023,88452,20.34839,434688
8884,damonjbeasley,1,0.00023,88453,20.34862,434688
8885,damoon,1,0.00023,88454,20.34885,434688
8886,dana-harrington,1,0.00023,88455,20.34908,434688
8887,danbarr,1,0.00023,88456,20.34931,434688
8888,danbrad,1,0.00023,88457,20.34954,434688
8889,dan-evolvere,1,0.00023,88458,20.34977,434688
8890,DanForys,1,0.00023,88459,20.35000,434688
8891,DangChien,1,0.00023,88460,20.35023,434688
8892,DaniBet,1,0.00023,88461,20.35046,434688
8893,danicheeta,1,0.00023,88462,20.35069,434688
8894,DanielBanobreDopico,1,0.00023,88463,20.35092,434688
8895,danieldides,1,0.00023,88464,20.35115,434688
8896,Danielferencz21,1,0.00023,88465,20.35138,434688
8897,danielgblanco,1,0.00023,88466,20.35161,434688
8898,DanielGrunberger,1,0.00023,88467,20.35184,434688
8899,danielGz,1,0.00023,88468,20.35207,434688
8900,daniel-kotler-exa,1,0.00023,88469,20.35230,434688
8901,danielkucera,1,0.00023,88470,20.35253,434688
8902,DanielZhangQD,1,0.00023,88471,20.35276,434688
8903,DanielZuck,1,0.00023,88472,20.35299,434688
8904,DaniilHarik,1,0.00023,88473,20.35322,434688
8905,danilnich,1,0.00023,88474,20.35345,434688
8906,danmichaelo,1,0.00023,88475,20.35368,434688
8907,danmillwood,1,0.00023,88476,20.35391,434688
8908,danmutblix,1,0.00023,88477,20.35414,434688
8909,DanNiESh,1,0.00023,88478,20.35437,434688
8910,Danny200,1,0.00023,88479,20.35460,434688
8911,dannydombrowski,1,0.00023,88480,20.35483,434688
8912,dannyhertz,1,0.00023,88481,20.35506,434688
8913,dannylee-,1,0.00023,88482,20.35529,434688
8914,dannystaple,1,0.00023,88483,20.35552,434688
8915,dannyxu2015,1,0.00023,88484,20.35575,434688
8916,danp60,1,0.00023,88485,20.35598,434688
8917,danpawlik,1,0.00023,88486,20.35621,434688
8918,danroconnor,1,0.00023,88487,20.35644,434688
8919,danshapir,1,0.00023,88488,20.35667,434688
8920,DanSibbernsen,1,0.00023,88489,20.35690,434688
8921,danstancu,1,0.00023,88490,20.35713,434688
8922,DanStory,1,0.00023,88491,20.35736,434688
8923,dan-tw,1,0.00023,88492,20.35759,434688
8924,danvaida,1,0.00023,88493,20.35782,434688
8925,DanWahlin,1,0.00023,88494,20.35805,434688
8926,danwoytowich,1,0.00023,88495,20.35828,434688
8927,danylott,1,0.00023,88496,20.35851,434688
8928,daraghlowe,1,0.00023,88497,20.35874,434688
8929,darakian,1,0.00023,88498,20.35897,434688
8930,dario617,1,0.00023,88499,20.35920,434688
8931,dariov1988,1,0.00023,88500,20.35943,434688
8932,Dariusch,1,0.00023,88501,20.35966,434688
8933,dariusgrassi,1,0.00023,88502,20.35989,434688
8934,darkgordon,1,0.00023,88503,20.36012,434688
8935,darklore,1,0.00023,88504,20.36035,434688
8936,Darkmasterhk,1,0.00023,88505,20.36058,434688
8937,dark-shade,1,0.00023,88506,20.36081,434688
8938,darksinge,1,0.00023,88507,20.36104,434688
8939,Darrenzzy,1,0.00023,88508,20.36127,434688
8940,DarwinSurvivor,1,0.00023,88509,20.36150,434688
8941,darzanebor,1,0.00023,88510,20.36173,434688
8942,dashingsat,1,0.00023,88511,20.36196,434688
8943,DasSkelett,1,0.00023,88512,20.36219,434688
8944,daugustin,1,0.00023,88513,20.36242,434688
8945,davedbase,1,0.00023,88514,20.36265,434688
8946,davehodg,1,0.00023,88515,20.36288,434688
8947,davehorton,1,0.00023,88516,20.36311,434688
8948,davem-pearson,1,0.00023,88517,20.36334,434688
8949,Daverkex,1,0.00023,88518,20.36357,434688
8950,davesilva,1,0.00023,88519,20.36380,434688
8951,davesuketu215,1,0.00023,88520,20.36403,434688
8952,david1alvarez,1,0.00023,88521,20.36426,434688
8953,davidamin,1,0.00023,88522,20.36449,434688
8954,davidberglund,1,0.00023,88523,20.36472,434688
8955,davidbIQ,1,0.00023,88524,20.36495,434688
8956,daviddenton,1,0.00023,88525,20.36518,434688
8957,davideicardi,1,0.00023,88526,20.36541,434688
8958,David-Kenkadze,1,0.00023,88527,20.36564,434688
8959,davidli2010,1,0.00023,88528,20.36587,434688
8960,DavidMonk00,1,0.00023,88529,20.36610,434688
8961,davidmukiibi,1,0.00023,88530,20.36633,434688
8962,davidroth,1,0.00023,88531,20.36656,434688
8963,david-seo-dubber,1,0.00023,88532,20.36679,434688
8964,davidshare,1,0.00023,88533,20.36702,434688
8965,davidstrauss,1,0.00023,88534,20.36725,434688
8966,Davidsv,1,0.00023,88535,20.36748,434688
8967,davidwneary,1,0.00023,88536,20.36771,434688
8968,davisg123,1,0.00023,88537,20.36794,434688
8969,Davitron,1,0.00023,88538,20.36817,434688
8970,davix,1,0.00023,88539,20.36840,434688
8971,davo,1,0.00023,88540,20.36863,434688
8972,davorceman,1,0.00023,88541,20.36886,434688
8973,davoustp,1,0.00023,88542,20.36909,434688
8974,dawidd6,1,0.00023,88543,20.36932,434688
8975,Daxcor69,1,0.00023,88544,20.36955,434688
8976,daxhuiberts,1,0.00023,88545,20.36978,434688
8977,dayongi,1,0.00023,88546,20.37001,434688
8978,dbalpha,1,0.00023,88547,20.37024,434688
8979,dbluxo,1,0.00023,88548,20.37047,434688
8980,dborman-hpe,1,0.00023,88549,20.37070,434688
8981,dbpolito,1,0.00023,88550,20.37093,434688
8982,dcarlet,1,0.00023,88551,20.37116,434688
8983,dcavour,1,0.00023,88552,20.37139,434688
8984,dcermak,1,0.00023,88553,20.37162,434688
8985,dchandekstark,1,0.00023,88554,20.37185,434688
8986,dcharbonnier,1,0.00023,88555,20.37208,434688
8987,dclarke,1,0.00023,88556,20.37231,434688
8988,dcodix,1,0.00023,88557,20.37254,434688
8989,dcomas,1,0.00023,88558,20.37277,434688
8990,ddelange,1,0.00023,88559,20.37300,434688
8991,ddelnano,1,0.00023,88560,20.37323,434688
8992,ddl-kevin,1,0.00023,88561,20.37346,434688
8993,ddmendes,1,0.00023,88562,20.37369,434688
8994,ddorando,1,0.00023,88563,20.37392,434688
8995,DDSharma1,1,0.00023,88564,20.37415,434688
8996,ddskit,1,0.00023,88565,20.37438,434688
8997,ddurham2,1,0.00023,88566,20.37461,434688
8998,dearchap,1,0.00023,88567,20.37484,434688
8999,DeathRabbit679,1,0.00023,88568,20.37507,434688
9000,debayande,1,0.00023,88569,20.37530,434688
9001,debimishra89,1,0.00023,88570,20.37553,434688
9002,DebojyotiGhosal,1,0.00023,88571,20.37576,434688
9003,debuggerpk,1,0.00023,88572,20.37599,434688
9004,deceive3w,1,0.00023,88573,20.37622,434688
9005,declard,1,0.00023,88574,20.37645,434688
9006,deekshaaneja,1,0.00023,88575,20.37668,434688
9007,deepahoskote,1,0.00023,88576,20.37691,434688
9008,deepak7093,1,0.00023,88577,20.37714,434688
9009,deepakgc,1,0.00023,88578,20.37737,434688
9010,deepak-malhotra,1,0.00023,88579,20.37760,434688
9011,deepakponnada,1,0.00023,88580,20.37783,434688
9012,deeprooteddev,1,0.00023,88581,20.37806,434688
9013,deepshikhaaa,1,0.00023,88582,20.37829,434688
9014,defenestration,1,0.00023,88583,20.37852,434688
9015,defool,1,0.00023,88584,20.37875,434688
9016,Deichindianer,1,0.00023,88585,20.37898,434688
9017,DeirdreRodgers,1,0.00023,88586,20.37921,434688
9018,dejanzele,1,0.00023,88587,20.37944,434688
9019,dekimsey,1,0.00023,88588,20.37967,434688
9020,deleff,1,0.00023,88589,20.37990,434688
9021,Delfos98,1,0.00023,88590,20.38013,434688
9022,deliahu,1,0.00023,88591,20.38036,434688
9023,DellEMCProductSecurity,1,0.00023,88592,20.38059,434688
9024,delong-coder,1,0.00023,88593,20.38082,434688
9025,DengLZ,1,0.00023,88594,20.38105,434688
9026,dengziming,1,0.00023,88595,20.38128,434688
9027,denisgmarques,1,0.00023,88596,20.38152,434688
9028,denissabramovs,1,0.00023,88597,20.38175,434688
9029,denissimonovski,1,0.00023,88598,20.38198,434688
9030,denitiu,1,0.00023,88599,20.38221,434688
9031,denniceritchie,1,0.00023,88600,20.38244,434688
9032,dennis08,1,0.00023,88601,20.38267,434688
9033,denniseffing,1,0.00023,88602,20.38290,434688
9034,depeele,1,0.00023,88603,20.38313,434688
9035,derekguo001,1,0.00023,88604,20.38336,434688
9036,derekmauro,1,0.00023,88605,20.38359,434688
9037,derence2002,1,0.00023,88606,20.38382,434688
9038,derjust,1,0.00023,88607,20.38405,434688
9039,derketo,1,0.00023,88608,20.38428,434688
9040,derTobsch,1,0.00023,88609,20.38451,434688
9041,Des333,1,0.00023,88610,20.38474,434688
9042,destallon,1,0.00023,88611,20.38497,434688
9043,DestroyerAlpha,1,0.00023,88612,20.38520,434688
9044,deuch,1,0.00023,88613,20.38543,434688
9045,devinnasar,1,0.00023,88614,20.38566,434688
9046,devivaraprasad901,1,0.00023,88615,20.38589,434688
9047,devlifealways,1,0.00023,88616,20.38612,434688
9048,dev-mull,1,0.00023,88617,20.38635,434688
9049,devNajjary,1,0.00023,88618,20.38658,434688
9050,dev-ninja-ops,1,0.00023,88619,20.38681,434688
9051,devodev,1,0.00023,88620,20.38704,434688
9052,devopstales,1,0.00023,88621,20.38727,434688
9053,devplayerJoe,1,0.00023,88622,20.38750,434688
9054,devrajmaker,1,0.00023,88623,20.38773,434688
9055,DevsAnon,1,0.00023,88624,20.38796,434688
9056,DevSrSouza,1,0.00023,88625,20.38819,434688
9057,dewnull,1,0.00023,88626,20.38842,434688
9058,dextras,1,0.00023,88627,20.38865,434688
9059,DeyunLuo,1,0.00023,88628,20.38888,434688
9060,dfeddema,1,0.00023,88629,20.38911,434688
9061,dfengshi,1,0.00023,88630,20.38934,434688
9062,dfisher1,1,0.00023,88631,20.38957,434688
9063,dfisk,1,0.00023,88632,20.38980,434688
9064,dfsdevops,1,0.00023,88633,20.39003,434688
9065,dfyz011,1,0.00023,88634,20.39026,434688
9066,dg424,1,0.00023,88635,20.39049,434688
9067,dgetu,1,0.00023,88636,20.39072,434688
9068,dgo-,1,0.00023,88637,20.39095,434688
9069,dgrechka,1,0.00023,88638,20.39118,434688
9070,dgrozenok,1,0.00023,88639,20.39141,434688
9071,dgurns,1,0.00023,88640,20.39164,434688
9072,Dh0ren,1,0.00023,88641,20.39187,434688
9073,dharmasitepu,1,0.00023,88642,20.39210,434688
9074,dhax,1,0.00023,88643,20.39233,434688
9075,dherbert97,1,0.00023,88644,20.39256,434688
9076,DhimanNeha,1,0.00023,88645,20.39279,434688
9077,Dhirajdgandhi,1,0.00023,88646,20.39302,434688
9078,dh-ironsec,1,0.00023,88647,20.39325,434688
9079,dhiruLeo,1,0.00023,88648,20.39348,434688
9080,Diamonds0a,1,0.00023,88649,20.39371,434688
9081,diegosaul402,1,0.00023,88650,20.39394,434688
9082,difrost,1,0.00023,88651,20.39417,434688
9083,diggerdric,1,0.00023,88652,20.39440,434688
9084,digibank-rons,1,0.00023,88653,20.39463,434688
9085,dilipkk-foyernet,1,0.00023,88654,20.39486,434688
9086,dima-atg,1,0.00023,88655,20.39509,434688
9087,dimatha,1,0.00023,88656,20.39532,434688
9088,dimay2,1,0.00023,88657,20.39555,434688
9089,dimitris444,1,0.00023,88658,20.39578,434688
9090,Dimitriusos,1,0.00023,88659,20.39601,434688
9091,dimitrmo,1,0.00023,88660,20.39624,434688
9092,dimkin-eu,1,0.00023,88661,20.39647,434688
9093,Dimple-dsk,1,0.00023,88662,20.39670,434688
9094,dineshpatilcloud,1,0.00023,88663,20.39693,434688
9095,dingsihua,1,0.00023,88664,20.39716,434688
9096,dinhanhhuy,1,0.00023,88665,20.39739,434688
9097,dinvlad,1,0.00023,88666,20.39762,434688
9098,diodel-agr,1,0.00023,88667,20.39785,434688
9099,diogommartins,1,0.00023,88668,20.39808,434688
9100,dipanjank,1,0.00023,88669,20.39831,434688
9101,Dipenbhatt03,1,0.00023,88670,20.39854,434688
9102,DisasteR,1,0.00023,88671,20.39877,434688
9103,discdisk,1,0.00023,88672,20.39900,434688
9104,disconn3ct,1,0.00023,88673,20.39923,434688
9105,disconnect3d,1,0.00023,88674,20.39946,434688
9106,dissoupov,1,0.00023,88675,20.39969,434688
9107,divan,1,0.00023,88676,20.39992,434688
9108,divbhasin,1,0.00023,88677,20.40015,434688
9109,Divyagitnew,1,0.00023,88678,20.40038,434688
9110,djingoule,1,0.00023,88679,20.40061,434688
9111,djnautiyal,1,0.00023,88680,20.40084,434688
9112,djvs,1,0.00023,88681,20.40107,434688
9113,dk-lockdown,1,0.00023,88682,20.40130,434688
9114,dkolovrat,1,0.00023,88683,20.40153,434688
9115,dlisin,1,0.00023,88684,20.40176,434688
9116,d-lopes,1,0.00023,88685,20.40199,434688
9117,dlunch,1,0.00023,88686,20.40222,434688
9118,dmanchon,1,0.00023,88687,20.40245,434688
9119,dmarar,1,0.00023,88688,20.40268,434688
9120,dmares01,1,0.00023,88689,20.40291,434688
9121,dmhursh,1,0.00023,88690,20.40314,434688
9122,dmichel1,1,0.00023,88691,20.40337,434688
9123,dmikusa,1,0.00023,88692,20.40360,434688
9124,DmitriGekhtman,1,0.00023,88693,20.40383,434688
9125,DmitrijDN,1,0.00023,88694,20.40406,434688
9126,dmitry-rachkov,1,0.00023,88695,20.40429,434688
9127,DmitryTravyan,1,0.00023,88696,20.40452,434688
9128,dmlond,1,0.00023,88697,20.40475,434688
9129,dmytrostriletskyi,1,0.00023,88698,20.40498,434688
9130,dnguyenzd,1,0.00023,88699,20.40521,434688
9131,dnrecording,1,0.00023,88700,20.40544,434688
9132,D-o-c,1,0.00023,88701,20.40567,434688
9133,doctorpangloss,1,0.00023,88702,20.40590,434688
9134,dod-jwhite,1,0.00023,88703,20.40613,434688
9135,doit05,1,0.00023,88704,20.40636,434688
9136,dolfly,1,0.00023,88705,20.40659,434688
9137,domainname,1,0.00023,88706,20.40682,434688
9138,domenjesenovec,1,0.00023,88707,20.40705,434688
9139,dominch,1,0.00023,88708,20.40728,434688
9140,dominicqi,1,0.00023,88709,20.40751,434688
9141,dominiquehunziker,1,0.00023,88710,20.40774,434688
9142,Domodan,1,0.00023,88711,20.40797,434688
9143,donaldh,1,0.00023,88712,20.40820,434688
9144,DonAndrey,1,0.00023,88713,20.40843,434688
9145,Donatas-M,1,0.00023,88714,20.40866,434688
9146,dongyan8912,1,0.00023,88715,20.40889,434688
9147,Donkere-vader,1,0.00023,88716,20.40912,434688
9148,donutmonger,1,0.00023,88717,20.40935,434688
9149,DonYum,1,0.00023,88718,20.40958,434688
9150,DorianRoos,1,0.00023,88719,20.40981,434688
9151,Doron-Bargo,1,0.00023,88720,20.41004,434688
9152,dorrabb,1,0.00023,88721,20.41027,434688
9153,Dorsivan,1,0.00023,88722,20.41050,434688
9154,Dorthu,1,0.00023,88723,20.41073,434688
9155,doublest,1,0.00023,88724,20.41096,434688
9156,doug-ba,1,0.00023,88725,20.41119,434688
9157,douxiaoniu77,1,0.00023,88726,20.41142,434688
9158,dpachiappan,1,0.00023,88727,20.41165,434688
9159,dpbevin,1,0.00023,88728,20.41188,434688
9160,dpedu,1,0.00023,88729,20.41211,434688
9161,dperetz1,1,0.00023,88730,20.41234,434688
9162,dpmerron-ltd,1,0.00023,88731,20.41257,434688
9163,DpoBoceka,1,0.00023,88732,20.41280,434688
9164,drakejin,1,0.00023,88733,20.41303,434688
9165,drAlberT,1,0.00023,88734,20.41326,434688
9166,dr-duke,1,0.00023,88735,20.41349,434688
9167,dr-duplo,1,0.00023,88736,20.41372,434688
9168,dreamskyw,1,0.00023,88737,20.41395,434688
9169,Dredd13,1,0.00023,88738,20.41418,434688
9170,dredwilliams,1,0.00023,88739,20.41441,434688
9171,drewcorlin1,1,0.00023,88740,20.41464,434688
9172,drewswiredin,1,0.00023,88741,20.41487,434688
9173,drex333,1,0.00023,88742,20.41510,434688
9174,drissamri,1,0.00023,88743,20.41533,434688
9175,driverpt,1,0.00023,88744,20.41556,434688
9176,drmaciej,1,0.00023,88745,20.41579,434688
9177,drobit,1,0.00023,88746,20.41602,434688
9178,drodriguez78,1,0.00023,88747,20.41625,434688
9179,dromaniuk,1,0.00023,88748,20.41648,434688
9180,drosket,1,0.00023,88749,20.41671,434688
9181,drtobbyas,1,0.00023,88750,20.41694,434688
9182,Drugoy,1,0.00023,88751,20.41717,434688
9183,d-rupp,1,0.00023,88752,20.41740,434688
9184,drz9,1,0.00023,88753,20.41763,434688
9185,dsayan154,1,0.00023,88754,20.41786,434688
9186,dschaaff,1,0.00023,88755,20.41809,434688
9187,dschwoerer,1,0.00023,88756,20.41832,434688
9188,dsedivec,1,0.00023,88757,20.41855,434688
9189,dsharp-pivotal,1,0.00023,88758,20.41878,434688
9190,dshato42,1,0.00023,88759,20.41901,434688
9191,dsmith3197,1,0.00023,88760,20.41924,434688
9192,Dsqds,1,0.00023,88761,20.41947,434688
9193,dstibbe,1,0.00023,88762,20.41970,434688
9194,dstreet,1,0.00023,88763,20.41993,434688
9195,dsuievalov,1,0.00023,88764,20.42016,434688
9196,DTavaszi,1,0.00023,88765,20.42039,434688
9197,dtln820,1,0.00023,88766,20.42062,434688
9198,du86796922,1,0.00023,88767,20.42085,434688
9199,duanbaihong,1,0.00023,88768,20.42108,434688
9200,duanbing,1,0.00023,88769,20.42131,434688
9201,dubeno,1,0.00023,88770,20.42154,434688
9202,dud225,1,0.00023,88771,20.42177,434688
9203,dududko,1,0.00023,88772,20.42200,434688
9204,dudumao520,1,0.00023,88773,20.42223,434688
9205,duedal,1,0.00023,88774,20.42246,434688
9206,dumaresq,1,0.00023,88775,20.42269,434688
9207,Duncan-tree-zhou,1,0.00023,88776,20.42292,434688
9208,duritong,1,0.00023,88777,20.42315,434688
9209,DuskXi,1,0.00023,88778,20.42338,434688
9210,dvmrry,1,0.00023,88779,20.42361,434688
9211,dvob,1,0.00023,88780,20.42384,434688
9212,dwaynebailey,1,0.00023,88781,20.42407,434688
9213,dwhu,1,0.00023,88782,20.42430,434688
9214,dwink,1,0.00023,88783,20.42453,434688
9215,dxas90,1,0.00023,88784,20.42476,434688
9216,dy009,1,0.00023,88785,20.42499,434688
9217,dy21335,1,0.00023,88786,20.42522,434688
9218,dycheng-sf,1,0.00023,88787,20.42545,434688
9219,dylanlingelbach,1,0.00023,88788,20.42568,434688
9220,dylanPowers,1,0.00023,88789,20.42591,434688
9221,dymitrs,1,0.00023,88790,20.42614,434688
9222,dynamite-bud,1,0.00023,88791,20.42637,434688
9223,dysinger,1,0.00023,88792,20.42660,434688
9224,dystopiandev,1,0.00023,88793,20.42683,434688
9225,d-zalewski,1,0.00023,88794,20.42706,434688
9226,dzirg44,1,0.00023,88795,20.42729,434688
9227,Dziuniekhm,1,0.00023,88796,20.42753,434688
9228,dzkaraka,1,0.00023,88797,20.42776,434688
9229,dzsquared,1,0.00023,88798,20.42799,434688
9230,dzvon,1,0.00023,88799,20.42822,434688
9231,e33ivanyauwai,1,0.00023,88800,20.42845,434688
9232,eagle4567,1,0.00023,88801,20.42868,434688
9233,earnm40,1,0.00023,88802,20.42891,434688
9234,earthquakesan,1,0.00023,88803,20.42914,434688
9235,ebilling,1,0.00023,88804,20.42937,434688
9236,ecerulm,1,0.00023,88805,20.42960,434688
9237,ecktom,1,0.00023,88806,20.42983,434688
9238,ed2020dev,1,0.00023,88807,20.43006,434688
9239,eddieparker,1,0.00023,88808,20.43029,434688
9240,EddyJLSH,1,0.00023,88809,20.43052,434688
9241,edemen,1,0.00023,88810,20.43075,434688
9242,edgan,1,0.00023,88811,20.43098,434688
9243,EdgeJ,1,0.00023,88812,20.43121,434688
9244,edgsantos,1,0.00023,88813,20.43144,434688
9245,edify42,1,0.00023,88814,20.43167,434688
9246,edigaryev,1,0.00023,88815,20.43190,434688
9247,edmondsw,1,0.00023,88816,20.43213,434688
9248,edoardo-borsato,1,0.00023,88817,20.43236,434688
9249,eduardoaemunoz,1,0.00023,88818,20.43259,434688
9250,eduardobarbosa,1,0.00023,88819,20.43282,434688
9251,eduardoriveror,1,0.00023,88820,20.43305,434688
9252,eeijlar,1,0.00023,88821,20.43328,434688
9253,efahlstrom,1,0.00023,88822,20.43351,434688
9254,Efesto,1,0.00023,88823,20.43374,434688
9255,eglookz,1,0.00023,88824,20.43397,434688
9256,egmkang,1,0.00023,88825,20.43420,434688
9257,egruble,1,0.00023,88826,20.43443,434688
9258,ehsanialireza,1,0.00023,88827,20.43466,434688
9259,ehsanrezaee,1,0.00023,88828,20.43489,434688
9260,ei09010,1,0.00023,88829,20.43512,434688
9261,eikooc,1,0.00023,88830,20.43535,434688
9262,eileensheu,1,0.00023,88831,20.43558,434688
9263,ejiek,1,0.00023,88832,20.43581,434688
9264,ejose19,1,0.00023,88833,20.43604,434688
9265,ekalosak,1,0.00023,88834,20.43627,434688
9266,EkeleAsonye,1,0.00023,88835,20.43650,434688
9267,ekmobile,1,0.00023,88836,20.43673,434688
9268,Ekwav,1,0.00023,88837,20.43696,434688
9269,elderwann,1,0.00023,88838,20.43719,434688
9270,eleaar,1,0.00023,88839,20.43742,434688
9271,electricmind007,1,0.00023,88840,20.43765,434688
9272,ElectricVampire,1,0.00023,88841,20.43788,434688
9273,Elettronik,1,0.00023,88842,20.43811,434688
9274,elghazal-a,1,0.00023,88843,20.43834,434688
9275,eliekoren,1,0.00023,88844,20.43857,434688
9276,eli-kaplan,1,0.00023,88845,20.43880,434688
9277,elisvaldoazevedo,1,0.00023,88846,20.43903,434688
9278,eliw00d,1,0.00023,88847,20.43926,434688
9279,EliyaCohen,1,0.00023,88848,20.43949,434688
9280,elliott-king,1,0.00023,88849,20.43972,434688
9281,ellirad,1,0.00023,88850,20.43995,434688
9282,ellispritchard,1,0.00023,88851,20.44018,434688
9283,elops-od,1,0.00023,88852,20.44041,434688
9284,elsbrock,1,0.00023,88853,20.44064,434688
9285,emckean,1,0.00023,88854,20.44087,434688
9286,emenendez,1,0.00023,88855,20.44110,434688
9287,emil14,1,0.00023,88856,20.44133,434688
9288,emiletab,1,0.00023,88857,20.44156,434688
9289,eminokic,1,0.00023,88858,20.44179,434688
9290,emolitor,1,0.00023,88859,20.44202,434688
9291,Emon46,1,0.00023,88860,20.44225,434688
9292,empinator,1,0.00023,88861,20.44248,434688
9293,EmptyShadow,1,0.00023,88862,20.44271,434688
9294,emraanali11,1,0.00023,88863,20.44294,434688
9295,emranbm,1,0.00023,88864,20.44317,434688
9296,emy-lee,1,0.00023,88865,20.44340,434688
9297,encigem,1,0.00023,88866,20.44363,434688
9298,enderv,1,0.00023,88867,20.44386,434688
9299,endlesstravel,1,0.00023,88868,20.44409,434688
9300,engmustafak26,1,0.00023,88869,20.44432,434688
9301,enkeyz,1,0.00023,88870,20.44455,434688
9302,Ennosigaeon,1,0.00023,88871,20.44478,434688
9303,ENQSUWY,1,0.00023,88872,20.44501,434688
9304,Enrico204,1,0.00023,88873,20.44524,434688
9305,enrico-j-yang,1,0.00023,88874,20.44547,434688
9306,enricorotundo,1,0.00023,88875,20.44570,434688
9307,enyinna1234,1,0.00023,88876,20.44593,434688
9308,enyo,1,0.00023,88877,20.44616,434688
9309,eolouw,1,0.00023,88878,20.44639,434688
9310,eoneal89,1,0.00023,88879,20.44662,434688
9311,ep4sh,1,0.00023,88880,20.44685,434688
9312,eqvis,1,0.00023,88881,20.44708,434688
9313,eranelbaz,1,0.00023,88882,20.44731,434688
9314,eranshpiner,1,0.00023,88883,20.44754,434688
9315,EraYaN,1,0.00023,88884,20.44777,434688
9316,erdii,1,0.00023,88885,20.44800,434688
9317,erdnaxeli,1,0.00023,88886,20.44823,434688
9318,eregon,1,0.00023,88887,20.44846,434688
9319,erginacta,1,0.00023,88888,20.44869,434688
9320,erharb,1,0.00023,88889,20.44892,434688
9321,eric-aops,1,0.00023,88890,20.44915,434688
9322,erickbreness,1,0.00023,88891,20.44938,434688
9323,erickfaustino,1,0.00023,88892,20.44961,434688
9324,erikvanbrakel,1,0.00023,88893,20.44984,434688
9325,erir910,1,0.00023,88894,20.45007,434688
9326,ErmiasF,1,0.00023,88895,20.45030,434688
9327,ernani,1,0.00023,88896,20.45053,434688
9328,ernelio,1,0.00023,88897,20.45076,434688
9329,erni27,1,0.00023,88898,20.45099,434688
9330,ernie18a,1,0.00023,88899,20.45122,434688
9331,ersoyugur,1,0.00023,88900,20.45145,434688
9332,ervinb,1,0.00023,88901,20.45168,434688
9333,ErwanDL,1,0.00023,88902,20.45191,434688
9334,ESA-Security-Group,1,0.00023,88903,20.45214,434688
9335,espringsteen,1,0.00023,88904,20.45237,434688
9336,esrrhs,1,0.00023,88905,20.45260,434688
9337,esse,1,0.00023,88906,20.45283,434688
9338,estebanramos,1,0.00023,88907,20.45306,434688
9339,ethax-ross,1,0.00023,88908,20.45329,434688
9340,Etran-H,1,0.00023,88909,20.45352,434688
9341,eugenebnd,1,0.00023,88910,20.45375,434688
9342,eugene-chernyshenko,1,0.00023,88911,20.45398,434688
9343,EugeneLugovtsov,1,0.00023,88912,20.45421,434688
9344,eugene-marchanka,1,0.00023,88913,20.45444,434688
9345,eugene-riabchuk,1,0.00023,88914,20.45467,434688
9346,eugeniyost,1,0.00023,88915,20.45490,434688
9347,everflux,1,0.00023,88916,20.45513,434688
9348,EvertonSA,1,0.00023,88917,20.45536,434688
9349,EvgeniGordeev,1,0.00023,88918,20.45559,434688
9350,Evgenus,1,0.00023,88919,20.45582,434688
9351,evredinka,1,0.00023,88920,20.45605,434688
9352,excieve,1,0.00023,88921,20.45628,434688
9353,exenin,1,0.00023,88922,20.45651,434688
9354,exe-r,1,0.00023,88923,20.45674,434688
9355,exocode,1,0.00023,88924,20.45697,434688
9356,eyarz,1,0.00023,88925,20.45720,434688
9357,ey-bluecore,1,0.00023,88926,20.45743,434688
9358,eyJhb,1,0.00023,88927,20.45766,434688
9359,ezamriy,1,0.00023,88928,20.45789,434688
9360,ezbercih,1,0.00023,88929,20.45812,434688
9361,f1017746640,1,0.00023,88930,20.45835,434688
9362,F1ko,1,0.00023,88931,20.45858,434688
9363,f2130793,1,0.00023,88932,20.45881,434688
9364,f3d3Cz,1,0.00023,88933,20.45904,434688
9365,faabsen,1,0.00023,88934,20.45927,434688
9366,fabienmifsud,1,0.00023,88935,20.45950,434688
9367,fabiomdiniz,1,0.00023,88936,20.45973,434688
9368,fabiorauber,1,0.00023,88937,20.45996,434688
9369,fabiorosadev,1,0.00023,88938,20.46019,434688
9370,fabiosimeoni,1,0.00023,88939,20.46042,434688
9371,faceair,1,0.00023,88940,20.46065,434688
9372,fafg,1,0.00023,88941,20.46088,434688
9373,fagiani,1,0.00023,88942,20.46111,434688
9374,failytaler,1,0.00023,88943,20.46134,434688
9375,faisalrazzak,1,0.00023,88944,20.46157,434688
9376,faith2god,1,0.00023,88945,20.46180,434688
9377,falconbin,1,0.00023,88946,20.46203,434688
9378,fallenwood,1,0.00023,88947,20.46226,434688
9379,falun,1,0.00023,88948,20.46249,434688
9380,fanchuanster,1,0.00023,88949,20.46272,434688
9381,fanda2013,1,0.00023,88950,20.46295,434688
9382,fangsean,1,0.00023,88951,20.46318,434688
9383,fangzi0813,1,0.00023,88952,20.46341,434688
9384,fanlix,1,0.00023,88953,20.46364,434688
9385,fanshiqing,1,0.00023,88954,20.46387,434688
9386,fansi404,1,0.00023,88955,20.46410,434688
9387,farhaan-shamsee,1,0.00023,88956,20.46433,434688
9388,FarhanKhan-sains,1,0.00023,88957,20.46456,434688
9389,Farzad-Jalali,1,0.00023,88958,20.46479,434688
9390,fascinatedcow,1,0.00023,88959,20.46502,434688
9391,fast-and-the-curious,1,0.00023,88960,20.46525,434688
9392,fbozic,1,0.00023,88961,20.46548,434688
9393,Fchateauvert,1,0.00023,88962,20.46571,434688
9394,fdlg,1,0.00023,88963,20.46594,434688
9395,fearless11,1,0.00023,88964,20.46617,434688
9396,FedAnt,1,0.00023,88965,20.46640,434688
9397,fedeostrit,1,0.00023,88966,20.46663,434688
9398,federicobucchi,1,0.00023,88967,20.46686,434688
9399,feilengcui008,1,0.00023,88968,20.46709,434688
9400,felice64,1,0.00023,88969,20.46732,434688
9401,felipecwb,1,0.00023,88970,20.46755,434688
9402,felipess19,1,0.00023,88971,20.46778,434688
9403,felixmw,1,0.00023,88972,20.46801,434688
9404,FelixSFD,1,0.00023,88973,20.46824,434688
9405,felschr,1,0.00023,88974,20.46847,434688
9406,fengou1,1,0.00023,88975,20.46870,434688
9407,fengshenyun,1,0.00023,88976,20.46893,434688
9408,FengXingYuXin,1,0.00023,88977,20.46916,434688
9409,fengzhao,1,0.00023,88978,20.46939,434688
9410,ferdinandosimonetti,1,0.00023,88979,20.46962,434688
9411,Ferenc-,1,0.00023,88980,20.46985,434688
9412,fernandodeperto,1,0.00023,88981,20.47008,434688
9413,fernandonogueira,1,0.00023,88982,20.47031,434688
9414,Ferror,1,0.00023,88983,20.47054,434688
9415,fert-f,1,0.00023,88984,20.47077,434688
9416,fferrann,1,0.00023,88985,20.47100,434688
9417,fferraro87,1,0.00023,88986,20.47123,434688
9418,fgheysels,1,0.00023,88987,20.47146,434688
9419,fghso,1,0.00023,88988,20.47169,434688
9420,fgrelaud,1,0.00023,88989,20.47192,434688
9421,fhmlsml,1,0.00023,88990,20.47215,434688
9422,figroc,1,0.00023,88991,20.47238,434688
9423,fijimunkii,1,0.00023,88992,20.47261,434688
9424,fiksn,1,0.00023,88993,20.47284,434688
9425,filidorwiese,1,0.00023,88994,20.47307,434688
9426,filiphagan,1,0.00023,88995,20.47330,434688
9427,fimbulvetr,1,0.00023,88996,20.47354,434688
9428,Finfalter,1,0.00023,88997,20.47377,434688
9429,finnatsea,1,0.00023,88998,20.47400,434688
9430,finnickkim,1,0.00023,88999,20.47423,434688
9431,fire2,1,0.00023,89000,20.47446,434688
9432,fire833,1,0.00023,89001,20.47469,434688
9433,fireba11,1,0.00023,89002,20.47492,434688
9434,firebook,1,0.00023,89003,20.47515,434688
9435,FireEmerald,1,0.00023,89004,20.47538,434688
9436,fisabelle-lmi,1,0.00023,89005,20.47561,434688
9437,fish895623,1,0.00023,89006,20.47584,434688
9438,FishGoddess,1,0.00023,89007,20.47607,434688
9439,FixItDad,1,0.00023,89008,20.47630,434688
9440,fkmatsuda,1,0.00023,89009,20.47653,434688
9441,flamywhale,1,0.00023,89010,20.47676,434688
9442,Flauschbaellchen,1,0.00023,89011,20.47699,434688
9443,flcdrg,1,0.00023,89012,20.47722,434688
9444,flopex,1,0.00023,89013,20.47745,434688
9445,floppa,1,0.00023,89014,20.47768,434688
9446,florianhug,1,0.00023,89015,20.47791,434688
9447,florian-sattler,1,0.00023,89016,20.47814,434688
9448,Flpha0830,1,0.00023,89017,20.47837,434688
9449,flying-snail0630,1,0.00023,89018,20.47860,434688
9450,flyme2uh,1,0.00023,89019,20.47883,434688
9451,fnordic,1,0.00023,89020,20.47906,434688
9452,foamkeen,1,0.00023,89021,20.47929,434688
9453,fogerd,1,0.00023,89022,20.47952,434688
9454,folksgl,1,0.00023,89023,20.47975,434688
9455,foosinn,1,0.00023,89024,20.47998,434688
9456,Forbzy,1,0.00023,89025,20.48021,434688
9457,forcedroidbrain,1,0.00023,89026,20.48044,434688
9458,forcemagic,1,0.00023,89027,20.48067,434688
9459,foreverchens,1,0.00023,89028,20.48090,434688
9460,forresthopkinsa,1,0.00023,89029,20.48113,434688
9461,fouadsemaan,1,0.00023,89030,20.48136,434688
9462,FourTimes,1,0.00023,89031,20.48159,434688
9463,FPAX,1,0.00023,89032,20.48182,434688
9464,fpiesche,1,0.00023,89033,20.48205,434688
9465,Fr0zenBoy,1,0.00023,89034,20.48228,434688
9466,fragaLY,1,0.00023,89035,20.48251,434688
9467,fragfutter,1,0.00023,89036,20.48274,434688
9468,fragolinux,1,0.00023,89037,20.48297,434688
9469,Frame25,1,0.00023,89038,20.48320,434688
9470,frangauthiercgi,1,0.00023,89039,20.48343,434688
9471,FranGM,1,0.00023,89040,20.48366,434688
9472,frankcorneliusmartin,1,0.00023,89041,20.48389,434688
9473,franklbt,1,0.00023,89042,20.48412,434688
9474,franko22,1,0.00023,89043,20.48435,434688
9475,frankruizhi,1,0.00023,89044,20.48458,434688
9476,FrankWang1108,1,0.00023,89045,20.48481,434688
9477,FrankYang0529,1,0.00023,89046,20.48504,434688
9478,frans42,1,0.00023,89047,20.48527,434688
9479,FrantzT,1,0.00023,89048,20.48550,434688
9480,FraPazGal,1,0.00023,89049,20.48573,434688
9481,fredericpougnault,1,0.00023,89050,20.48596,434688
9482,frederiksf,1,0.00023,89051,20.48619,434688
9483,fredflev,1,0.00023,89052,20.48642,434688
9484,fredjeronimo,1,0.00023,89053,20.48665,434688
9485,FredNass,1,0.00023,89054,20.48688,434688
9486,fredsuvn,1,0.00023,89055,20.48711,434688
9487,freebased,1,0.00023,89056,20.48734,434688
9488,freefood89,1,0.00023,89057,20.48757,434688
9489,freegnu,1,0.00023,89058,20.48780,434688
9490,freeman,1,0.00023,89059,20.48803,434688
9491,Frenk8,1,0.00023,89060,20.48826,434688
9492,frenkye,1,0.00023,89061,20.48849,434688
9493,FridayRU,1,0.00023,89062,20.48872,434688
9494,fritzduchardt,1,0.00023,89063,20.48895,434688
9495,frog-network,1,0.00023,89064,20.48918,434688
9496,FroHenK,1,0.00023,89065,20.48941,434688
9497,frouzbeh,1,0.00023,89066,20.48964,434688
9498,frvge,1,0.00023,89067,20.48987,434688
9499,fsalazarh,1,0.00023,89068,20.49010,434688
9500,ftolosa,1,0.00023,89069,20.49033,434688
9501,fubai3,1,0.00023,89070,20.49056,434688
9502,fuerer,1,0.00023,89071,20.49079,434688
9503,ful09003,1,0.00023,89072,20.49102,434688
9504,furio,1,0.00023,89073,20.49125,434688
9505,FWinkler79,1,0.00023,89074,20.49148,434688
9506,fwt11,1,0.00023,89075,20.49171,434688
9507,fyzn12,1,0.00023,89076,20.49194,434688
9508,fzyzcjy,1,0.00023,89077,20.49217,434688
9509,g10f,1,0.00023,89078,20.49240,434688
9510,g3rhard,1,0.00023,89079,20.49263,434688
9511,g3rzi,1,0.00023,89080,20.49286,434688
9512,gabbueno,1,0.00023,89081,20.49309,434688
9513,gabece,1,0.00023,89082,20.49332,434688
9514,gabe-l-hart,1,0.00023,89083,20.49355,434688
9515,gabihodoroaga,1,0.00023,89084,20.49378,434688
9516,gabor,1,0.00023,89085,20.49401,434688
9517,gabrielcora20,1,0.00023,89086,20.49424,434688
9518,GabrielDyck,1,0.00023,89087,20.49447,434688
9519,gabrielhesposito,1,0.00023,89088,20.49470,434688
9520,gabrieljones,1,0.00023,89089,20.49493,434688
9521,gabrielSoudry,1,0.00023,89090,20.49516,434688
9522,gadinaor-r7,1,0.00023,89091,20.49539,434688
9523,gaelleacas,1,0.00023,89092,20.49562,434688
9524,gaetanrebufet,1,0.00023,89093,20.49585,434688
9525,gageffroy,1,0.00023,89094,20.49608,434688
9526,gagipro,1,0.00023,89095,20.49631,434688
9527,gai6948,1,0.00023,89096,20.49654,434688
9528,gainskills,1,0.00023,89097,20.49677,434688
9529,Gainutdinov,1,0.00023,89098,20.49700,434688
9530,Galaxy0106,1,0.00023,89099,20.49723,434688
9531,galdor,1,0.00023,89100,20.49746,434688
9532,galemccommons,1,0.00023,89101,20.49769,434688
9533,ganga-sah,1,0.00023,89102,20.49792,434688
9534,gangyi89,1,0.00023,89103,20.49815,434688
9535,ganidhavid,1,0.00023,89104,20.49838,434688
9536,GaoJiasheng,1,0.00023,89105,20.49861,434688
9537,gaoxinge,1,0.00023,89106,20.49884,434688
9538,garantir-km,1,0.00023,89107,20.49907,434688
9539,gareth-liu276,1,0.00023,89108,20.49930,434688
9540,garimakhulbe02,1,0.00023,89109,20.49953,434688
9541,garretcoffman,1,0.00023,89110,20.49976,434688
9542,garygan89,1,0.00023,89111,20.49999,434688
9543,gasperlf,1,0.00023,89112,20.50022,434688
9544,GaTechThomas,1,0.00023,89113,20.50045,434688
9545,Gatsby-Lee,1,0.00023,89114,20.50068,434688
9546,gaubej,1,0.00023,89115,20.50091,434688
9547,Gaurang-Patel,1,0.00023,89116,20.50114,434688
9548,gaurav517,1,0.00023,89117,20.50137,434688
9549,gauravrao08,1,0.00023,89118,20.50160,434688
9550,gauravtaank,1,0.00023,89119,20.50183,434688
9551,gautamnaha,1,0.00023,89120,20.50206,434688
9552,gavahi,1,0.00023,89121,20.50229,434688
9553,Gavin-github-user,1,0.00023,89122,20.50252,434688
9554,gavinvangent,1,0.00023,89123,20.50275,434688
9555,gawmanarnar,1,0.00023,89124,20.50298,434688
9556,gbarceloPIB,1,0.00023,89125,20.50321,434688
9557,gbarker,1,0.00023,89126,20.50344,434688
9558,gburek-fastly,1,0.00023,89127,20.50367,434688
9559,gca3020,1,0.00023,89128,20.50390,434688
9560,gcblana,1,0.00023,89129,20.50413,434688
9561,gchappell99,1,0.00023,89130,20.50436,434688
9562,gc-ss,1,0.00023,89131,20.50459,434688
9563,gedlu,1,0.00023,89132,20.50482,434688
9564,geek,1,0.00023,89133,20.50505,434688
9565,geekbass,1,0.00023,89134,20.50528,434688
9566,geertjanw,1,0.00023,89135,20.50551,434688
9567,geetasg,1,0.00023,89136,20.50574,434688
9568,gemagomez,1,0.00023,89137,20.50597,434688
9569,General-Abdul-HBO,1,0.00023,89138,20.50620,434688
9570,GeneralFox,1,0.00023,89139,20.50643,434688
9571,genesi5,1,0.00023,89140,20.50666,434688
9572,geoberle,1,0.00023,89141,20.50689,434688
9573,geodro,1,0.00023,89142,20.50712,434688
9574,geofffranks,1,0.00023,89143,20.50735,434688
9575,geoffrey-pascal,1,0.00023,89144,20.50758,434688
9576,Geoffrotism,1,0.00023,89145,20.50781,434688
9577,georgantasp,1,0.00023,89146,20.50804,434688
9578,george-oakling,1,0.00023,89147,20.50827,434688
9579,georgeps21,1,0.00023,89148,20.50850,434688
9580,GeorgeTsilias,1,0.00023,89149,20.50873,434688
9581,georg-pp,1,0.00023,89150,20.50896,434688
9582,georgyo,1,0.00023,89151,20.50919,434688
9583,gergas3,1,0.00023,89152,20.50942,434688
9584,GerrySeidman,1,0.00023,89153,20.50965,434688
9585,getachew,1,0.00023,89154,20.50988,434688
9586,getong,1,0.00023,89155,20.51011,434688
9587,Gevorgisk,1,0.00023,89156,20.51034,434688
9588,gfrankel97,1,0.00023,89157,20.51057,434688
9589,ggilley,1,0.00023,89158,20.51080,434688
9590,ggjjlldd,1,0.00023,89159,20.51103,434688
9591,ggregoire,1,0.00023,89160,20.51126,434688
9592,ghb-1234,1,0.00023,89161,20.51149,434688
9593,Ghitor,1,0.00023,89162,20.51172,434688
9594,ghorofamike,1,0.00023,89163,20.51195,434688
9595,GhostInThePotato,1,0.00023,89164,20.51218,434688
9596,giantcroc,1,0.00023,89165,20.51241,434688
9597,gilgameshfreedom,1,0.00023,89166,20.51264,434688
9598,Gilwe,1,0.00023,89167,20.51287,434688
9599,GinoPane,1,0.00023,89168,20.51310,434688
9600,giondo,1,0.00023,89169,20.51333,434688
9601,giordyb,1,0.00023,89170,20.51356,434688
9602,girindrag,1,0.00023,89171,20.51379,434688
9603,girish332,1,0.00023,89172,20.51402,434688
9604,girishgrover2008,1,0.00023,89173,20.51425,434688
9605,git-dolia,1,0.00023,89174,20.51448,434688
9606,github-brice-jaglin,1,0.00023,89175,20.51471,434688
9607,githubcdr,1,0.00023,89176,20.51494,434688
9608,GitHubFor122,1,0.00023,89177,20.51517,434688
9609,githubixx,1,0.00023,89178,20.51540,434688
9610,githublaohu,1,0.00023,89179,20.51563,434688
9611,gitrojones,1,0.00023,89180,20.51586,434688
9612,giuseppecampanelli,1,0.00023,89181,20.51609,434688
9613,GiviMAD,1,0.00023,89182,20.51632,434688
9614,givip,1,0.00023,89183,20.51655,434688
9615,gjacobsatl,1,0.00023,89184,20.51678,434688
9616,gkapkowski,1,0.00023,89185,20.51701,434688
9617,gkgaurav31,1,0.00023,89186,20.51724,434688
9618,Gkolman,1,0.00023,89187,20.51747,434688
9619,gkope,1,0.00023,89188,20.51770,434688
9620,gldraphael,1,0.00023,89189,20.51793,434688
9621,GlebIgnatevEmlid,1,0.00023,89190,20.51816,434688
9622,gleichda,1,0.00023,89191,20.51839,434688
9623,gleyfer,1,0.00023,89192,20.51862,434688
9624,gliderkite,1,0.00023,89193,20.51885,434688
9625,gmiejski,1,0.00023,89194,20.51908,434688
9626,gmintoco,1,0.00023,89195,20.51932,434688
9627,gmorse81,1,0.00023,89196,20.51955,434688
9628,gnagel,1,0.00023,89197,20.51978,434688
9629,gnalsa,1,0.00023,89198,20.52001,434688
9630,godchen0212,1,0.00023,89199,20.52024,434688
9631,gogogwwb,1,0.00023,89200,20.52047,434688
9632,gohmc,1,0.00023,89201,20.52070,434688
9633,goku321,1,0.00023,89202,20.52093,434688
9634,Goldselleruk,1,0.00023,89203,20.52116,434688
9635,gomi-service,1,0.00023,89204,20.52139,434688
9636,g-ongenae,1,0.00023,89205,20.52162,434688
9637,goooogs,1,0.00023,89206,20.52185,434688
9638,gopaljayanthi,1,0.00023,89207,20.52208,434688
9639,goshansp,1,0.00023,89208,20.52231,434688
9640,gothrek22,1,0.00023,89209,20.52254,434688
9641,gouchaoer,1,0.00023,89210,20.52277,434688
9642,GounGG,1,0.00023,89211,20.52300,434688
9643,gouravmohanty7070,1,0.00023,89212,20.52323,434688
9644,govargo,1,0.00023,89213,20.52346,434688
9645,gowthams316,1,0.00023,89214,20.52369,434688
9646,gpareraavoristravelio,1,0.00023,89215,20.52392,434688
9647,gpavinteractiv,1,0.00023,89216,20.52415,434688
9648,GrandChaman,1,0.00023,89217,20.52438,434688
9649,grandich,1,0.00023,89218,20.52461,434688
9650,graqfreak,1,0.00023,89219,20.52484,434688
9651,gravypod,1,0.00023,89220,20.52507,434688
9652,grawin,1,0.00023,89221,20.52530,434688
9653,graysonrtaylor,1,0.00023,89222,20.52553,434688
9654,Gre8t,1,0.00023,89223,20.52576,434688
9655,greg-caffeine,1,0.00023,89224,20.52599,434688
9656,greglanthier,1,0.00023,89225,20.52622,434688
9657,gregorso,1,0.00023,89226,20.52645,434688
9658,gregoryfranklin,1,0.00023,89227,20.52668,434688
9659,GregoryVds,1,0.00023,89228,20.52691,434688
9660,gregstoll,1,0.00023,89229,20.52714,434688
9661,gregswift,1,0.00023,89230,20.52737,434688
9662,GregWasHere,1,0.00023,89231,20.52760,434688
9663,gresockj,1,0.00023,89232,20.52783,434688
9664,groeges,1,0.00023,89233,20.52806,434688
9665,grosren,1,0.00023,89234,20.52829,434688
9666,Grrui,1,0.00023,89235,20.52852,434688
9667,GrumpyRainbow,1,0.00023,89236,20.52875,434688
9668,grzesrap,1,0.00023,89237,20.52898,434688
9669,gsaraf,1,0.00023,89238,20.52921,434688
9670,gschier,1,0.00023,89239,20.52944,434688
9671,G-Shriya,1,0.00023,89240,20.52967,434688
9672,gssjl2008,1,0.00023,89241,20.52990,434688
9673,gstaware,1,0.00023,89242,20.53013,434688
9674,gsvachulay01,1,0.00023,89243,20.53036,434688
9675,gtfortytwo,1,0.00023,89244,20.53059,434688
9676,gtmanfred,1,0.00023,89245,20.53082,434688
9677,Guanyan1996,1,0.00023,89246,20.53105,434688
9678,gucci,1,0.00023,89247,20.53128,434688
9679,guedes84,1,0.00023,89248,20.53151,434688
9680,GUESSO,1,0.00023,89249,20.53174,434688
9681,guillaumeger,1,0.00023,89250,20.53197,434688
9682,guillaumelfv,1,0.00023,89251,20.53220,434688
9683,Guillaume-Mayer,1,0.00023,89252,20.53243,434688
9684,GuillaumeWaignier,1,0.00023,89253,20.53266,434688
9685,guillemj,1,0.00023,89254,20.53289,434688
9686,guillenotfound,1,0.00023,89255,20.53312,434688
9687,guleng,1,0.00023,89256,20.53335,434688
9688,GuobingLiu,1,0.00023,89257,20.53358,434688
9689,guodongli-google,1,0.00023,89258,20.53381,434688
9690,guojing013214,1,0.00023,89259,20.53404,434688
9691,guongle-ssense,1,0.00023,89260,20.53427,434688
9692,guqiu369,1,0.00023,89261,20.53450,434688
9693,guraslan,1,0.00023,89262,20.53473,434688
9694,guruabsa,1,0.00023,89263,20.53496,434688
9695,GustavoAdrianGimenez,1,0.00023,89264,20.53519,434688
9696,gustavoortega,1,0.00023,89265,20.53542,434688
9697,guumaster,1,0.00023,89266,20.53565,434688
9698,guykanyvision,1,0.00023,89267,20.53588,434688
9699,GuyLewin,1,0.00023,89268,20.53611,434688
9700,guy-lud,1,0.00023,89269,20.53634,434688
9701,guy-microsoft,1,0.00023,89270,20.53657,434688
9702,guyromb,1,0.00023,89271,20.53680,434688
9703,guzongmin,1,0.00023,89272,20.53703,434688
9704,gwuah,1,0.00023,89273,20.53726,434688
9705,gwvandesteeg,1,0.00023,89274,20.53749,434688
9706,gyakovlev,1,0.00023,89275,20.53772,434688
9707,gyoza,1,0.00023,89276,20.53795,434688
9708,Gyuh,1,0.00023,89277,20.53818,434688
9709,Gzylzy,1,0.00023,89278,20.53841,434688
9710,haagenson,1,0.00023,89279,20.53864,434688
9711,habmic,1,0.00023,89280,20.53887,434688
9712,HackZZ,1,0.00023,89281,20.53910,434688
9713,hadimansuri,1,0.00023,89282,20.53933,434688
9714,hahewlet,1,0.00023,89283,20.53956,434688
9715,haho16,1,0.00023,89284,20.53979,434688
9716,hak33m16,1,0.00023,89285,20.54002,434688
9717,hakanqq66,1,0.00023,89286,20.54025,434688
9718,hakashya,1,0.00023,89287,20.54048,434688
9719,hakuna-matatah,1,0.00023,89288,20.54071,434688
9720,halayli,1,0.00023,89289,20.54094,434688
9721,hamidrezash2000,1,0.00023,89290,20.54117,434688
9722,hammadzz,1,0.00023,89291,20.54140,434688
9723,HammerMeetNail,1,0.00023,89292,20.54163,434688
9724,Hammond95,1,0.00023,89293,20.54186,434688
9725,hamzaabi,1,0.00023,89294,20.54209,434688
9726,hanaper,1,0.00023,89295,20.54232,434688
9727,hangzhouwanjun,1,0.00023,89296,20.54255,434688
9728,hanhyalex,1,0.00023,89297,20.54278,434688
9729,hanjh0814,1,0.00023,89298,20.54301,434688
9730,HannanSolo,1,0.00023,89299,20.54324,434688
9731,hansdcr,1,0.00023,89300,20.54347,434688
9732,hansh1029,1,0.00023,89301,20.54370,434688
9733,hanzala1234,1,0.00023,89302,20.54393,434688
9734,hanzZzZzZ,1,0.00023,89303,20.54416,434688
9735,haohello,1,0.00023,89304,20.54439,434688
9736,HaoKunT,1,0.00023,89305,20.54462,434688
9737,happy15,1,0.00023,89306,20.54485,434688
9738,haraldatbmw,1,0.00023,89307,20.54508,434688
9739,HaraldGustafsson,1,0.00023,89308,20.54531,434688
9740,haraldng,1,0.00023,89309,20.54554,434688
9741,hardik-fareye,1,0.00023,89310,20.54577,434688
9742,hardis2003,1,0.00023,89311,20.54600,434688
9743,HardNorth,1,0.00023,89312,20.54623,434688
9744,HarikrishnanBalagopal,1,0.00023,89313,20.54646,434688
9745,harindaka,1,0.00023,89314,20.54669,434688
9746,harinder-jabal,1,0.00023,89315,20.54692,434688
9747,harishkumarbalaji,1,0.00023,89316,20.54715,434688
9748,harishmurali-hub,1,0.00023,89317,20.54738,434688
9749,hari-uc,1,0.00023,89318,20.54761,434688
9750,Harmelodic,1,0.00023,89319,20.54784,434688
9751,harold-kfuse,1,0.00023,89320,20.54807,434688
9752,harry671003,1,0.00023,89321,20.54830,434688
9753,harry-xiaomi,1,0.00023,89322,20.54853,434688
9754,harryyann,1,0.00023,89323,20.54876,434688
9755,harshakondreddy,1,0.00023,89324,20.54899,434688
9756,harshaperera532,1,0.00023,89325,20.54922,434688
9757,hasanghasemi,1,0.00023,89326,20.54945,434688
9758,hasanhaja,1,0.00023,89327,20.54968,434688
9759,hashimyousaf1,1,0.00023,89328,20.54991,434688
9760,hastarin,1,0.00023,89329,20.55014,434688
9761,Hatho86,1,0.00023,89330,20.55037,434688
9762,Haybu,1,0.00023,89331,20.55060,434688
9763,hayhay27,1,0.00023,89332,20.55083,434688
9764,Hazhir007,1,0.00023,89333,20.55106,434688
9765,hbahadorzadeh,1,0.00023,89334,20.55129,434688
9766,HcgRandon,1,0.00023,89335,20.55152,434688
9767,hchenc,1,0.00023,89336,20.55175,434688
9768,hds,1,0.00023,89337,20.55198,434688
9769,headkm,1,0.00023,89338,20.55221,434688
9770,heangratha,1,0.00023,89339,20.55244,434688
9771,hectoralicea,1,0.00023,89340,20.55267,434688
9772,HecvStyle,1,0.00023,89341,20.55290,434688
9773,heerajoshi,1,0.00023,89342,20.55313,434688
9774,heftig,1,0.00023,89343,20.55336,434688
9775,heilerich,1,0.00023,89344,20.55359,434688
9776,heipark,1,0.00023,89345,20.55382,434688
9777,heitorPB,1,0.00023,89346,20.55405,434688
9778,helldweller,1,0.00023,89347,20.55428,434688
9779,hellocloudnative,1,0.00023,89348,20.55451,434688
9780,hellokarthik,1,0.00023,89349,20.55474,434688
9781,HEllRZA,1,0.00023,89350,20.55497,434688
9782,HelperInCa,1,0.00023,89351,20.55520,434688
9783,helpmeplsssss,1,0.00023,89352,20.55543,434688
9784,hemandee,1,0.00023,89353,20.55566,434688
9785,HemanthAditi,1,0.00023,89354,20.55589,434688
9786,HemantNegi,1,0.00023,89355,20.55612,434688
9787,henrik-m,1,0.00023,89356,20.55635,434688
9788,HenrryVargas,1,0.00023,89357,20.55658,434688
9789,HenryChou90,1,0.00023,89358,20.55681,434688
9790,HenryFBP,1,0.00023,89359,20.55704,434688
9791,here4thee,1,0.00023,89360,20.55727,434688
9792,heruv1m,1,0.00023,89361,20.55750,434688
9793,hevemula,1,0.00023,89362,20.55773,434688
9794,heysujal,1,0.00023,89363,20.55796,434688
9795,hfczgo,1,0.00023,89364,20.55819,434688
9796,HGladiator,1,0.00023,89365,20.55842,434688
9797,hh186011,1,0.00023,89366,20.55865,434688
9798,hhamalai,1,0.00023,89367,20.55888,434688
9799,hhorak,1,0.00023,89368,20.55911,434688
9800,hi-artem,1,0.00023,89369,20.55934,434688
9801,hieu29791,1,0.00023,89370,20.55957,434688
9802,hieuhuynhdev,1,0.00023,89371,20.55980,434688
9803,hieunc278,1,0.00023,89372,20.56003,434688
9804,hihellobolke,1,0.00023,89373,20.56026,434688
9805,hilloaLoa,1,0.00023,89374,20.56049,434688
9806,Himani-Raina,1,0.00023,89375,20.56072,434688
9807,Himani-relan,1,0.00023,89376,20.56095,434688
9808,himankvishwakarma,1,0.00023,89377,20.56118,434688
9809,himanshutiwariji,1,0.00023,89378,20.56141,434688
9810,hippyaki,1,0.00023,89379,20.56164,434688
9811,hirannair,1,0.00023,89380,20.56187,434688
9812,hirenoble,1,0.00023,89381,20.56210,434688
9813,hirenvadalia,1,0.00023,89382,20.56233,434688
9814,Hisyamkamil,1,0.00023,89383,20.56256,434688
9815,hi-usui,1,0.00023,89384,20.56279,434688
9816,hiveliberty,1,0.00023,89385,20.56302,434688
9817,hlesesne,1,0.00023,89386,20.56325,434688
9818,hmrg-grmh,1,0.00023,89387,20.56348,434688
9819,hnasr,1,0.00023,89388,20.56371,434688
9820,hoangdh,1,0.00023,89389,20.56394,434688
9821,hoanhan101,1,0.00023,89390,20.56417,434688
9822,hobbes1069,1,0.00023,89391,20.56440,434688
9823,hobyte,1,0.00023,89392,20.56463,434688
9824,hocgin,1,0.00023,89393,20.56486,434688
9825,hoeg,1,0.00023,89394,20.56509,434688
9826,hoffie,1,0.00023,89395,20.56533,434688
9827,hoffmanr-cshs,1,0.00023,89396,20.56556,434688
9828,hokadiri,1,0.00023,89397,20.56579,434688
9829,hokiegeek2,1,0.00023,89398,20.56602,434688
9830,holgermetschulat,1,0.00023,89399,20.56625,434688
9831,holleyism,1,0.00023,89400,20.56648,434688
9832,hollowsunsets,1,0.00023,89401,20.56671,434688
9833,holmes1412,1,0.00023,89402,20.56694,434688
9834,honghaiw,1,0.00023,89403,20.56717,434688
9835,honghan94,1,0.00023,89404,20.56740,434688
9836,hongliang5316,1,0.00023,89405,20.56763,434688
9837,HongliBu,1,0.00023,89406,20.56786,434688
9838,HoodieHo,1,0.00023,89407,20.56809,434688
9839,hopik007,1,0.00023,89408,20.56832,434688
9840,houfangdong,1,0.00023,89409,20.56855,434688
9841,houshym,1,0.00023,89410,20.56878,434688
9842,hpdobrica,1,0.00023,89411,20.56901,434688
9843,HQ1363,1,0.00023,89412,20.56924,434688
9844,hrodic,1,0.00023,89413,20.56947,434688
9845,hrpatel,1,0.00023,89414,20.56970,434688
9846,hrzbrg,1,0.00023,89415,20.56993,434688
9847,hs02041102,1,0.00023,89416,20.57016,434688
9848,hshabbar,1,0.00023,89417,20.57039,434688
9849,hsharma96,1,0.00023,89418,20.57062,434688
9850,hstamminger,1,0.00023,89419,20.57085,434688
9851,hty690,1,0.00023,89420,20.57108,434688
9852,huadufusu,1,0.00023,89421,20.57131,434688
9853,huang12zheng,1,0.00023,89422,20.57154,434688
9854,huangxan,1,0.00023,89423,20.57177,434688
9855,huangxinrui,1,0.00023,89424,20.57200,434688
9856,huangyong1991,1,0.00023,89425,20.57223,434688
9857,HuanLiu-hotstar,1,0.00023,89426,20.57246,434688
9858,hubwoop,1,0.00023,89427,20.57269,434688
9859,huchunxu,1,0.00023,89428,20.57292,434688
9860,hudec,1,0.00023,89429,20.57315,434688
9861,hudson741,1,0.00023,89430,20.57338,434688
9862,huehnerlady,1,0.00023,89431,20.57361,434688
9863,hugo345816,1,0.00023,89432,20.57384,434688
9864,hugtale,1,0.00023,89433,20.57407,434688
9865,hulquest,1,0.00023,89434,20.57430,434688
9866,HumairAK,1,0.00023,89435,20.57453,434688
9867,hungpv-2039,1,0.00023,89436,20.57476,434688
9868,hunterhug,1,0.00023,89437,20.57499,434688
9869,hupling,1,0.00023,89438,20.57522,434688
9870,hush-hush,1,0.00023,89439,20.57545,434688
9871,Huskehhh,1,0.00023,89440,20.57568,434688
9872,hustlzp1981,1,0.00023,89441,20.57591,434688
9873,husunal,1,0.00023,89442,20.57614,434688
9874,huxulm,1,0.00023,89443,20.57637,434688
9875,huyifeng0522,1,0.00023,89444,20.57660,434688
9876,huynqtiki,1,0.00023,89445,20.57683,434688
9877,huzefa51,1,0.00023,89446,20.57706,434688
9878,hvitoi,1,0.00023,89447,20.57729,434688
9879,hw4liu,1,0.00023,89448,20.57752,434688
9880,hwkim94,1,0.00023,89449,20.57775,434688
9881,hxjr,1,0.00023,89450,20.57798,434688
9882,hy0619,1,0.00023,89451,20.57821,434688
9883,hypc,1,0.00023,89452,20.57844,434688
9884,hypervtechnics,1,0.00023,89453,20.57867,434688
9885,hywook4,1,0.00023,89454,20.57890,434688
9886,i1337m,1,0.00023,89455,20.57913,434688
9887,iaditya0375,1,0.00023,89456,20.57936,434688
9888,iamatsundere,1,0.00023,89457,20.57959,434688
9889,iamdevelopergirl,1,0.00023,89458,20.57982,434688
9890,iamlucaswolf,1,0.00023,89459,20.58005,434688
9891,iamzhoug37,1,0.00023,89460,20.58028,434688
9892,iapain,1,0.00023,89461,20.58051,434688
9893,iapicca,1,0.00023,89462,20.58074,434688
9894,i-Apoorva,1,0.00023,89463,20.58097,434688
9895,ibata,1,0.00023,89464,20.58120,434688
9896,ibauersachs,1,0.00023,89465,20.58143,434688
9897,Ibrahim-Akk,1,0.00023,89466,20.58166,434688
9898,icamys,1,0.00023,89467,20.58189,434688
9899,icf-schubes,1,0.00023,89468,20.58212,434688
9900,ichadhr,1,0.00023,89469,20.58235,434688
9901,ichbinblau,1,0.00023,89470,20.58258,434688
9902,Id2ndR,1,0.00023,89471,20.58281,434688
9903,idlezombie,1,0.00023,89472,20.58304,434688
9904,Ido-Itz,1,0.00023,89473,20.58327,434688
9905,idonca,1,0.00023,89474,20.58350,434688
9906,ievgen-kapinos,1,0.00023,89475,20.58373,434688
9907,ifelseend,1,0.00023,89476,20.58396,434688
9908,ig0rsky,1,0.00023,89477,20.58419,434688
9909,igbanam,1,0.00023,89478,20.58442,434688
9910,Igetin,1,0.00023,89479,20.58465,434688
9911,igorbrigadir,1,0.00023,89480,20.58488,434688
9912,IgorGee,1,0.00023,89481,20.58511,434688
9913,igorGevaerd,1,0.00023,89482,20.58534,434688
9914,igormishsky,1,0.00023,89483,20.58557,434688
9915,igozali,1,0.00023,89484,20.58580,434688
9916,igrowheart,1,0.00023,89485,20.58603,434688
9917,ihalloum,1,0.00023,89486,20.58626,434688
9918,Ihjaz,1,0.00023,89487,20.58649,434688
9919,ikarlashov,1,0.00023,89488,20.58672,434688
9920,ikhoon,1,0.00023,89489,20.58695,434688
9921,ikirker,1,0.00023,89490,20.58718,434688
9922,ikroumov,1,0.00023,89491,20.58741,434688
9923,ila-001,1,0.00023,89492,20.58764,434688
9924,ilanitr,1,0.00023,89493,20.58787,434688
9925,ilhom0258,1,0.00023,89494,20.58810,434688
9926,illrill,1,0.00023,89495,20.58833,434688
9927,ilmanzo,1,0.00023,89496,20.58856,434688
9928,IlonkaO,1,0.00023,89497,20.58879,434688
9929,imbrou,1,0.00023,89498,20.58902,434688
9930,ImMukulTaneja,1,0.00023,89499,20.58925,434688
9931,imnetworku,1,0.00023,89500,20.58948,434688
9932,ImNM,1,0.00023,89501,20.58971,434688
9933,impos,1,0.00023,89502,20.58994,434688
9934,imran9m,1,0.00023,89503,20.59017,434688
9935,imtiazpk,1,0.00023,89504,20.59040,434688
9936,in4mer,1,0.00023,89505,20.59063,434688
9937,inajob,1,0.00023,89506,20.59086,434688
9938,inanib,1,0.00023,89507,20.59109,434688
9939,InAnimaTe,1,0.00023,89508,20.59132,434688
9940,incubateurpe,1,0.00023,89509,20.59155,434688
9941,indiketa,1,0.00023,89510,20.59178,434688
9942,indrajithgihan,1,0.00023,89511,20.59201,434688
9943,indreek,1,0.00023,89512,20.59224,434688
9944,indrora,1,0.00023,89513,20.59247,434688
9945,infakt-HNP,1,0.00023,89514,20.59270,434688
9946,infogulch,1,0.00023,89515,20.59293,434688
9947,inforzip,1,0.00023,89516,20.59316,434688
9948,ingomueller-net,1,0.00023,89517,20.59339,434688
9949,in-linux,1,0.00023,89518,20.59362,434688
9950,insanemal,1,0.00023,89519,20.59385,434688
9951,Insvald,1,0.00023,89520,20.59408,434688
9952,internet-diglett,1,0.00023,89521,20.59431,434688
9953,intfrr,1,0.00023,89522,20.59454,434688
9954,invzhi,1,0.00023,89523,20.59477,434688
9955,ioanc,1,0.00023,89524,20.59500,434688
9956,iofirag,1,0.00023,89525,20.59523,434688
9957,IonatanMocan,1,0.00023,89526,20.59546,434688
9958,ionutleca,1,0.00023,89527,20.59569,434688
9959,iowillhoit,1,0.00023,89528,20.59592,434688
9960,ipapast,1,0.00023,89529,20.59615,434688
9961,Ipicky22,1,0.00023,89530,20.59638,434688
9962,ipyker,1,0.00023,89531,20.59661,434688
9963,iron-rain,1,0.00023,89532,20.59684,434688
9964,Irrational-NX,1,0.00023,89533,20.59707,434688
9965,isaac-patterson,1,0.00023,89534,20.59730,434688
9966,isaevdan,1,0.00023,89535,20.59753,434688
9967,isakkarin,1,0.00023,89536,20.59776,434688
9968,isavl,1,0.00023,89537,20.59799,434688
9969,isax5,1,0.00023,89538,20.59822,434688
9970,isc30,1,0.00023,89539,20.59845,434688
9971,ishan16696,1,0.00023,89540,20.59868,434688
9972,ishika261,1,0.00023,89541,20.59891,434688
9973,ismarslomic,1,0.00023,89542,20.59914,434688
9974,isogram,1,0.00023,89543,20.59937,434688
9975,ItalyPaleAle,1,0.00023,89544,20.59960,434688
9976,itamarkam,1,0.00023,89545,20.59983,434688
9977,itayronen,1,0.00023,89546,20.60006,434688
9978,itdoginfo,1,0.00023,89547,20.60029,434688
9979,itinneed,1,0.00023,89548,20.60052,434688
9980,itziklavon,1,0.00023,89549,20.60075,434688
9981,IuryAlves,1,0.00023,89550,20.60098,434688
9982,ivailopankow,1,0.00023,89551,20.60121,434688
9983,ivan046,1,0.00023,89552,20.60144,434688
9984,ivanbenko,1,0.00023,89553,20.60167,434688
9985,ivangrynkoring,1,0.00023,89554,20.60190,434688
9986,ivanpang-crypto,1,0.00023,89555,20.60213,434688
9987,ivanvtimofeev,1,0.00023,89556,20.60236,434688
9988,ivoanjo,1,0.00023,89557,20.60259,434688
9989,iwishiwasaneagle,1,0.00023,89558,20.60282,434688
9990,iwita,1,0.00023,89559,20.60305,434688
9991,iyenigul,1,0.00023,89560,20.60328,434688
9992,izenk,1,0.00023,89561,20.60351,434688
9993,Izvi,1,0.00023,89562,20.60374,434688
9994,j13tw,1,0.00023,89563,20.60397,434688
9995,j2udevelopment,1,0.00023,89564,20.60420,434688
9996,j4m3s-s,1,0.00023,89565,20.60443,434688
9997,jacek-idzik,1,0.00023,89566,20.60466,434688
9998,jacetyh,1,0.00023,89567,20.60489,434688
9999,jachou,1,0.00023,89568,20.60512,434688
10000,jackdpeterson,1,0.00023,89569,20.60535,434688
10001,jacklund,1,0.00023,89570,20.60558,434688
10002,jackmcguire1,1,0.00023,89571,20.60581,434688
10003,JackPott,1,0.00023,89572,20.60604,434688
10004,Jackson-soft,1,0.00023,89573,20.60627,434688
10005,jacobbeasley,1,0.00023,89574,20.60650,434688
10006,JacobCarrell,1,0.00023,89575,20.60673,434688
10007,jacob-hudson,1,0.00023,89576,20.60696,434688
10008,jacobstr,1,0.00023,89577,20.60719,434688
10009,JacobX33,1,0.00023,89578,20.60742,434688
10010,jadeapplegate,1,0.00023,89579,20.60765,434688
10011,jadedevin13,1,0.00023,89580,20.60788,434688
10012,jadedfire,1,0.00023,89581,20.60811,434688
10013,jagan-source,1,0.00023,89582,20.60834,434688
10014,jaggerwang,1,0.00023,89583,20.60857,434688
10015,jainilparikh,1,0.00023,89584,20.60880,434688
10016,jaisegrg,1,0.00023,89585,20.60903,434688
10017,JakeCooper,1,0.00023,89586,20.60926,434688
10018,jakestambaugh,1,0.00023,89587,20.60949,434688
10019,jaklan,1,0.00023,89588,20.60972,434688
10020,Jakob3xD,1,0.00023,89589,20.60995,434688
10021,jakubbaron,1,0.00023,89590,20.61018,434688
10022,jakub-koban,1,0.00023,89591,20.61041,434688
10023,jalagari,1,0.00023,89592,20.61064,434688
10024,JamesBalazs,1,0.00023,89593,20.61087,434688
10025,james-ct,1,0.00023,89594,20.61110,434688
10026,jamesdboone,1,0.00023,89595,20.61134,434688
10027,jamesdehart,1,0.00023,89596,20.61157,434688
10028,james-d-elliott,1,0.00023,89597,20.61180,434688
10029,JamesGallant,1,0.00023,89598,20.61203,434688
10030,jameslin0312,1,0.00023,89599,20.61226,434688
10031,jamesmbourne,1,0.00023,89600,20.61249,434688
10032,james-mchugh,1,0.00023,89601,20.61272,434688
10033,james-pollard-leapyear,1,0.00023,89602,20.61295,434688
10034,jamesSampica,1,0.00023,89603,20.61318,434688
10035,jamestutton,1,0.00023,89604,20.61341,434688
10036,JAMH-CBB,1,0.00023,89605,20.61364,434688
10037,jamietanna,1,0.00023,89606,20.61387,434688
10038,jamietdavidson,1,0.00023,89607,20.61410,434688
10039,jamoflaw,1,0.00023,89608,20.61433,434688
10040,jandalpetr,1,0.00023,89609,20.61456,434688
10041,janecekt,1,0.00023,89610,20.61479,434688
10042,jan-hudec,1,0.00023,89611,20.61502,434688
10043,jankosecki,1,0.00023,89612,20.61525,434688
10044,jantekb,1,0.00023,89613,20.61548,434688
10045,Janukriti,1,0.00023,89614,20.61571,434688
10046,jar3b,1,0.00023,89615,20.61594,434688
10047,jarduini,1,0.00023,89616,20.61617,434688
10048,jared-maguire,1,0.00023,89617,20.61640,434688
10049,JarHMJ,1,0.00023,89618,20.61663,434688
10050,JarnoRFB,1,0.00023,89619,20.61686,434688
10051,jarobar435,1,0.00023,89620,20.61709,434688
10052,jarojasm95,1,0.00023,89621,20.61732,434688
10053,jaronnie,1,0.00023,89622,20.61755,434688
10054,jasonchrion,1,0.00023,89623,20.61778,434688
10055,jason-edstrom,1,0.00023,89624,20.61801,434688
10056,jasonhadi,1,0.00023,89625,20.61824,434688
10057,jasons42,1,0.00023,89626,20.61847,434688
10058,jasper-bk,1,0.00023,89627,20.61870,434688
10059,jasper-zhang,1,0.00023,89628,20.61893,434688
10060,javid-dastgoshadeh,1,0.00023,89629,20.61916,434688
10061,javiermmenendez,1,0.00023,89630,20.61939,434688
10062,javiersvg,1,0.00023,89631,20.61962,434688
10063,jax79sg,1,0.00023,89632,20.61985,434688
10064,jaxzon,1,0.00023,89633,20.62008,434688
10065,jayaraj-selvaraj,1,0.00023,89634,20.62031,434688
10066,Jayaram059,1,0.00023,89635,20.62054,434688
10067,jayasg12,1,0.00023,89636,20.62077,434688
10068,jaydp17,1,0.00023,89637,20.62100,434688
10069,jayeshjk,1,0.00023,89638,20.62123,434688
10070,jayheinlein,1,0.00023,89639,20.62146,434688
10071,Jayita10,1,0.00023,89640,20.62169,434688
10072,jaylcm,1,0.00023,89641,20.62192,434688
10073,jayMedicalChain,1,0.00023,89642,20.62215,434688
10074,jaymiracola,1,0.00023,89643,20.62238,434688
10075,jaywcarman,1,0.00023,89644,20.62261,434688
10076,jbandoro,1,0.00023,89645,20.62284,434688
10077,jbemmel,1,0.00023,89646,20.62307,434688
10078,jbhennin,1,0.00023,89647,20.62330,434688
10079,jbms,1,0.00023,89648,20.62353,434688
10080,jbouchery,1,0.00023,89649,20.62376,434688
10081,jbpratt,1,0.00023,89650,20.62399,434688
10082,jbraidju,1,0.00023,89651,20.62422,434688
10083,jbucar,1,0.00023,89652,20.62445,434688
10084,jbuck,1,0.00023,89653,20.62468,434688
10085,jbuettnerbild,1,0.00023,89654,20.62491,434688
10086,jcambronero,1,0.00023,89655,20.62514,434688
10087,jcdecaux-oss,1,0.00023,89656,20.62537,434688
10088,jcetkov,1,0.00023,89657,20.62560,434688
10089,jcferaud,1,0.00023,89658,20.62583,434688
10090,jchau207,1,0.00023,89659,20.62606,434688
10091,jclinn,1,0.00023,89660,20.62629,434688
10092,jcobb48,1,0.00023,89661,20.62652,434688
10093,J-Curragh,1,0.00023,89662,20.62675,434688
10094,jdesrosiers,1,0.00023,89663,20.62698,434688
10095,jdforsythe,1,0.00023,89664,20.62721,434688
10096,jdial1996,1,0.00023,89665,20.62744,434688
10097,jdileonardo,1,0.00023,89666,20.62767,434688
10098,jdmuntacb,1,0.00023,89667,20.62790,434688
10099,jdoylei,1,0.00023,89668,20.62813,434688
10100,jdshkolnik,1,0.00023,89669,20.62836,434688
10101,jdwnetapp,1,0.00023,89670,20.62859,434688
10102,jecnua,1,0.00023,89671,20.62882,434688
10103,jeffliu527,1,0.00023,89672,20.62905,434688
10104,Jeffrey778,1,0.00023,89673,20.62928,434688
10105,jeffspicer,1,0.00023,89674,20.62951,434688
10106,jeffwestaway,1,0.00023,89675,20.62974,434688
10107,Jekinnnnnn,1,0.00023,89676,20.62997,434688
10108,jelmer,1,0.00023,89677,20.63020,434688
10109,jeltz,1,0.00023,89678,20.63043,434688
10110,jemag,1,0.00023,89679,20.63066,434688
10111,Jenniferbosley2000yahoocom,1,0.00023,89680,20.63089,434688
10112,jensoncs,1,0.00023,89681,20.63112,434688
10113,jeongki-kim,1,0.00023,89682,20.63135,434688
10114,jeremiahbowen,1,0.00023,89683,20.63158,434688
10115,JeremyCaron,1,0.00023,89684,20.63181,434688
10116,jeremy-chua,1,0.00023,89685,20.63204,434688
10117,jeremy-duckworth,1,0.00023,89686,20.63227,434688
10118,jeremylingg,1,0.00023,89687,20.63250,434688
10119,JeroenKnoops,1,0.00023,89688,20.63273,434688
10120,jeroentorrekens,1,0.00023,89689,20.63296,434688
10121,jerryli-ctc,1,0.00023,89690,20.63319,434688
10122,JesperBerggren,1,0.00023,89691,20.63342,434688
10123,jessebond2,1,0.00023,89692,20.63365,434688
10124,jessejlt,1,0.00023,89693,20.63388,434688
10125,jesumyip,1,0.00023,89694,20.63411,434688
10126,jetvillegas,1,0.00023,89695,20.63434,434688
10127,jeunoir,1,0.00023,89696,20.63457,434688
10128,Jeyrce,1,0.00023,89697,20.63480,434688
10129,jezhang2014,1,0.00023,89698,20.63503,434688
10130,jf352,1,0.00023,89699,20.63526,434688
10131,jfbrennan,1,0.00023,89700,20.63549,434688
10132,jfg1701a,1,0.00023,89701,20.63572,434688
10133,jfg956,1,0.00023,89702,20.63595,434688
10134,jfgosselin,1,0.00023,89703,20.63618,434688
10135,jfmyers9,1,0.00023,89704,20.63641,434688
10136,jfoechsler,1,0.00023,89705,20.63664,434688
10137,jfolz,1,0.00023,89706,20.63687,434688
10138,jfrojo,1,0.00023,89707,20.63710,434688
10139,jgarriso,1,0.00023,89708,20.63733,434688
10140,jgielstra-cs,1,0.00023,89709,20.63756,434688
10141,jgillis01,1,0.00023,89710,20.63779,434688
10142,JGiola,1,0.00023,89711,20.63802,434688
10143,jgkawell,1,0.00023,89712,20.63825,434688
10144,jgregmac,1,0.00023,89713,20.63848,434688
10145,jgz,1,0.00023,89714,20.63871,434688
10146,jhautin,1,0.00023,89715,20.63894,434688
10147,jhbswart,1,0.00023,89716,20.63917,434688
10148,jhcolville,1,0.00023,89717,20.63940,434688
10149,jhdalek55,1,0.00023,89718,20.63963,434688
10150,jhead-slg,1,0.00023,89719,20.63986,434688
10151,JhonHarvard,1,0.00023,89720,20.64009,434688
10152,JhwuGit,1,0.00023,89721,20.64032,434688
10153,jiangpengjul,1,0.00023,89722,20.64055,434688
10154,jiangxiaoqiang,1,0.00023,89723,20.64078,434688
10155,jianh619,1,0.00023,89724,20.64101,434688
10156,jidalong,1,0.00023,89725,20.64124,434688
10157,jiegec,1,0.00023,89726,20.64147,434688
10158,JiffsMaverick,1,0.00023,89727,20.64170,434688
10159,jikunbupt,1,0.00023,89728,20.64193,434688
10160,jimbogr77,1,0.00023,89729,20.64216,434688
10161,jimmy0012,1,0.00023,89730,20.64239,434688
10162,jimsmith,1,0.00023,89731,20.64262,434688
10163,jinjiaKarl,1,0.00023,89732,20.64285,434688
10164,jinnerbichler,1,0.00023,89733,20.64308,434688
10165,jinnery,1,0.00023,89734,20.64331,434688
10166,jinsongo,1,0.00023,89735,20.64354,434688
10167,jitheshktv,1,0.00023,89736,20.64377,434688
10168,jittra201,1,0.00023,89737,20.64400,434688
10169,Jivvon,1,0.00023,89738,20.64423,434688
10170,jixiangcheng,1,0.00023,89739,20.64446,434688
10171,jjafrih,1,0.00023,89740,20.64469,434688
10172,jjayesh-gohil,1,0.00023,89741,20.64492,434688
10173,jjb,1,0.00023,89742,20.64515,434688
10174,jjcollinge,1,0.00023,89743,20.64538,434688
10175,JJJJJones,1,0.00023,89744,20.64561,434688
10176,jjkiely,1,0.00023,89745,20.64584,434688
10177,jjoynsonerwin,1,0.00023,89746,20.64607,434688
10178,jjsheridan,1,0.00023,89747,20.64630,434688
10179,jjsty1e,1,0.00023,89748,20.64653,434688
10180,jk,1,0.00023,89749,20.64676,434688
10181,jkanczler,1,0.00023,89750,20.64699,434688
10182,jkhenning,1,0.00023,89751,20.64722,434688
10183,jkralik,1,0.00023,89752,20.64745,434688
10184,JKtheSlacker,1,0.00023,89753,20.64768,434688
10185,jkylling,1,0.00023,89754,20.64791,434688
10186,JLenssen,1,0.00023,89755,20.64814,434688
10187,jli3388,1,0.00023,89756,20.64837,434688
10188,jlintz,1,0.00023,89757,20.64860,434688
10189,jlosito,1,0.00023,89758,20.64883,434688
10190,jlourenc,1,0.00023,89759,20.64906,434688
10191,jlsan92,1,0.00023,89760,20.64929,434688
10192,jmacelroy,1,0.00023,89761,20.64952,434688
10193,j-manu,1,0.00023,89762,20.64975,434688
10194,jmcastellote,1,0.00023,89763,20.64998,434688
10195,jmcdonagh,1,0.00023,89764,20.65021,434688
10196,jmeza-xyz,1,0.00023,89765,20.65044,434688
10197,jmichaelthurman,1,0.00023,89766,20.65067,434688
10198,jmjava,1,0.00023,89767,20.65090,434688
10199,jmlogan,1,0.00023,89768,20.65113,434688
10200,jmmaloney4,1,0.00023,89769,20.65136,434688
10201,jmo-qap,1,0.00023,89770,20.65159,434688
10202,jn1z,1,0.00023,89771,20.65182,434688
10203,jn9e9,1,0.00023,89772,20.65205,434688
10204,jnadler,1,0.00023,89773,20.65228,434688
10205,jnauska,1,0.00023,89774,20.65251,434688
10206,jnikles1,1,0.00023,89775,20.65274,434688
10207,JoachimBergt,1,0.00023,89776,20.65297,434688
10208,joahimg,1,0.00023,89777,20.65320,434688
10209,joanbm,1,0.00023,89778,20.65343,434688
10210,joantomas,1,0.00023,89779,20.65366,434688
10211,joaocfernandes,1,0.00023,89780,20.65389,434688
10212,joaocostamm,1,0.00023,89781,20.65412,434688
10213,joaolgn1985,1,0.00023,89782,20.65435,434688
10214,JoaRiski,1,0.00023,89783,20.65458,434688
10215,joca-bt,1,0.00023,89784,20.65481,434688
10216,jodybro,1,0.00023,89785,20.65504,434688
10217,JoeAmedeo,1,0.00023,89786,20.65527,434688
10218,joeky888,1,0.00023,89787,20.65550,434688
10219,joelbrandenburg,1,0.00023,89788,20.65573,434688
10220,joelsdc,1,0.00023,89789,20.65596,434688
10221,joewreschnig,1,0.00023,89790,20.65619,434688
10222,JohanElmis,1,0.00023,89791,20.65642,434688
10223,johanflint,1,0.00023,89792,20.65665,434688
10224,johgoe,1,0.00023,89793,20.65688,434688
10225,johnchesser,1,0.00023,89794,20.65711,434688
10226,johnfzc,1,0.00023,89795,20.65735,434688
10227,JohnGarbutt,1,0.00023,89796,20.65758,434688
10228,johngirvin,1,0.00023,89797,20.65781,434688
10229,johnhenry,1,0.00023,89798,20.65804,434688
10230,johnico,1,0.00023,89799,20.65827,434688
10231,johnlonganecker,1,0.00023,89800,20.65850,434688
10232,JohnMaison,1,0.00023,89801,20.65873,434688
10233,johnmba,1,0.00023,89802,20.65896,434688
10234,johnmuth81,1,0.00023,89803,20.65919,434688
10235,johnny-fuse,1,0.00023,89804,20.65942,434688
10236,johnnymetz,1,0.00023,89805,20.65965,434688
10237,johnnymorano,1,0.00023,89806,20.65988,434688
10238,johns007n,1,0.00023,89807,20.66011,434688
10239,johnseekins,1,0.00023,89808,20.66034,434688
10240,jojofeng,1,0.00023,89809,20.66057,434688
10241,jojotaro123,1,0.00023,89810,20.66080,434688
10242,jolusch,1,0.00023,89811,20.66103,434688
10243,Jonakss,1,0.00023,89812,20.66126,434688
10244,jonasmulticloudiac,1,0.00023,89813,20.66149,434688
10245,jonas-voi,1,0.00023,89814,20.66172,434688
10246,jonathanl-telenav,1,0.00023,89815,20.66195,434688
10247,JonathanRRogers,1,0.00023,89816,20.66218,434688
10248,jon-depop,1,0.00023,89817,20.66241,434688
10249,jonerer,1,0.00023,89818,20.66264,434688
10250,jonnytest1,1,0.00023,89819,20.66287,434688
10251,jonny-wg2,1,0.00023,89820,20.66310,434688
10252,Jonomir,1,0.00023,89821,20.66333,434688
10253,JonsKou,1,0.00023,89822,20.66356,434688
10254,jontro,1,0.00023,89823,20.66379,434688
10255,jonwilliams84,1,0.00023,89824,20.66402,434688
10256,JordanStump,1,0.00023,89825,20.66425,434688
10257,jordanworner,1,0.00023,89826,20.66448,434688
10258,jordy1024,1,0.00023,89827,20.66471,434688
10259,Jordy694,1,0.00023,89828,20.66494,434688
10260,jorgecasals,1,0.00023,89829,20.66517,434688
10261,jorgeghm,1,0.00023,89830,20.66540,434688
10262,jorioux,1,0.00023,89831,20.66563,434688
10263,jorlamd,1,0.00023,89832,20.66586,434688
10264,josegomezr,1,0.00023,89833,20.66609,434688
10265,joseluisgomes,1,0.00023,89834,20.66632,434688
10266,josephflynch,1,0.00023,89835,20.66655,434688
10267,josephkurian,1,0.00023,89836,20.66678,434688
10268,josh-ferrell-vmw,1,0.00023,89837,20.66701,434688
10269,Joshhw,1,0.00023,89838,20.66724,434688
10270,joshi-aparna,1,0.00023,89839,20.66747,434688
10271,JoshLove-msft,1,0.00023,89840,20.66770,434688
10272,joshongithub,1,0.00023,89841,20.66793,434688
10273,joshua-barnett,1,0.00023,89842,20.66816,434688
10274,joshuafernandes,1,0.00023,89843,20.66839,434688
10275,jotacamou,1,0.00023,89844,20.66862,434688
10276,jozefs,1,0.00023,89845,20.66885,434688
10277,jpatterson-fastly,1,0.00023,89846,20.66908,434688
10278,jpdoria,1,0.00023,89847,20.66931,434688
10279,jpedro1992,1,0.00023,89848,20.66954,434688
10280,jpengenheiro,1,0.00023,89849,20.66977,434688
10281,jphelp32,1,0.00023,89850,20.67000,434688
10282,jpramos123,1,0.00023,89851,20.67023,434688
10283,jpriebe,1,0.00023,89852,20.67046,434688
10284,jproig,1,0.00023,89853,20.67069,434688
10285,jpuskar,1,0.00023,89854,20.67092,434688
10286,jQrgen,1,0.00023,89855,20.67115,434688
10287,jrcasso,1,0.00023,89856,20.67138,434688
10288,jrenggli,1,0.00023,89857,20.67161,434688
10289,jriguera,1,0.00023,89858,20.67184,434688
10290,jroeber,1,0.00023,89859,20.67207,434688
10291,jrudley,1,0.00023,89860,20.67230,434688
10292,jsalgado78,1,0.00023,89861,20.67253,434688
10293,jsedy7,1,0.00023,89862,20.67276,434688
10294,jserviceorg,1,0.00023,89863,20.67299,434688
10295,jshaptic,1,0.00023,89864,20.67322,434688
10296,jshawatsplunk,1,0.00023,89865,20.67345,434688
10297,jshen28,1,0.00023,89866,20.67368,434688
10298,jshiell,1,0.00023,89867,20.67391,434688
10299,jshin47,1,0.00023,89868,20.67414,434688
10300,jshokrollahi,1,0.00023,89869,20.67437,434688
10301,jsight,1,0.00023,89870,20.67460,434688
10302,js-kyle,1,0.00023,89871,20.67483,434688
10303,jslay88,1,0.00023,89872,20.67506,434688
10304,jsmartel68,1,0.00023,89873,20.67529,434688
10305,jsmcnair,1,0.00023,89874,20.67552,434688
10306,jsnouffer,1,0.00023,89875,20.67575,434688
10307,jsnowacki,1,0.00023,89876,20.67598,434688
10308,jsonmp-k8,1,0.00023,89877,20.67621,434688
10309,js-rwwa,1,0.00023,89878,20.67644,434688
10310,jstewmon,1,0.00023,89879,20.67667,434688
10311,jsubirat,1,0.00023,89880,20.67690,434688
10312,jswingle-git,1,0.00023,89881,20.67713,434688
10313,jsymon,1,0.00023,89882,20.67736,434688
10314,jt20190617,1,0.00023,89883,20.67759,434688
10315,jtabasz,1,0.00023,89884,20.67782,434688
10316,jtheo,1,0.00023,89885,20.67805,434688
10317,ju187,1,0.00023,89886,20.67828,434688
10318,juanjoDiaz,1,0.00023,89887,20.67851,434688
10319,juanjoku,1,0.00023,89888,20.67874,434688
10320,jubeergon,1,0.00023,89889,20.67897,434688
10321,JudeNiroshan,1,0.00023,89890,20.67920,434688
10322,judomu,1,0.00023,89891,20.67943,434688
10323,juergenthomann,1,0.00023,89892,20.67966,434688
10324,jughead,1,0.00023,89893,20.67989,434688
10325,JulesBelveze,1,0.00023,89894,20.68012,434688
10326,JulianBriggs,1,0.00023,89895,20.68035,434688
10327,juliandm,1,0.00023,89896,20.68058,434688
10328,julianocosta89,1,0.00023,89897,20.68081,434688
10329,juliantaylor,1,0.00023,89898,20.68104,434688
10330,jullianow,1,0.00023,89899,20.68127,434688
10331,jumeza,1,0.00023,89900,20.68150,434688
10332,jumpeiMano,1,0.00023,89901,20.68173,434688
10333,JumpMaster,1,0.00023,89902,20.68196,434688
10334,junhuihuang,1,0.00023,89903,20.68219,434688
10335,juniorgasparotto,1,0.00023,89904,20.68242,434688
10336,juniorjbn,1,0.00023,89905,20.68265,434688
10337,junjie-landing,1,0.00023,89906,20.68288,434688
10338,junky89,1,0.00023,89907,20.68311,434688
10339,juremedvesek,1,0.00023,89908,20.68334,434688
10340,jussikuosa,1,0.00023,89909,20.68357,434688
10341,Justin8303,1,0.00023,89910,20.68380,434688
10342,JustinGuese,1,0.00023,89911,20.68403,434688
10343,justin-mp,1,0.00023,89912,20.68426,434688
10344,justinsorubio,1,0.00023,89913,20.68449,434688
10345,justinTM,1,0.00023,89914,20.68472,434688
10346,justsomebody42,1,0.00023,89915,20.68495,434688
10347,jvassev,1,0.00023,89916,20.68518,434688
10348,jvilhuber,1,0.00023,89917,20.68541,434688
10349,jvleminc,1,0.00023,89918,20.68564,434688
10350,jvolkman,1,0.00023,89919,20.68587,434688
10351,jvrahav,1,0.00023,89920,20.68610,434688
10352,jwangyangls,1,0.00023,89921,20.68633,434688
10353,jwarner112,1,0.00023,89922,20.68656,434688
10354,JWebDev,1,0.00023,89923,20.68679,434688
10355,jwhb,1,0.00023,89924,20.68702,434688
10356,jwh-hutchison,1,0.00023,89925,20.68725,434688
10357,jwilner,1,0.00023,89926,20.68748,434688
10358,jwimmersplk,1,0.00023,89927,20.68771,434688
10359,jwitko,1,0.00023,89928,20.68794,434688
10360,Jw-Jm,1,0.00023,89929,20.68817,434688
10361,jwmajors81,1,0.00023,89930,20.68840,434688
10362,jwrookie,1,0.00023,89931,20.68863,434688
10363,jyndrkhole,1,0.00023,89932,20.68886,434688
10364,Jyny,1,0.00023,89933,20.68909,434688
10365,jzuijlek,1,0.00023,89934,20.68932,434688
10366,k2let,1,0.00023,89935,20.68955,434688
10367,k402xxxcenxxx,1,0.00023,89936,20.68978,434688
10368,k4nzdroid,1,0.00023,89937,20.69001,434688
10369,Kaelten,1,0.00023,89938,20.69024,434688
10370,kaharlichenko,1,0.00023,89939,20.69047,434688
10371,kahirokunn,1,0.00023,89940,20.69070,434688
10372,kailam2lot,1,0.00023,89941,20.69093,434688
10373,kajanth-tceu,1,0.00023,89942,20.69116,434688
10374,Kaka1127,1,0.00023,89943,20.69139,434688
10375,kalahari,1,0.00023,89944,20.69162,434688
10376,kalavt,1,0.00023,89945,20.69185,434688
10377,kalyansai99,1,0.00023,89946,20.69208,434688
10378,kamaleshtangudu,1,0.00023,89947,20.69231,434688
10379,kamalhussain,1,0.00023,89948,20.69254,434688
10380,kamalkech,1,0.00023,89949,20.69277,434688
10381,KamarasV,1,0.00023,89950,20.69300,434688
10382,kamilkowalski,1,0.00023,89951,20.69323,434688
10383,kamolhasan,1,0.00023,89952,20.69346,434688
10384,kanavdevops,1,0.00023,89953,20.69369,434688
10385,kanekv,1,0.00023,89954,20.69392,434688
10386,kanghaiyan,1,0.00023,89955,20.69415,434688
10387,kannanvr,1,0.00023,89956,20.69438,434688
10388,kaovilai,1,0.00023,89957,20.69461,434688
10389,kapalevan,1,0.00023,89958,20.69484,434688
10390,kaparwan,1,0.00023,89959,20.69507,434688
10391,kapilsingh421,1,0.00023,89960,20.69530,434688
10392,karakanb,1,0.00023,89961,20.69553,434688
10393,karamaru-alpha,1,0.00023,89962,20.69576,434688
10394,karianna,1,0.00023,89963,20.69599,434688
10395,karlhaworth,1,0.00023,89964,20.69622,434688
10396,karthik012,1,0.00023,89965,20.69645,434688
10397,karthikeayan,1,0.00023,89966,20.69668,434688
10398,karthikinamanamelluri,1,0.00023,89967,20.69691,434688
10399,kartikzheng,1,0.00023,89968,20.69714,434688
10400,kasenhoo,1,0.00023,89969,20.69737,434688
10401,kaskavalci,1,0.00023,89970,20.69760,434688
10402,KasnocknDave,1,0.00023,89971,20.69783,434688
10403,katcosgrove,1,0.00023,89972,20.69806,434688
10404,katehooper89,1,0.00023,89973,20.69829,434688
10405,katsok9,1,0.00023,89974,20.69852,434688
10406,kautkata,1,0.00023,89975,20.69875,434688
10407,kave,1,0.00023,89976,20.69898,434688
10408,kavirajk,1,0.00023,89977,20.69921,434688
10409,kavyapadmanabha,1,0.00023,89978,20.69944,434688
10410,kawaja,1,0.00023,89979,20.69967,434688
10411,kaxil,1,0.00023,89980,20.69990,434688
10412,kay07,1,0.00023,89981,20.70013,434688
10413,KayhanB21,1,0.00023,89982,20.70036,434688
10414,kazakovium,1,0.00023,89983,20.70059,434688
10415,kazuki43zoo,1,0.00023,89984,20.70082,434688
10416,kchaber,1,0.00023,89985,20.70105,434688
10417,kcheemz,1,0.00023,89986,20.70128,434688
10418,kdasme,1,0.00023,89987,20.70151,434688
10419,kddiji,1,0.00023,89988,20.70174,434688
10420,kd-nuance,1,0.00023,89989,20.70197,434688
10421,kdogdavenport,1,0.00023,89990,20.70220,434688
10422,kdroukman,1,0.00023,89991,20.70243,434688
10423,keamspring,1,0.00023,89992,20.70266,434688
10424,kebarb,1,0.00023,89993,20.70289,434688
10425,kebyn,1,0.00023,89994,20.70313,434688
10426,keep94,1,0.00023,89995,20.70336,434688
10427,keiransteele,1,0.00023,89996,20.70359,434688
10428,keithl-stripe,1,0.00023,89997,20.70382,434688
10429,keithpenrod,1,0.00023,89998,20.70405,434688
10430,keithpjolley,1,0.00023,89999,20.70428,434688
10431,kempy007,1,0.00023,90000,20.70451,434688
10432,Kenshir0,1,0.00023,90001,20.70474,434688
10433,kequach,1,0.00023,90002,20.70497,434688
10434,kerossin,1,0.00023,90003,20.70520,434688
10435,Kerrnel,1,0.00023,90004,20.70543,434688
10436,kerryeon,1,0.00023,90005,20.70566,434688
10437,kessko,1,0.00023,90006,20.70589,434688
10438,kevindavee,1,0.00023,90007,20.70612,434688
10439,kevindwei,1,0.00023,90008,20.70635,434688
10440,Kevin-Molina,1,0.00023,90009,20.70658,434688
10441,kevin-phillips-ah,1,0.00023,90010,20.70681,434688
10442,kevin-shelaga,1,0.00023,90011,20.70704,434688
10443,KevinWang15,1,0.00023,90012,20.70727,434688
10444,kevsjh,1,0.00023,90013,20.70750,434688
10445,kevwil,1,0.00023,90014,20.70773,434688
10446,kewang-equinix,1,0.00023,90015,20.70796,434688
10447,KeyDecoder,1,0.00023,90016,20.70819,434688
10448,kezhenxu94,1,0.00023,90017,20.70842,434688
10449,kfp,1,0.00023,90018,20.70865,434688
10450,kguelzau,1,0.00023,90019,20.70888,434688
10451,Khaaz,1,0.00023,90020,20.70911,434688
10452,khiav223577,1,0.00023,90021,20.70934,434688
10453,khobbs-ccri,1,0.00023,90022,20.70957,434688
10454,khopithan,1,0.00023,90023,20.70980,434688
10455,khs3131,1,0.00023,90024,20.71003,434688
10456,khushbr,1,0.00023,90025,20.71026,434688
10457,kiahmed,1,0.00023,90026,20.71049,434688
10458,kiddingl,1,0.00023,90027,20.71072,434688
10459,killwing,1,0.00023,90028,20.71095,434688
10460,KimDoubleB,1,0.00023,90029,20.71118,434688
10461,king311247,1,0.00023,90030,20.71141,434688
10462,kingbyteking,1,0.00023,90031,20.71164,434688
10463,kingcr7,1,0.00023,90032,20.71187,434688
10464,Kingmoz,1,0.00023,90033,20.71210,434688
10465,kingsmill,1,0.00023,90034,20.71233,434688
10466,kinlab1,1,0.00023,90035,20.71256,434688
10467,Kiran7691,1,0.00023,90036,20.71279,434688
10468,kirenotneb,1,0.00023,90037,20.71302,434688
10469,kirinnee,1,0.00023,90038,20.71325,434688
10470,kishor82,1,0.00023,90039,20.71348,434688
10471,kishorbhat,1,0.00023,90040,20.71371,434688
10472,kjjuno,1,0.00023,90041,20.71394,434688
10473,kkchoudhary5895,1,0.00023,90042,20.71417,434688
10474,kktk-KO,1,0.00023,90043,20.71440,434688
10475,kl52752,1,0.00023,90044,20.71463,434688
10476,kLamda,1,0.00023,90045,20.71486,434688
10477,Klapeyron,1,0.00023,90046,20.71509,434688
10478,Kledenai,1,0.00023,90047,20.71532,434688
10479,klutingrusang8377,1,0.00023,90048,20.71555,434688
10480,kmaldahi,1,0.00023,90049,20.71578,434688
10481,kmhaeren,1,0.00023,90050,20.71601,434688
10482,kmott,1,0.00023,90051,20.71624,434688
10483,knagasri,1,0.00023,90052,20.71647,434688
10484,knfoo,1,0.00023,90053,20.71670,434688
10485,knusbaum,1,0.00023,90054,20.71693,434688
10486,kobi86,1,0.00023,90055,20.71716,434688
10487,kokes,1,0.00023,90056,20.71739,434688
10488,kolesnevg,1,0.00023,90057,20.71762,434688
10489,kolomenkin,1,0.00023,90058,20.71785,434688
10490,komalbehera,1,0.00023,90059,20.71808,434688
10491,komalpcg,1,0.00023,90060,20.71831,434688
10492,komi1230,1,0.00023,90061,20.71854,434688
10493,kongbb,1,0.00023,90062,20.71877,434688
10494,konstantin-kornienko,1,0.00023,90063,20.71900,434688
10495,kostenkoi,1,0.00023,90064,20.71923,434688
10496,kotnn,1,0.00023,90065,20.71946,434688
10497,kotyara85,1,0.00023,90066,20.71969,434688
10498,kouk,1,0.00023,90067,20.71992,434688
10499,koushickp,1,0.00023,90068,20.72015,434688
10500,kova98,1,0.00023,90069,20.72038,434688
10501,KozakAG,1,0.00023,90070,20.72061,434688
10502,kpanic9,1,0.00023,90071,20.72084,434688
10503,k-popov,1,0.00023,90072,20.72107,434688
10504,kqkdChen,1,0.00023,90073,20.72130,434688
10505,kql250520,1,0.00023,90074,20.72153,434688
10506,KqLLL,1,0.00023,90075,20.72176,434688
10507,KR411-prog,1,0.00023,90076,20.72199,434688
10508,krafts,1,0.00023,90077,20.72222,434688
10509,kranthikumar-kvs-by,1,0.00023,90078,20.72245,434688
10510,Krast76,1,0.00023,90079,20.72268,434688
10511,krisavi,1,0.00023,90080,20.72291,434688
10512,krishan1390,1,0.00023,90081,20.72314,434688
10513,krishnadce,1,0.00023,90082,20.72337,434688
10514,krishnaindani,1,0.00023,90083,20.72360,434688
10515,krishnakumar4a4,1,0.00023,90084,20.72383,434688
10516,kristianpaul,1,0.00023,90085,20.72406,434688
10517,Kristof-Mattei,1,0.00023,90086,20.72429,434688
10518,kriswill,1,0.00023,90087,20.72452,434688
10519,krzysztof-bronk,1,0.00023,90088,20.72475,434688
10520,ksatrasala,1,0.00023,90089,20.72498,434688
10521,k-s-dean,1,0.00023,90090,20.72521,434688
10522,kshrest,1,0.00023,90091,20.72544,434688
10523,ksquaredkey,1,0.00023,90092,20.72567,434688
10524,ksripathi,1,0.00023,90093,20.72590,434688
10525,kstedman9,1,0.00023,90094,20.72613,434688
10526,ksumit,1,0.00023,90095,20.72636,434688
10527,k-tatgenhorst,1,0.00023,90096,20.72659,434688
10528,KTAtkinson,1,0.00023,90097,20.72682,434688
10529,ktham,1,0.00023,90098,20.72705,434688
10530,ktmdan,1,0.00023,90099,20.72728,434688
10531,kuberkaul,1,0.00023,90100,20.72751,434688
10532,kucint,1,0.00023,90101,20.72774,434688
10533,Kuckkuck,1,0.00023,90102,20.72797,434688
10534,kuhsinyv,1,0.00023,90103,20.72820,434688
10535,KukyNekoi,1,0.00023,90104,20.72843,434688
10536,kumoroku,1,0.00023,90105,20.72866,434688
10537,kumy,1,0.00023,90106,20.72889,434688
10538,KunalBurangi,1,0.00023,90107,20.72912,434688
10539,kunaltyagi,1,0.00023,90108,20.72935,434688
10540,kupi93,1,0.00023,90109,20.72958,434688
10541,kurtbomya,1,0.00023,90110,20.72981,434688
10542,kustav123,1,0.00023,90111,20.73004,434688
10543,kverstr,1,0.00023,90112,20.73027,434688
10544,kwangil-ha,1,0.00023,90113,20.73050,434688
10545,kwan-research,1,0.00023,90114,20.73073,434688
10546,kwkbtr,1,0.00023,90115,20.73096,434688
10547,kwlzn,1,0.00023,90116,20.73119,434688
10548,kwon14,1,0.00023,90117,20.73142,434688
10549,kxw9298,1,0.00023,90118,20.73165,434688
10550,kye308,1,0.00023,90119,20.73188,434688
10551,kyg9823,1,0.00023,90120,20.73211,434688
10552,kyle-miller-cko,1,0.00023,90121,20.73234,434688
10553,kylerqws,1,0.00023,90122,20.73257,434688
10554,kyle-thedelta,1,0.00023,90123,20.73280,434688
10555,Kymb3rl33,1,0.00023,90124,20.73303,434688
10556,kys1230,1,0.00023,90125,20.73326,434688
10557,Kyslik,1,0.00023,90126,20.73349,434688
10558,l0tzi,1,0.00023,90127,20.73372,434688
10559,LabMenV,1,0.00023,90128,20.73395,434688
10560,laceyallyn,1,0.00023,90129,20.73418,434688
10561,laeo,1,0.00023,90130,20.73441,434688
10562,laingke,1,0.00023,90131,20.73464,434688
10563,lainosantos,1,0.00023,90132,20.73487,434688
10564,laith-leo,1,0.00023,90133,20.73510,434688
10565,laixiaohuai,1,0.00023,90134,20.73533,434688
10566,lakhsaaron,1,0.00023,90135,20.73556,434688
10567,lalalawoo,1,0.00023,90136,20.73579,434688
10568,lallinger-arbeit,1,0.00023,90137,20.73602,434688
10569,lambchr,1,0.00023,90138,20.73625,434688
10570,lambdaS-zh,1,0.00023,90139,20.73648,434688
10571,lamoglia,1,0.00023,90140,20.73671,434688
10572,lance5890,1,0.00023,90141,20.73694,434688
10573,lance-plusai,1,0.00023,90142,20.73717,434688
10574,LancerRainier,1,0.00023,90143,20.73740,434688
10575,Langohr23,1,0.00023,90144,20.73763,434688
10576,lanhu-app,1,0.00023,90145,20.73786,434688
10577,laplasz,1,0.00023,90146,20.73809,434688
10578,larkee,1,0.00023,90147,20.73832,434688
10579,LarsBingBong,1,0.00023,90148,20.73855,434688
10580,larsderidder,1,0.00023,90149,20.73878,434688
10581,larspaulsen,1,0.00023,90150,20.73901,434688
10582,LaryCaka,1,0.00023,90151,20.73924,434688
10583,Laurianti,1,0.00023,90152,20.73947,434688
10584,LautaroJayat,1,0.00023,90153,20.73970,434688
10585,lawrencewu,1,0.00023,90154,20.73993,434688
10586,lawsontyler,1,0.00023,90155,20.74016,434688
10587,lawwk98,1,0.00023,90156,20.74039,434688
10588,Lazzaretti,1,0.00023,90157,20.74062,434688
10589,LBoldStep,1,0.00023,90158,20.74085,434688
10590,lbrackenAternity,1,0.00023,90159,20.74108,434688
10591,lcarlosjr,1,0.00023,90160,20.74131,434688
10592,lcasi,1,0.00023,90161,20.74154,434688
10593,lcburnham,1,0.00023,90162,20.74177,434688
10594,lcchris,1,0.00023,90163,20.74200,434688
10595,lchdev,1,0.00023,90164,20.74223,434688
10596,lclc,1,0.00023,90165,20.74246,434688
10597,ldbecker,1,0.00023,90166,20.74269,434688
10598,ld-singh,1,0.00023,90167,20.74292,434688
10599,leanrobot,1,0.00023,90168,20.74315,434688
10600,leapsky,1,0.00023,90169,20.74338,434688
10601,Leavrth,1,0.00023,90170,20.74361,434688
10602,LEDfan,1,0.00023,90171,20.74384,434688
10603,LeDominik,1,0.00023,90172,20.74407,434688
10604,le-duane,1,0.00023,90173,20.74430,434688
10605,leepatrick-goop,1,0.00023,90174,20.74453,434688
10606,LeeZBug,1,0.00023,90175,20.74476,434688
10607,Legeril,1,0.00023,90176,20.74499,434688
10608,leiysky,1,0.00023,90177,20.74522,434688
10609,lemmy04,1,0.00023,90178,20.74545,434688
10610,lemoba,1,0.00023,90179,20.74568,434688
10611,lemonviv,1,0.00023,90180,20.74591,434688
10612,Lenguti,1,0.00023,90181,20.74614,434688
10613,lennartjuette,1,0.00023,90182,20.74637,434688
10614,lennartmohr,1,0.00023,90183,20.74660,434688
10615,LENSHOOD,1,0.00023,90184,20.74683,434688
10616,leoaguilar97,1,0.00023,90185,20.74706,434688
10617,LeoEmisGit,1,0.00023,90186,20.74729,434688
10618,leo-frank,1,0.00023,90187,20.74752,434688
10619,leolin49,1,0.00023,90188,20.74775,434688
10620,Leomax004,1,0.00023,90189,20.74798,434688
10621,leonardder,1,0.00023,90190,20.74821,434688
10622,leonid-shevtsov,1,0.00023,90191,20.74844,434688
10623,leoplo,1,0.00023,90192,20.74867,434688
10624,LeoQuote,1,0.00023,90193,20.74890,434688
10625,LeoVS09,1,0.00023,90194,20.74914,434688
10626,Lepird,1,0.00023,90195,20.74937,434688
10627,lepistone,1,0.00023,90196,20.74960,434688
10628,leshik,1,0.00023,90197,20.74983,434688
10629,lesio999,1,0.00023,90198,20.75006,434688
10630,lethargosapatheia,1,0.00023,90199,20.75029,434688
10632,levinxo,1,0.00023,90201,20.75075,434688
10633,levonet,1,0.00023,90202,20.75098,434688
10634,levya4,1,0.00023,90203,20.75121,434688
10635,Lewisecurity,1,0.00023,90204,20.75144,434688
10636,lework,1,0.00023,90205,20.75167,434688
10637,leyou240,1,0.00023,90206,20.75190,434688
10638,lgfabres,1,0.00023,90207,20.75213,434688
10639,lgtaschetto,1,0.00023,90208,20.75236,434688
10640,Lh1208AJ,1,0.00023,90209,20.75259,434688
10641,lhauspie-adeo,1,0.00023,90210,20.75282,434688
10642,LHBAhsanG,1,0.00023,90211,20.75305,434688
10643,lhelman,1,0.00023,90212,20.75328,434688
10644,liangchao88,1,0.00023,90213,20.75351,434688
10645,lianyiwork,1,0.00023,90214,20.75374,434688
10646,liapretorius,1,0.00023,90215,20.75397,434688
10647,LiBa001,1,0.00023,90216,20.75420,434688
10648,libaoan,1,0.00023,90217,20.75443,434688
10649,LibertyBeta,1,0.00023,90218,20.75466,434688
10650,libintomgit,1,0.00023,90219,20.75489,434688
10651,libo-sober,1,0.00023,90220,20.75512,434688
10652,lichunli-amzn,1,0.00023,90221,20.75535,434688
10653,lickes-liu,1,0.00023,90222,20.75558,434688
10654,lidavidm,1,0.00023,90223,20.75581,434688
10655,liejuntao001,1,0.00023,90224,20.75604,434688
10656,lifeforfun,1,0.00023,90225,20.75627,434688
10657,lig,1,0.00023,90226,20.75650,434688
10658,ligeogeorge,1,0.00023,90227,20.75673,434688
10659,liger1978,1,0.00023,90228,20.75696,434688
10660,liguangsheng,1,0.00023,90229,20.75719,434688
10661,liiri,1,0.00023,90230,20.75742,434688
10662,likaiwen123,1,0.00023,90231,20.75765,434688
10663,lilinghai,1,0.00023,90232,20.75788,434688
10664,lilinji,1,0.00023,90233,20.75811,434688
10665,lilongthinker,1,0.00023,90234,20.75834,434688
10666,lilyball,1,0.00023,90235,20.75857,434688
10667,lilyjazz,1,0.00023,90236,20.75880,434688
10668,LimeHat,1,0.00023,90237,20.75903,434688
10669,lin404,1,0.00023,90238,20.75926,434688
10670,LinanV,1,0.00023,90239,20.75949,434688
10671,linch0312,1,0.00023,90240,20.75972,434688
10672,linghaoSu,1,0.00023,90241,20.75995,434688
10673,linktimecloud,1,0.00023,90242,20.76018,434688
10674,linl12138,1,0.00023,90243,20.76041,434688
10675,Linutux42,1,0.00023,90244,20.76064,434688
10676,linuxbasic,1,0.00023,90245,20.76087,434688
10677,linw1995,1,0.00023,90246,20.76110,434688
10678,linyuuki,1,0.00023,90247,20.76133,434688
10679,Lionelpang,1,0.00023,90248,20.76156,434688
10680,lioramilbaum,1,0.00023,90249,20.76179,434688
10681,lirugo,1,0.00023,90250,20.76202,434688
10682,lisushka,1,0.00023,90251,20.76225,434688
10683,littleamigo,1,0.00023,90252,20.76248,434688
10684,Littlecowherd,1,0.00023,90253,20.76271,434688
10685,liuerfire,1,0.00023,90254,20.76294,434688
10686,liujinxinggithub,1,0.00023,90255,20.76317,434688
10687,liumuqi,1,0.00023,90256,20.76340,434688
10688,liuquanhao,1,0.00023,90257,20.76363,434688
10689,liuxingjun,1,0.00023,90258,20.76386,434688
10690,liuyanzhen34,1,0.00023,90259,20.76409,434688
10691,LiuzcEECS,1,0.00023,90260,20.76432,434688
10692,lixianwa,1,0.00023,90261,20.76455,434688
10693,lixin-wei,1,0.00023,90262,20.76478,434688
10694,liyibo-tech,1,0.00023,90263,20.76501,434688
10695,liyinxin,1,0.00023,90264,20.76524,434688
10696,Lizalex-Systems,1,0.00023,90265,20.76547,434688
10697,ljli,1,0.00023,90266,20.76570,434688
10698,ljns,1,0.00023,90267,20.76593,434688
10699,ljun0712,1,0.00023,90268,20.76616,434688
10700,lklkxcxc,1,0.00023,90269,20.76639,434688
10701,llimon,1,0.00023,90270,20.76662,434688
10702,lllamnyp,1,0.00023,90271,20.76685,434688
10703,lluqqikkai,1,0.00023,90272,20.76708,434688
10704,lmasiero,1,0.00023,90273,20.76731,434688
10705,lmserrano,1,0.00023,90274,20.76754,434688
10706,lmssy,1,0.00023,90275,20.76777,434688
10707,lnhrdt,1,0.00023,90276,20.76800,434688
10708,lnx,1,0.00023,90277,20.76823,434688
10709,lod,1,0.00023,90278,20.76846,434688
10710,logankilpatrick,1,0.00023,90279,20.76869,434688
10711,loganknecht,1,0.00023,90280,20.76892,434688
10712,logingood,1,0.00023,90281,20.76915,434688
10713,lokeshwaran100,1,0.00023,90282,20.76938,434688
10714,LolHens,1,0.00023,90283,20.76961,434688
10715,loliveira-itp,1,0.00023,90284,20.76984,434688
10716,longshine,1,0.00023,90285,20.77007,434688
10717,lookerson,1,0.00023,90286,20.77030,434688
10718,loomis,1,0.00023,90287,20.77053,434688
10719,looneym,1,0.00023,90288,20.77076,434688
10720,LordNoteworthy,1,0.00023,90289,20.77099,434688
10721,lorenzleutgeb,1,0.00023,90290,20.77122,434688
10722,lossylife,1,0.00023,90291,20.77145,434688
10723,loudmouth,1,0.00023,90292,20.77168,434688
10724,loufenghua,1,0.00023,90293,20.77191,434688
10725,lovasoa,1,0.00023,90294,20.77214,434688
10726,love477,1,0.00023,90295,20.77237,434688
10727,loveyana,1,0.00023,90296,20.77260,434688
10728,LP0101,1,0.00023,90297,20.77283,434688
10729,lpakula,1,0.00023,90298,20.77306,434688
10730,lq2015,1,0.00023,90299,20.77329,434688
10731,lqdflying,1,0.00023,90300,20.77352,434688
10732,lshilin-r,1,0.00023,90301,20.77375,434688
10733,ls-jad-elkik,1,0.00023,90302,20.77398,434688
10734,lsolovey,1,0.00023,90303,20.77421,434688
10735,lthela,1,0.00023,90304,20.77444,434688
10736,ltqb,1,0.00023,90305,20.77467,434688
10737,LtTempletonPeck,1,0.00023,90306,20.77490,434688
10738,luanweijie,1,0.00023,90307,20.77513,434688
10739,lucabello,1,0.00023,90308,20.77536,434688
10740,lucadelmonte,1,0.00023,90309,20.77559,434688
10741,lucagervasi,1,0.00023,90310,20.77582,434688
10742,Lucas-C,1,0.00023,90311,20.77605,434688
10743,LucasCarioca,1,0.00023,90312,20.77628,434688
10744,lucashalbert,1,0.00023,90313,20.77651,434688
10745,lucask18,1,0.00023,90314,20.77674,434688
10746,lucaskenda,1,0.00023,90315,20.77697,434688
10747,lucavallin,1,0.00023,90316,20.77720,434688
10748,Lucifergene,1,0.00023,90317,20.77743,434688
10749,lucifinil,1,0.00023,90318,20.77766,434688
10750,luhongzhen317,1,0.00023,90319,20.77789,434688
10751,luizmiranda7,1,0.00023,90320,20.77812,434688
10752,luk3thomas,1,0.00023,90321,20.77835,434688
10753,lukascuper,1,0.00023,90322,20.77858,434688
10754,lukasrieger-dev,1,0.00023,90323,20.77881,434688
10755,lukas-zech-software,1,0.00023,90324,20.77904,434688
10756,lukasz-pyrzyk,1,0.00023,90325,20.77927,434688
10757,Luke31,1,0.00023,90326,20.77950,434688
10758,lukeplausin,1,0.00023,90327,20.77973,434688
10759,lukqw,1,0.00023,90328,20.77996,434688
10760,lunatik13,1,0.00023,90329,20.78019,434688
10761,luochen52,1,0.00023,90330,20.78042,434688
10762,luo-kaguya,1,0.00023,90331,20.78065,434688
10763,luoxiner,1,0.00023,90332,20.78088,434688
10764,luryus,1,0.00023,90333,20.78111,434688
10765,lusid,1,0.00023,90334,20.78134,434688
10766,LutzWeischerFujitsu,1,0.00023,90335,20.78157,434688
10767,luzhkovvv,1,0.00023,90336,20.78180,434688
10768,lvauvillier,1,0.00023,90337,20.78203,434688
10769,LvLs9,1,0.00023,90338,20.78226,434688
10770,LXMGIT,1,0.00023,90339,20.78249,434688
10771,lxShaDoWxl,1,0.00023,90340,20.78272,434688
10772,lyarwood,1,0.00023,90341,20.78295,434688
10773,Lyrwon,1,0.00023,90342,20.78318,434688
10774,lyuda26,1,0.00023,90343,20.78341,434688
10775,lz8773,1,0.00023,90344,20.78364,434688
10776,lzm0,1,0.00023,90345,20.78387,434688
10777,LzyGit,1,0.00023,90346,20.78410,434688
10778,m00lecule,1,0.00023,90347,20.78433,434688
10779,m0un10,1,0.00023,90348,20.78456,434688
10780,m1schka,1,0.00023,90349,20.78479,434688
10781,m2dc0d3r,1,0.00023,90350,20.78502,434688
10782,Ma9si,1,0.00023,90351,20.78525,434688
10783,maa-biolinq,1,0.00023,90352,20.78548,434688
10784,maanasa0318,1,0.00023,90353,20.78571,434688
10785,maati55,1,0.00023,90354,20.78594,434688
10786,maayrf,1,0.00023,90355,20.78617,434688
10787,mabombo,1,0.00023,90356,20.78640,434688
10788,mabusaa,1,0.00023,90357,20.78663,434688
10789,maclockard,1,0.00023,90358,20.78686,434688
10790,macobo,1,0.00023,90359,20.78709,434688
10791,madarez,1,0.00023,90360,20.78732,434688
10792,maddin79,1,0.00023,90361,20.78755,434688
10793,madhavikdb,1,0.00023,90362,20.78778,434688
10794,madhurnawandar,1,0.00023,90363,20.78801,434688
10795,mafonso,1,0.00023,90364,20.78824,434688
10796,magec,1,0.00023,90365,20.78847,434688
10797,magichair,1,0.00023,90366,20.78870,434688
10798,magick93,1,0.00023,90367,20.78893,434688
10799,Maha-acc-github,1,0.00023,90368,20.78916,434688
10800,MahamShakir,1,0.00023,90369,20.78939,434688
10801,mahertalha5,1,0.00023,90370,20.78962,434688
10802,mahesheBen,1,0.00023,90371,20.78985,434688
10803,Mahfuzur-Rahman-Masud,1,0.00023,90372,20.79008,434688
10804,mahgo,1,0.00023,90373,20.79031,434688
10805,maiconbaumx,1,0.00023,90374,20.79054,434688
10806,maikelvl,1,0.00023,90375,20.79077,434688
10807,majkinetor,1,0.00023,90376,20.79100,434688
10808,majorpeti007,1,0.00023,90377,20.79123,434688
10809,Makaan,1,0.00023,90378,20.79146,434688
10810,maksagit,1,0.00023,90379,20.79169,434688
10811,makzzz1986,1,0.00023,90380,20.79192,434688
10812,malcolm061990,1,0.00023,90381,20.79215,434688
10813,malikumaliku,1,0.00023,90382,20.79238,434688
10814,MalKeshar,1,0.00023,90383,20.79261,434688
10815,Mallikarjuna1985,1,0.00023,90384,20.79284,434688
10816,mallniya,1,0.00023,90385,20.79307,434688
10817,malstoun,1,0.00023,90386,20.79330,434688
10818,manatax,1,0.00023,90387,20.79353,434688
10819,manchinagarjuna,1,0.00023,90388,20.79376,434688
10820,mandydydy,1,0.00023,90389,20.79399,434688
10821,manfontan,1,0.00023,90390,20.79422,434688
10822,Manheim94,1,0.00023,90391,20.79445,434688
10823,maniator,1,0.00023,90392,20.79468,434688
10824,Manigandan-R,1,0.00023,90393,20.79491,434688
10825,ManilynRamos,1,0.00023,90394,20.79515,434688
10826,M-A-N-I-S-H-K,1,0.00023,90395,20.79538,434688
10827,ManishOffi,1,0.00023,90396,20.79561,434688
10828,manju-rn,1,0.00023,90397,20.79584,434688
10829,ManneReshma,1,0.00023,90398,20.79607,434688
10830,Manny2014,1,0.00023,90399,20.79630,434688
10831,Manojhs,1,0.00023,90400,20.79653,434688
10832,manojnamodurai,1,0.00023,90401,20.79676,434688
10833,manterfield,1,0.00023,90402,20.79699,434688
10834,manuelchichi,1,0.00023,90403,20.79722,434688
10835,manuelnucci,1,0.00023,90404,20.79745,434688
10836,manuelottlik,1,0.00023,90405,20.79768,434688
10837,manushawijekoon,1,0.00023,90406,20.79791,434688
10838,manzsolutions-lpreis,1,0.00023,90407,20.79814,434688
10839,maomyu,1,0.00023,90408,20.79837,434688
10840,maorkuriel,1,0.00023,90409,20.79860,434688
10841,MaorPaz,1,0.00023,90410,20.79883,434688
10842,maratbadretdinov,1,0.00023,90411,20.79906,434688
10843,Maraudingas,1,0.00023,90412,20.79929,434688
10844,MarbolanGos,1,0.00023,90413,20.79952,434688
10845,marc0olo,1,0.00023,90414,20.79975,434688
10846,marcdejonge,1,0.00023,90415,20.79998,434688
10847,marcelloromani,1,0.00023,90416,20.80021,434688
10848,marcelned,1,0.00023,90417,20.80044,434688
10849,marchdaisy,1,0.00023,90418,20.80067,434688
10850,MarcoMatarazzo,1,0.00023,90419,20.80090,434688
10851,marcomezzaro,1,0.00023,90420,20.80113,434688
10852,marco-m-pix4d,1,0.00023,90421,20.80136,434688
10853,marcosborges,1,0.00023,90422,20.80159,434688
10854,marcoshuck,1,0.00023,90423,20.80182,434688
10855,marcstreeter,1,0.00023,90424,20.80205,434688
10856,marcusio888,1,0.00023,90425,20.80228,434688
10857,marcusjsford,1,0.00023,90426,20.80251,434688
10858,marekhanus,1,0.00023,90427,20.80274,434688
10859,marga-kinvolk,1,0.00023,90428,20.80297,434688
10860,margau,1,0.00023,90429,20.80320,434688
10861,mariadb-JeffBachtel,1,0.00023,90430,20.80343,434688
10862,mariana-bocoi,1,0.00023,90431,20.80366,434688
10863,marina-sd,1,0.00023,90432,20.80389,434688
10864,marinflorin,1,0.00023,90433,20.80412,434688
10865,Mariusko82,1,0.00023,90434,20.80435,434688
10866,markdingram,1,0.00023,90435,20.80458,434688
10867,markdoerr,1,0.00023,90436,20.80481,434688
10868,markeastwood1,1,0.00023,90437,20.80504,434688
10869,MarkEwer,1,0.00023,90438,20.80527,434688
10870,MarkMckessock,1,0.00023,90439,20.80550,434688
10871,marko-espi,1,0.00023,90440,20.80573,434688
10872,markshields-gl,1,0.00023,90441,20.80596,434688
10873,markuman,1,0.00023,90442,20.80619,434688
10874,marmelin,1,0.00023,90443,20.80642,434688
10875,marqc,1,0.00023,90444,20.80665,434688
10876,mar-rih,1,0.00023,90445,20.80688,434688
10877,marrocksd,1,0.00023,90446,20.80711,434688
10878,MarS0K,1,0.00023,90447,20.80734,434688
10879,marshmallory,1,0.00023,90448,20.80757,434688
10880,Martin91,1,0.00023,90449,20.80780,434688
10881,MartinFuerstenau,1,0.00023,90450,20.80803,434688
10882,martingehrke,1,0.00023,90451,20.80826,434688
10883,martin-macrometa,1,0.00023,90452,20.80849,434688
10884,martinou,1,0.00023,90453,20.80872,434688
10885,MartyFox,1,0.00023,90454,20.80895,434688
10886,marvindaviddiaz,1,0.00023,90455,20.80918,434688
10887,marvinpinto,1,0.00023,90456,20.80941,434688
10888,marwan116,1,0.00023,90457,20.80964,434688
10889,MarWestermann,1,0.00023,90458,20.80987,434688
10890,marziman,1,0.00023,90459,20.81010,434688
10891,masi,1,0.00023,90460,20.81033,434688
10892,mason-liu,1,0.00023,90461,20.81056,434688
10893,mastaab,1,0.00023,90462,20.81079,434688
10894,master4044,1,0.00023,90463,20.81102,434688
10895,masturd,1,0.00023,90464,20.81125,434688
10896,matejnevlud,1,0.00023,90465,20.81148,434688
10897,mateuszkozakiewicz,1,0.00023,90466,20.81171,434688
10898,matheusrazzup,1,0.00023,90467,20.81194,434688
10899,mathewmeconry,1,0.00023,90468,20.81217,434688
10900,mathewsreji,1,0.00023,90469,20.81240,434688
10901,mathiasringhof,1,0.00023,90470,20.81263,434688
10902,matiasrege,1,0.00023,90471,20.81286,434688
10903,matoous,1,0.00023,90472,20.81309,434688
10904,MatrixManAtYrService,1,0.00023,90473,20.81332,434688
10905,matrus2,1,0.00023,90474,20.81355,434688
10906,mat-santoro,1,0.00023,90475,20.81378,434688
10907,matscederholm,1,0.00023,90476,20.81401,434688
10908,matsch01,1,0.00023,90477,20.81424,434688
10909,mattalexander-pantheon,1,0.00023,90478,20.81447,434688
10910,mattburgess,1,0.00023,90479,20.81470,434688
10911,mattdowdell,1,0.00023,90480,20.81493,434688
10912,matt-dw,1,0.00023,90481,20.81516,434688
10913,matteaston,1,0.00023,90482,20.81539,434688
10914,matteobarone,1,0.00023,90483,20.81562,434688
10915,MatteoManzoni,1,0.00023,90484,20.81585,434688
10916,MatteoMori,1,0.00023,90485,20.81608,434688
10917,mattf9,1,0.00023,90486,20.81631,434688
10918,MattFanto,1,0.00023,90487,20.81654,434688
10919,matthewberryman,1,0.00023,90488,20.81677,434688
10920,MatthewG-Tech,1,0.00023,90489,20.81700,434688
10921,matthewjstanford,1,0.00023,90490,20.81723,434688
10922,mattkirby,1,0.00023,90491,20.81746,434688
10923,MattMencel,1,0.00023,90492,20.81769,434688
10924,mattparkes,1,0.00023,90493,20.81792,434688
10925,mattroark,1,0.00023,90494,20.81815,434688
10926,mattrpav,1,0.00023,90495,20.81838,434688
10927,mattslane,1,0.00023,90496,20.81861,434688
10928,MattSWakefield,1,0.00023,90497,20.81884,434688
10929,mattyb,1,0.00023,90498,20.81907,434688
10930,mattypb,1,0.00023,90499,20.81930,434688
10931,matyashlavacek,1,0.00023,90500,20.81953,434688
10932,mauricio-sardinas,1,0.00023,90501,20.81976,434688
10933,maurosala,1,0.00023,90502,20.81999,434688
10934,Maw1395,1,0.00023,90503,20.82022,434688
10935,max0ne,1,0.00023,90504,20.82045,434688
10936,max-allan-surevine,1,0.00023,90505,20.82068,434688
10937,maxboone,1,0.00023,90506,20.82091,434688
10938,maxedmands,1,0.00023,90507,20.82114,434688
10939,maximmasiutin,1,0.00023,90508,20.82137,434688
10940,maximTarleckiy,1,0.00023,90509,20.82160,434688
10941,maxisacoder,1,0.00023,90510,20.82183,434688
10942,Maxkile,1,0.00023,90511,20.82206,434688
10943,maxkraft7,1,0.00023,90512,20.82229,434688
10944,max-mathieu,1,0.00023,90513,20.82252,434688
10945,maxnilz,1,0.00023,90514,20.82275,434688
10946,maxpoirier,1,0.00023,90515,20.82298,434688
10947,maxres-fr,1,0.00023,90516,20.82321,434688
10948,MaxRuenz,1,0.00023,90517,20.82344,434688
10949,maxweiss-74656,1,0.00023,90518,20.82367,434688
10950,MayconDionisio,1,0.00023,90519,20.82390,434688
10951,mbaliuk-lohika-tix,1,0.00023,90520,20.82413,434688
10952,mbecca,1,0.00023,90521,20.82436,434688
10953,mbugua-samuel,1,0.00023,90522,20.82459,434688
10954,mcblair,1,0.00023,90523,20.82482,434688
10955,mcg1969,1,0.00023,90524,20.82505,434688
10956,mchon89,1,0.00023,90525,20.82528,434688
10957,MCKLMT,1,0.00023,90526,20.82551,434688
10958,mcmarkj,1,0.00023,90527,20.82574,434688
10959,McSick,1,0.00023,90528,20.82597,434688
10960,mdavis77,1,0.00023,90529,20.82620,434688
10961,mdbhamanii,1,0.00023,90530,20.82643,434688
10962,mdconner,1,0.00023,90531,20.82666,434688
10963,mddoor,1,0.00023,90532,20.82689,434688
10964,mdedetrich,1,0.00023,90533,20.82712,434688
10965,mdellavedova,1,0.00023,90534,20.82735,434688
10966,MDerrickGlass,1,0.00023,90535,20.82758,434688
10967,mdrajibkhan,1,0.00023,90536,20.82781,434688
10968,mdrakiburrahman,1,0.00023,90537,20.82804,434688
10969,MD-V,1,0.00023,90538,20.82827,434688
10970,mederel,1,0.00023,90539,20.82850,434688
10971,meerkampdvv,1,0.00023,90540,20.82873,434688
10972,mefistofeel,1,0.00023,90541,20.82896,434688
10973,megamorf,1,0.00023,90542,20.82919,434688
10974,meganC315,1,0.00023,90543,20.82942,434688
10975,meganlyntalley,1,0.00023,90544,20.82965,434688
10976,megawebmaster,1,0.00023,90545,20.82988,434688
10977,meghnasiingh,1,0.00023,90546,20.83011,434688
10978,mehmooda,1,0.00023,90547,20.83034,434688
10979,meier-christoph,1,0.00023,90548,20.83057,434688
10980,meirhazonAnyVision,1,0.00023,90549,20.83080,434688
10981,meise,1,0.00023,90550,20.83103,434688
10982,melisatanrverdi,1,0.00023,90551,20.83126,434688
10983,melpeln,1,0.00023,90552,20.83149,434688
10984,melvio,1,0.00023,90553,20.83172,434688
10985,menehune23,1,0.00023,90554,20.83195,434688
10986,menemelkatan,1,0.00023,90555,20.83218,434688
10987,mengfanli,1,0.00023,90556,20.83241,434688
10988,menglingwei,1,0.00023,90557,20.83264,434688
10989,mengshi02,1,0.00023,90558,20.83287,434688
10990,mengyaoyang11,1,0.00023,90559,20.83310,434688
10991,meowrison,1,0.00023,90560,20.83333,434688
10992,mercuriete,1,0.00023,90561,20.83356,434688
10993,merlinran,1,0.00023,90562,20.83379,434688
10994,merrcury,1,0.00023,90563,20.83402,434688
10995,MerreM,1,0.00023,90564,20.83425,434688
10996,mersl,1,0.00023,90565,20.83448,434688
10997,mervynzhang,1,0.00023,90566,20.83471,434688
10998,MerzMax,1,0.00023,90567,20.83494,434688
10999,meschbach,1,0.00023,90568,20.83517,434688
11000,metri,1,0.00023,90569,20.83540,434688
11001,meysholdt,1,0.00023,90570,20.83563,434688
11002,mfayiz,1,0.00023,90571,20.83586,434688
11003,mfkldev,1,0.00023,90572,20.83609,434688
11004,mforgues,1,0.00023,90573,20.83632,434688
11005,MFrancesco,1,0.00023,90574,20.83655,434688
11006,mgale,1,0.00023,90575,20.83678,434688
11007,mgmm13,1,0.00023,90576,20.83701,434688
11008,mgnisia,1,0.00023,90577,20.83724,434688
11009,mgrechukh,1,0.00023,90578,20.83747,434688
11010,mhall119,1,0.00023,90579,20.83770,434688
11011,mharriscircleci,1,0.00023,90580,20.83793,434688
11012,MHDante,1,0.00023,90581,20.83816,434688
11013,mhellmeier-ISST,1,0.00023,90582,20.83839,434688
11014,mhkarimi1383,1,0.00023,90583,20.83862,434688
11015,mhunger,1,0.00023,90584,20.83885,434688
11016,miaojianwei,1,0.00023,90585,20.83908,434688
11017,miaoxiaoy,1,0.00023,90586,20.83931,434688
11018,michael4338,1,0.00023,90587,20.83954,434688
11019,michael-careplanner,1,0.00023,90588,20.83977,434688
11020,Michael-D-Pine-dorsavi,1,0.00023,90589,20.84000,434688
11021,michaelfortin,1,0.00023,90590,20.84023,434688
11022,MichaelKueller,1,0.00023,90591,20.84046,434688
11023,Michael-M-Zhang,1,0.00023,90592,20.84069,434688
11024,michael-robbins,1,0.00023,90593,20.84092,434688
11025,michaelrodas,1,0.00023,90594,20.84116,434688
11026,michaelschem,1,0.00023,90595,20.84139,434688
11027,michailbrynard,1,0.00023,90596,20.84162,434688
11028,michalip,1,0.00023,90597,20.84185,434688
11029,michalke-it,1,0.00023,90598,20.84208,434688
11030,michallula,1,0.00023,90599,20.84231,434688
11031,michalziobro,1,0.00023,90600,20.84254,434688
11032,michelefa1988,1,0.00023,90601,20.84277,434688
11033,MickJar,1,0.00023,90602,20.84300,434688
11034,microwavables,1,0.00023,90603,20.84323,434688
11035,middagj,1,0.00023,90604,20.84346,434688
11036,Mierpo,1,0.00023,90605,20.84369,434688
11037,mieubrisse,1,0.00023,90606,20.84392,434688
11038,mig5,1,0.00023,90607,20.84415,434688
11039,MiguelLucas,1,0.00023,90608,20.84438,434688
11040,miguelrdp,1,0.00023,90609,20.84461,434688
11041,mikalai-t,1,0.00023,90610,20.84484,434688
11042,mikeeq,1,0.00023,90611,20.84507,434688
11043,MikeK184,1,0.00023,90612,20.84530,434688
11044,mikestef9,1,0.00023,90613,20.84553,434688
11045,miketruman,1,0.00023,90614,20.84576,434688
11046,mikeweisskopf,1,0.00023,90615,20.84599,434688
11047,mikeycmccarthy,1,0.00023,90616,20.84622,434688
11048,mikouaj,1,0.00023,90617,20.84645,434688
11049,MikyChow,1,0.00023,90618,20.84668,434688
11050,m-ildefons,1,0.00023,90619,20.84691,434688
11051,mingfang,1,0.00023,90620,20.84714,434688
11052,mingregister,1,0.00023,90621,20.84737,434688
11053,minh-hpham,1,0.00023,90622,20.84760,434688
11054,miquelbar,1,0.00023,90623,20.84783,434688
11055,mirajehossain,1,0.00023,90624,20.84806,434688
11056,mirusky,1,0.00023,90625,20.84829,434688
11057,miso-belica,1,0.00023,90626,20.84852,434688
11058,mitchello,1,0.00023,90627,20.84875,434688
11059,mithie,1,0.00023,90628,20.84898,434688
11060,miwurster,1,0.00023,90629,20.84921,434688
11061,MixITGit,1,0.00023,90630,20.84944,434688
11062,mj41-gdc,1,0.00023,90631,20.84967,434688
11063,mjaglan,1,0.00023,90632,20.84990,434688
11064,mjmckay,1,0.00023,90633,20.85013,434688
11065,mjmonroe,1,0.00023,90634,20.85036,434688
11066,mjoshi89,1,0.00023,90635,20.85059,434688
11067,mjoshi-sanuk,1,0.00023,90636,20.85082,434688
11068,mjpieters,1,0.00023,90637,20.85105,434688
11069,mjsmith1028,1,0.00023,90638,20.85128,434688
11070,mk2134226,1,0.00023,90639,20.85151,434688
11071,mk3rnb8,1,0.00023,90640,20.85174,434688
11072,mkfsn,1,0.00023,90641,20.85197,434688
11073,mkhodave,1,0.00023,90642,20.85220,434688
11074,mkothar2,1,0.00023,90643,20.85243,434688
11075,mkoval,1,0.00023,90644,20.85266,434688
11076,mkozal,1,0.00023,90645,20.85289,434688
11077,mkubdev,1,0.00023,90646,20.85312,434688
11078,mkubit-pl,1,0.00023,90647,20.85335,434688
11079,mkurovski,1,0.00023,90648,20.85358,434688
11080,mladlow,1,0.00023,90649,20.85381,434688
11081,mleutner,1,0.00023,90650,20.85404,434688
11082,mley,1,0.00023,90651,20.85427,434688
11083,mlopezja,1,0.00023,90652,20.85450,434688
11084,mmatache,1,0.00023,90653,20.85473,434688
11085,MMeent,1,0.00023,90654,20.85496,434688
11086,mmenbawy,1,0.00023,90655,20.85519,434688
11087,mmillard0,1,0.00023,90656,20.85542,434688
11088,mmottaghi,1,0.00023,90657,20.85565,434688
11089,mmslkr,1,0.00023,90658,20.85588,434688
11090,mmurasawa,1,0.00023,90659,20.85611,434688
11091,mmurphy30,1,0.00023,90660,20.85634,434688
11092,mnacharov,1,0.00023,90661,20.85657,434688
11093,mndrix,1,0.00023,90662,20.85680,434688
11094,mnk-se,1,0.00023,90663,20.85703,434688
11095,mnordie,1,0.00023,90664,20.85726,434688
11096,mnorrsken,1,0.00023,90665,20.85749,434688
11097,mnrendra,1,0.00023,90666,20.85772,434688
11098,MoBoo,1,0.00023,90667,20.85795,434688
11099,mogest,1,0.00023,90668,20.85818,434688
11100,mohafarooq,1,0.00023,90669,20.85841,434688
11101,MohamedHooda,1,0.00023,90670,20.85864,434688
11102,MohammadAlaviComplion,1,0.00023,90671,20.85887,434688
11103,mohammaddawoodshaik,1,0.00023,90672,20.85910,434688
11104,mohantaylor,1,0.00023,90673,20.85933,434688
11105,Mohid-A,1,0.00023,90674,20.85956,434688
11106,mohitaligne,1,0.00023,90675,20.85979,434688
11107,Mohkam,1,0.00023,90676,20.86002,434688
11108,mohnishvats,1,0.00023,90677,20.86025,434688
11109,MoienTajik,1,0.00023,90678,20.86048,434688
11110,moindev65,1,0.00023,90679,20.86071,434688
11111,mokitoo,1,0.00023,90680,20.86094,434688
11112,MollardMichael,1,0.00023,90681,20.86117,434688
11113,Momotoculteur,1,0.00023,90682,20.86140,434688
11114,monester,1,0.00023,90683,20.86163,434688
11115,Monishguru,1,0.00023,90684,20.86186,434688
11116,MonkeyS914,1,0.00023,90685,20.86209,434688
11117,moorara,1,0.00023,90686,20.86232,434688
11118,moriarty,1,0.00023,90687,20.86255,434688
11119,MoritzGruber,1,0.00023,90688,20.86278,434688
11120,morteza1131,1,0.00023,90689,20.86301,434688
11121,moshewe,1,0.00023,90690,20.86324,434688
11122,moshez,1,0.00023,90691,20.86347,434688
11123,MoShiKB,1,0.00023,90692,20.86370,434688
11124,Mosibi,1,0.00023,90693,20.86393,434688
11125,mosihra,1,0.00023,90694,20.86416,434688
11126,MotaOcimar,1,0.00023,90695,20.86439,434688
11127,motianya211314,1,0.00023,90696,20.86462,434688
11128,mottibec,1,0.00023,90697,20.86485,434688
11129,movsb,1,0.00023,90698,20.86508,434688
11130,mowings,1,0.00023,90699,20.86531,434688
11131,mpaine-act,1,0.00023,90700,20.86554,434688
11132,mpanne,1,0.00023,90701,20.86577,434688
11133,mpdevul,1,0.00023,90702,20.86600,434688
11134,mpetazzoni,1,0.00023,90703,20.86623,434688
11135,mpryahin,1,0.00023,90704,20.86646,434688
11136,mpuleikis1,1,0.00023,90705,20.86669,434688
11137,mqxter,1,0.00023,90706,20.86692,434688
11138,Mr8,1,0.00023,90707,20.86715,434688
11139,mramonlopez,1,0.00023,90708,20.86738,434688
11140,Mreddi1,1,0.00023,90709,20.86761,434688
11141,mredlars,1,0.00023,90710,20.86784,434688
11142,mreinhardt,1,0.00023,90711,20.86807,434688
11143,mrh666,1,0.00023,90712,20.86830,434688
11144,MrJackQiao,1,0.00023,90713,20.86853,434688
11145,mrkwtz,1,0.00023,90714,20.86876,434688
11146,mrliptontea,1,0.00023,90715,20.86899,434688
11147,MrLotU,1,0.00023,90716,20.86922,434688
11148,mrniranjan,1,0.00023,90717,20.86945,434688
11149,MRostanski,1,0.00023,90718,20.86968,434688
11150,MrPowerGamerBR,1,0.00023,90719,20.86991,434688
11151,mr-remington,1,0.00023,90720,20.87014,434688
11152,MrStonedOne,1,0.00023,90721,20.87037,434688
11153,mruck,1,0.00023,90722,20.87060,434688
11154,mrvreddy,1,0.00023,90723,20.87083,434688
11155,ms2008,1,0.00023,90724,20.87106,434688
11156,msaaddev,1,0.00023,90725,20.87129,434688
11157,mschindl,1,0.00023,90726,20.87152,434688
11158,mschueler,1,0.00023,90727,20.87175,434688
11159,mscrivo,1,0.00023,90728,20.87198,434688
11160,msf1t,1,0.00023,90729,20.87221,434688
11161,msftcoderdjw,1,0.00023,90730,20.87244,434688
11162,msfussell,1,0.00023,90731,20.87267,434688
11163,mshiriv,1,0.00023,90732,20.87290,434688
11164,msjingli,1,0.00023,90733,20.87313,434688
11165,msmith93,1,0.00023,90734,20.87336,434688
11166,msonnleitner,1,0.00023,90735,20.87359,434688
11167,mspaansen,1,0.00023,90736,20.87382,434688
11168,msrikantha-anuta,1,0.00023,90737,20.87405,434688
11169,mstefany,1,0.00023,90738,20.87428,434688
11170,mstenta,1,0.00023,90739,20.87451,434688
11171,mstoetzer,1,0.00023,90740,20.87474,434688
11172,m-stojanovic,1,0.00023,90741,20.87497,434688
11173,msudgh,1,0.00023,90742,20.87520,434688
11174,msusta,1,0.00023,90743,20.87543,434688
11175,mtb-xt,1,0.00023,90744,20.87566,434688
11176,mtcunningh,1,0.00023,90745,20.87589,434688
11177,mtessun,1,0.00023,90746,20.87612,434688
11178,mthomson-pulse,1,0.00023,90747,20.87635,434688
11179,mtmk,1,0.00023,90748,20.87658,434688
11180,mtneug,1,0.00023,90749,20.87681,434688
11181,mtojek,1,0.00023,90750,20.87704,434688
11182,mtt0,1,0.00023,90751,20.87727,434688
11183,mttkay,1,0.00023,90752,20.87750,434688
11184,m-tu,1,0.00023,90753,20.87773,434688
11185,muasif80,1,0.00023,90754,20.87796,434688
11186,MubeenaNaragund,1,0.00023,90755,20.87819,434688
11187,mugli,1,0.00023,90756,20.87842,434688
11188,mumrau,1,0.00023,90757,20.87865,434688
11189,murilodag,1,0.00023,90758,20.87888,434688
11190,murindwaz,1,0.00023,90759,20.87911,434688
11191,murradkh,1,0.00023,90760,20.87934,434688
11192,murugan-kannan,1,0.00023,90761,20.87957,434688
11193,muryoutaisuu,1,0.00023,90762,20.87980,434688
11194,MurzNN,1,0.00023,90763,20.88003,434688
11195,musaib072,1,0.00023,90764,20.88026,434688
11196,muskankhedia,1,0.00023,90765,20.88049,434688
11197,mut3,1,0.00023,90766,20.88072,434688
11198,Muyan0828,1,0.00023,90767,20.88095,434688
11199,muzuiget,1,0.00023,90768,20.88118,434688
11200,mvgijssel,1,0.00023,90769,20.88141,434688
11201,mvh-stripe,1,0.00023,90770,20.88164,434688
11202,mvineza,1,0.00023,90771,20.88187,434688
11203,MWalcz4k,1,0.00023,90772,20.88210,434688
11204,mwek,1,0.00023,90773,20.88233,434688
11205,mwennrich,1,0.00023,90774,20.88256,434688
11206,mxchist,1,0.00023,90775,20.88279,434688
11207,mxmeinhold,1,0.00023,90776,20.88302,434688
11208,mylespollie,1,0.00023,90777,20.88325,434688
11209,mymeatball,1,0.00023,90778,20.88348,434688
11210,myvker,1,0.00023,90779,20.88371,434688
11211,mzabsky,1,0.00023,90780,20.88394,434688
11212,mzagar,1,0.00023,90781,20.88417,434688
11213,N05h3ll,1,0.00023,90782,20.88440,434688
11214,n0vad3v,1,0.00023,90783,20.88463,434688
11215,n3yron,1,0.00023,90784,20.88486,434688
11216,nabam,1,0.00023,90785,20.88509,434688
11217,Nachimak28,1,0.00023,90786,20.88532,434688
11218,NachoRaik,1,0.00023,90787,20.88555,434688
11219,nadejdidjdhdhdh,1,0.00023,90788,20.88578,434688
11220,nadenf,1,0.00023,90789,20.88601,434688
11221,nadgowdas,1,0.00023,90790,20.88624,434688
11222,nagendrasanthosh,1,0.00023,90791,20.88647,434688
11223,nagyv,1,0.00023,90792,20.88670,434688
11224,naidu-kjml,1,0.00023,90793,20.88693,434688
11225,naishadh14,1,0.00023,90794,20.88717,434688
11226,naitianliu-google,1,0.00023,90795,20.88740,434688
11227,Nakilon,1,0.00023,90796,20.88763,434688
11228,naltun,1,0.00023,90797,20.88786,434688
11229,namcxn,1,0.00023,90798,20.88809,434688
11230,namgk,1,0.00023,90799,20.88832,434688
11231,Namyts,1,0.00023,90800,20.88855,434688
11232,Nancylsell,1,0.00023,90801,20.88878,434688
11233,narcis-sy,1,0.00023,90802,20.88901,434688
11234,narendra-cloudthat,1,0.00023,90803,20.88924,434688
11235,nareshkota2008,1,0.00023,90804,20.88947,434688
11236,nashtsai,1,0.00023,90805,20.88970,434688
11237,natbaker,1,0.00023,90806,20.88993,434688
11238,nathan9120,1,0.00023,90807,20.89016,434688
11239,nathanielop,1,0.00023,90808,20.89039,434688
11240,NathanNZ,1,0.00023,90809,20.89062,434688
11241,nathanperkins,1,0.00023,90810,20.89085,434688
11242,natsumemaya,1,0.00023,90811,20.89108,434688
11243,naveen-armedia,1,0.00023,90812,20.89131,434688
11244,navidnabavi,1,0.00023,90813,20.89154,434688
11245,navin6698,1,0.00023,90814,20.89177,434688
11246,navist2020,1,0.00023,90815,20.89200,434688
11247,navrocky,1,0.00023,90816,20.89223,434688
11248,nazari-dev,1,0.00023,90817,20.89246,434688
11249,nbaztec,1,0.00023,90818,20.89269,434688
11250,nbeal,1,0.00023,90819,20.89292,434688
11251,n-bes,1,0.00023,90820,20.89315,434688
11252,nbn,1,0.00023,90821,20.89338,434688
11253,nbon12,1,0.00023,90822,20.89361,434688
11254,nbraun-wolf,1,0.00023,90823,20.89384,434688
11255,ncabanis,1,0.00023,90824,20.89407,434688
11256,ncsibra,1,0.00023,90825,20.89430,434688
11257,Nctllnty,1,0.00023,90826,20.89453,434688
11258,nealharris,1,0.00023,90827,20.89476,434688
11259,nebiros,1,0.00023,90828,20.89499,434688
11260,NeckBeardPrince,1,0.00023,90829,20.89522,434688
11261,neelk-s1,1,0.00023,90830,20.89545,434688
11262,neelshah1617,1,0.00023,90831,20.89568,434688
11263,neha200,1,0.00023,90832,20.89591,434688
11264,neicunlideyu,1,0.00023,90833,20.89614,434688
11265,nekia,1,0.00023,90834,20.89637,434688
11266,nelliesnoodles,1,0.00023,90835,20.89660,434688
11267,nemonik,1,0.00023,90836,20.89683,434688
11268,Neor5804,1,0.00023,90837,20.89706,434688
11269,NeoTech,1,0.00023,90838,20.89729,434688
11270,neozeed,1,0.00023,90839,20.89752,434688
11271,nepeta-cataria,1,0.00023,90840,20.89775,434688
11272,NerijusVerseckas,1,0.00023,90841,20.89798,434688
11273,netfishx,1,0.00023,90842,20.89821,434688
11274,Neustradamus,1,0.00023,90843,20.89844,434688
11275,newb1e,1,0.00023,90844,20.89867,434688
11276,newtgreg,1,0.00023,90845,20.89890,434688
11277,nextgeo,1,0.00023,90846,20.89913,434688
11278,nfisher,1,0.00023,90847,20.89936,434688
11279,nf-versent,1,0.00023,90848,20.89959,434688
11280,nghyjohn,1,0.00023,90849,20.89982,434688
11281,ngoracke,1,0.00023,90850,20.90005,434688
11282,ngstigator,1,0.00023,90851,20.90028,434688
11283,nguaman,1,0.00023,90852,20.90051,434688
11284,nguyenhoai890,1,0.00023,90853,20.90074,434688
11285,NHingerl,1,0.00023,90854,20.90097,434688
11286,niallthomson,1,0.00023,90855,20.90120,434688
11287,nibbl,1,0.00023,90856,20.90143,434688
11288,nicholasmhughes,1,0.00023,90857,20.90166,434688
11289,nickazzv,1,0.00023,90858,20.90189,434688
11290,nickchen,1,0.00023,90859,20.90212,434688
11291,nickjenkin,1,0.00023,90860,20.90235,434688
11292,nickjj,1,0.00023,90861,20.90258,434688
11293,nickjmh,1,0.00023,90862,20.90281,434688
11294,nicklaus4,1,0.00023,90863,20.90304,434688
11295,nickperkins,1,0.00023,90864,20.90327,434688
11296,nickstamat,1,0.00023,90865,20.90350,434688
11297,nickwhitt,1,0.00023,90866,20.90373,434688
11298,nicolaelapteanu,1,0.00023,90867,20.90396,434688
11299,NicolasCaous,1,0.00023,90868,20.90419,434688
11300,nidhi-doshi,1,0.00023,90869,20.90442,434688
11301,niekvangogh,1,0.00023,90870,20.90465,434688
11302,nielsdemoen,1,0.00023,90871,20.90488,434688
11303,NielsHoogeveen,1,0.00023,90872,20.90511,434688
11304,nigeisel,1,0.00023,90873,20.90534,434688
11305,Nightfall2343,1,0.00023,90874,20.90557,434688
11306,nightlyone,1,0.00023,90875,20.90580,434688
11307,Niharikadutta,1,0.00023,90876,20.90603,434688
11308,nijave,1,0.00023,90877,20.90626,434688
11309,nikelsj11,1,0.00023,90878,20.90649,434688
11310,nikema-armory,1,0.00023,90879,20.90672,434688
11311,nikhil-neu,1,0.00023,90880,20.90695,434688
11312,nikhil-rajan-neu,1,0.00023,90881,20.90718,434688
11313,nikitag55,1,0.00023,90882,20.90741,434688
11314,NiklasWagner,1,0.00023,90883,20.90764,434688
11315,nikolai-semenov,1,0.00023,90884,20.90787,434688
11316,nikolasrieble,1,0.00023,90885,20.90810,434688
11317,nikola-vortexwe,1,0.00023,90886,20.90833,434688
11318,nikotili,1,0.00023,90887,20.90856,434688
11319,nilbacardit26,1,0.00023,90888,20.90879,434688
11320,NilimaC04,1,0.00023,90889,20.90902,434688
11321,nilofer,1,0.00023,90890,20.90925,434688
11322,nimams,1,0.00023,90891,20.90948,434688
11323,nimeshbhagat,1,0.00023,90892,20.90971,434688
11324,nimf,1,0.00023,90893,20.90994,434688
11325,nimrodshn,1,0.00023,90894,20.91017,434688
11326,ninadm,1,0.00023,90895,20.91040,434688
11327,ninamao,1,0.00023,90896,20.91063,434688
11328,Nindaleth,1,0.00023,90897,20.91086,434688
11329,ninehills,1,0.00023,90898,20.91109,434688
11330,NinekoTheCat,1,0.00023,90899,20.91132,434688
11331,ninghaocalgary,1,0.00023,90900,20.91155,434688
11332,NingjieLu,1,0.00023,90901,20.91178,434688
11333,ninthnails,1,0.00023,90902,20.91201,434688
11334,nipr-jdoenges,1,0.00023,90903,20.91224,434688
11335,niroowns,1,0.00023,90904,20.91247,434688
11336,nirroz93,1,0.00023,90905,20.91270,434688
11337,Nithin2994,1,0.00023,90906,20.91293,434688
11338,nithu0115,1,0.00023,90907,20.91316,434688
11339,niuzs-alan,1,0.00023,90908,20.91339,434688
11340,nivsa,1,0.00023,90909,20.91362,434688
11341,njavilas2015,1,0.00023,90910,20.91385,434688
11342,njtman,1,0.00023,90911,20.91408,434688
11343,njucjc,1,0.00023,90912,20.91431,434688
11344,njuCZ,1,0.00023,90913,20.91454,434688
11345,nleconte-csgroup,1,0.00023,90914,20.91477,434688
11346,nlykkei,1,0.00023,90915,20.91500,434688
11347,nmahajan-jpmc,1,0.00023,90916,20.91523,434688
11348,nmathew,1,0.00023,90917,20.91546,434688
11349,nmathewson,1,0.00023,90918,20.91569,434688
11350,nmonserrato,1,0.00023,90919,20.91592,434688
11351,nmyalik,1,0.00023,90920,20.91615,434688
11352,nnewc,1,0.00023,90921,20.91638,434688
11353,nniehoff,1,0.00023,90922,20.91661,434688
11354,nnunodev,1,0.00023,90923,20.91684,434688
11355,No9,1,0.00023,90924,20.91707,434688
11356,noahjd,1,0.00023,90925,20.91730,434688
11357,noahsbwilliams,1,0.00023,90926,20.91753,434688
11358,nobuhikosawai,1,0.00023,90927,20.91776,434688
11359,noevhlev,1,0.00023,90928,20.91799,434688
11360,nofacer,1,0.00023,90929,20.91822,434688
11361,nohant,1,0.00023,90930,20.91845,434688
11362,nokome,1,0.00023,90931,20.91868,434688
11363,Noksa,1,0.00023,90932,20.91891,434688
11364,nolith,1,0.00023,90933,20.91914,434688
11365,NoNalTrX,1,0.00023,90934,20.91937,434688
11366,Nonius,1,0.00023,90935,20.91960,434688
11367,nonylene,1,0.00023,90936,20.91983,434688
11368,norbertwnuk,1,0.00023,90937,20.92006,434688
11369,NormanLYJ,1,0.00023,90938,20.92029,434688
11370,NotAFile,1,0.00023,90939,20.92052,434688
11371,notrealanurag,1,0.00023,90940,20.92075,434688
11372,novegit,1,0.00023,90941,20.92098,434688
11373,noxora,1,0.00023,90942,20.92121,434688
11374,nrhtr,1,0.00023,90943,20.92144,434688
11375,nrk-simple,1,0.00023,90944,20.92167,434688
11376,nrodruck,1,0.00023,90945,20.92190,434688
11377,ns0092,1,0.00023,90946,20.92213,434688
11378,nscuro,1,0.00023,90947,20.92236,434688
11379,nsharma-fy,1,0.00023,90948,20.92259,434688
11380,nsourov,1,0.00023,90949,20.92282,434688
11381,ntindle,1,0.00023,90950,20.92305,434688
11382,ntorba,1,0.00023,90951,20.92328,434688
11383,nuckydong,1,0.00023,90952,20.92351,434688
11384,NULLPlayer,1,0.00023,90953,20.92374,434688
11385,nullpo-head,1,0.00023,90954,20.92397,434688
11386,Nuru,1,0.00023,90955,20.92420,434688
11387,nuved,1,0.00023,90956,20.92443,434688
11388,Nuxij,1,0.00023,90957,20.92466,434688
11389,nvermalulu,1,0.00023,90958,20.92489,434688
11390,nvx,1,0.00023,90959,20.92512,434688
11391,nwoodmsft,1,0.00023,90960,20.92535,434688
11392,nwpappas,1,0.00023,90961,20.92558,434688
11393,NYARAS,1,0.00023,90962,20.92581,434688
11394,nyrahul,1,0.00023,90963,20.92604,434688
11395,oana-s,1,0.00023,90964,20.92627,434688
11396,obataku,1,0.00023,90965,20.92650,434688
11397,obourdon,1,0.00023,90966,20.92673,434688
11398,ocavue,1,0.00023,90967,20.92696,434688
11399,Octokat-dotcom,1,0.00023,90968,20.92719,434688
11400,oDn,1,0.00023,90969,20.92742,434688
11401,Odysseas640,1,0.00023,90970,20.92765,434688
11402,OElGebaly,1,0.00023,90971,20.92788,434688
11403,ofaakye,1,0.00023,90972,20.92811,434688
11404,OfirTadmor,1,0.00023,90973,20.92834,434688
11405,ofsaleem,1,0.00023,90974,20.92857,434688
11406,Ognian,1,0.00023,90975,20.92880,434688
11407,OgreCase,1,0.00023,90976,20.92903,434688
11408,oguzdag,1,0.00023,90977,20.92926,434688
11409,ogxd,1,0.00023,90978,20.92949,434688
11410,ohadm2,1,0.00023,90979,20.92972,434688
11411,ohanedan,1,0.00023,90980,20.92995,434688
11412,ohmygd,1,0.00023,90981,20.93018,434688
11413,oivindoh,1,0.00023,90982,20.93041,434688
11414,Okeanos,1,0.00023,90983,20.93064,434688
11415,okravets,1,0.00023,90984,20.93087,434688
11416,oksiquatzel,1,0.00023,90985,20.93110,434688
11417,olaf-2,1,0.00023,90986,20.93133,434688
11418,olarudan,1,0.00023,90987,20.93156,434688
11419,olavloite,1,0.00023,90988,20.93179,434688
11420,oldfo4,1,0.00023,90989,20.93202,434688
11421,olearczuk,1,0.00023,90990,20.93225,434688
11422,oleg-webdeveloper,1,0.00023,90991,20.93248,434688
11423,olehb,1,0.00023,90992,20.93271,434688
11424,oleksdiam,1,0.00023,90993,20.93295,434688
11425,oliv3340,1,0.00023,90994,20.93318,434688
11426,OliverCole,1,0.00023,90995,20.93341,434688
11427,oliverdawid,1,0.00023,90996,20.93364,434688
11428,Oliver-Sellwood,1,0.00023,90997,20.93387,434688
11429,omallo,1,0.00023,90998,20.93410,434688
11430,omarine,1,0.00023,90999,20.93433,434688
11431,omer-shtivi,1,0.00023,91000,20.93456,434688
11432,ominiet,1,0.00023,91001,20.93479,434688
11433,omyers89,1,0.00023,91002,20.93502,434688
11434,omzmarlon,1,0.00023,91003,20.93525,434688
11435,OndraZizka,1,0.00023,91004,20.93548,434688
11436,ondrejmo,1,0.00023,91005,20.93571,434688
11437,ondrejtomcik,1,0.00023,91006,20.93594,434688
11438,onepos-zaika,1,0.00023,91007,20.93617,434688
11439,onigm,1,0.00023,91008,20.93640,434688
11440,oniony,1,0.00023,91009,20.93663,434688
11441,onmomo,1,0.00023,91010,20.93686,434688
11442,oops-lgtm,1,0.00023,91011,20.93709,434688
11443,opencommits,1,0.00023,91012,20.93732,434688
11444,oper25,1,0.00023,91013,20.93755,434688
11445,op-euga,1,0.00023,91014,20.93778,434688
11446,opscmkamthe,1,0.00023,91015,20.93801,434688
11447,optimus-kart,1,0.00023,91016,20.93824,434688
11448,OpzekerIT,1,0.00023,91017,20.93847,434688
11449,oranerez,1,0.00023,91018,20.93870,434688
11450,orange-llajeanne,1,0.00023,91019,20.93893,434688
11451,orenlevi,1,0.00023,91020,20.93916,434688
11452,orHayoun,1,0.00023,91021,20.93939,434688
11453,ori-nat,1,0.00023,91022,20.93962,434688
11454,orlandothoeny,1,0.00023,91023,20.93985,434688
11455,oronsh,1,0.00023,91024,20.94008,434688
11456,orrymr,1,0.00023,91025,20.94031,434688
11457,orsher,1,0.00023,91026,20.94054,434688
11458,osherlevi,1,0.00023,91027,20.94077,434688
11459,Oshratn,1,0.00023,91028,20.94100,434688
11460,OS-WS,1,0.00023,91029,20.94123,434688
11461,otharry,1,0.00023,91030,20.94146,434688
11462,oxeye-schmil,1,0.00023,91031,20.94169,434688
11463,OzanSayici,1,0.00023,91032,20.94192,434688
11464,ozhankaraman,1,0.00023,91033,20.94215,434688
11465,OzySky,1,0.00023,91034,20.94238,434688
11466,P0rth0s,1,0.00023,91035,20.94261,434688
11467,p3kj,1,0.00023,91036,20.94284,434688
11468,p3t3rp3pp3r,1,0.00023,91037,20.94307,434688
11469,pablitoc,1,0.00023,91038,20.94330,434688
11470,pablitovicente,1,0.00023,91039,20.94353,434688
11471,pabloborh,1,0.00023,91040,20.94376,434688
11472,pablodz,1,0.00023,91041,20.94399,434688
11473,pabusse,1,0.00023,91042,20.94422,434688
11474,Packetslave,1,0.00023,91043,20.94445,434688
11475,pacoguzman,1,0.00023,91044,20.94468,434688
11476,paimon0715,1,0.00023,91045,20.94491,434688
11477,painhardcore,1,0.00023,91046,20.94514,434688
11478,Paleloser,1,0.00023,91047,20.94537,434688
11479,Pale-whale,1,0.00023,91048,20.94560,434688
11480,pallabganai,1,0.00023,91049,20.94583,434688
11481,Pallavi4399,1,0.00023,91050,20.94606,434688
11482,pampatzoglou,1,0.00023,91051,20.94629,434688
11483,PANDURANGANGAN35,1,0.00023,91052,20.94652,434688
11484,panitaxx,1,0.00023,91053,20.94675,434688
11485,pankaj957,1,0.00023,91054,20.94698,434688
11486,panos--,1,0.00023,91055,20.94721,434688
11487,Pantalones411,1,0.00023,91056,20.94744,434688
11488,Pante,1,0.00023,91057,20.94767,434688
11489,pantianying,1,0.00023,91058,20.94790,434688
11490,panza24,1,0.00023,91059,20.94813,434688
11491,paolo2299,1,0.00023,91060,20.94836,434688
11492,papagian,1,0.00023,91061,20.94859,434688
11493,papezt,1,0.00023,91062,20.94882,434688
11494,Paragon1970,1,0.00023,91063,20.94905,434688
11495,ParamPathak,1,0.00023,91064,20.94928,434688
11496,ParaziDXD,1,0.00023,91065,20.94951,434688
11497,pardeike,1,0.00023,91066,20.94974,434688
11498,Parsonswy,1,0.00023,91067,20.94997,434688
11499,parswebserver,1,0.00023,91068,20.95020,434688
11500,partcyborg,1,0.00023,91069,20.95043,434688
11501,parth7676,1,0.00023,91070,20.95066,434688
11502,parth-pandit,1,0.00023,91071,20.95089,434688
11503,parvezsyed,1,0.00023,91072,20.95112,434688
11504,pashenmebaojinwo,1,0.00023,91073,20.95135,434688
11505,pashinin,1,0.00023,91074,20.95158,434688
11506,passcod,1,0.00023,91075,20.95181,434688
11507,Patchud,1,0.00023,91076,20.95204,434688
11508,pathikritmodak,1,0.00023,91077,20.95227,434688
11509,patrickjahns,1,0.00023,91078,20.95250,434688
11510,patrickmen,1,0.00023,91079,20.95273,434688
11511,PatrickOsborne,1,0.00023,91080,20.95296,434688
11512,patrickpierson,1,0.00023,91081,20.95319,434688
11513,patrixr,1,0.00023,91082,20.95342,434688
11514,patrykcloudmind,1,0.00023,91083,20.95365,434688
11515,patryksandomierski,1,0.00023,91084,20.95388,434688
11516,paulden,1,0.00023,91085,20.95411,434688
11517,paulgear,1,0.00023,91086,20.95434,434688
11518,paul-mesnilgrente,1,0.00023,91087,20.95457,434688
11519,pauloalima,1,0.00023,91088,20.95480,434688
11520,PauloLuna,1,0.00023,91089,20.95503,434688
11521,paulopatto,1,0.00023,91090,20.95526,434688
11522,paul-oreilly-nz,1,0.00023,91091,20.95549,434688
11523,paulsavides,1,0.00023,91092,20.95572,434688
11524,paulstelian97,1,0.00023,91093,20.95595,434688
11525,pavani-17,1,0.00023,91094,20.95618,434688
11526,PavloZabudskyi,1,0.00023,91095,20.95641,434688
11527,pavog,1,0.00023,91096,20.95664,434688
11528,pawanakhil,1,0.00023,91097,20.95687,434688
11529,pawelborkar,1,0.00023,91098,20.95710,434688
11530,pawelpreczynski-digica,1,0.00023,91099,20.95733,434688
11531,pawlean,1,0.00023,91100,20.95756,434688
11532,paxbit,1,0.00023,91101,20.95779,434688
11533,Paxhape,1,0.00023,91102,20.95802,434688
11534,Payop,1,0.00023,91103,20.95825,434688
11535,pazuzux,1,0.00023,91104,20.95848,434688
11536,pbaderia01,1,0.00023,91105,20.95871,434688
11537,pbarnum,1,0.00023,91106,20.95894,434688
11538,pbn4,1,0.00023,91107,20.95917,434688
11539,pbradly,1,0.00023,91108,20.95940,434688
11540,pchang388,1,0.00023,91109,20.95963,434688
11541,pdassani,1,0.00023,91110,20.95986,434688
11542,pdf,1,0.00023,91111,20.96009,434688
11543,pdiaz,1,0.00023,91112,20.96032,434688
11544,pd-kcarrasco,1,0.00023,91113,20.96055,434688
11545,pedinil,1,0.00023,91114,20.96078,434688
11546,pedro-stanaka,1,0.00023,91115,20.96101,434688
11547,peetasan,1,0.00023,91116,20.96124,434688
11548,peleduri,1,0.00023,91117,20.96147,434688
11549,pelletier,1,0.00023,91118,20.96170,434688
11550,Pendicool,1,0.00023,91119,20.96193,434688
11551,PengBo-Tyler,1,0.00023,91120,20.96216,434688
11552,penglei,1,0.00023,91121,20.96239,434688
11553,pengshengguo,1,0.00023,91122,20.96262,434688
11554,pensarguet,1,0.00023,91123,20.96285,434688
11555,peripurnama,1,0.00023,91124,20.96308,434688
11556,pesarboy,1,0.00023,91125,20.96331,434688
11557,pesarkhobeee,1,0.00023,91126,20.96354,434688
11558,PetarBersic,1,0.00023,91127,20.96377,434688
11559,peterclauterbach,1,0.00023,91128,20.96400,434688
11560,peter-englmaier,1,0.00023,91129,20.96423,434688
11561,peterfraedrich,1,0.00023,91130,20.96446,434688
11562,PeterGarner,1,0.00023,91131,20.96469,434688
11563,peterhaddad3121,1,0.00023,91132,20.96492,434688
11564,peter-hst,1,0.00023,91133,20.96515,434688
11565,Peterisfar,1,0.00023,91134,20.96538,434688
11566,peterolivosuse,1,0.00023,91135,20.96561,434688
11567,peters95,1,0.00023,91136,20.96584,434688
11568,petersutty,1,0.00023,91137,20.96607,434688
11569,petewilcock,1,0.00023,91138,20.96630,434688
11570,petr4,1,0.00023,91139,20.96653,434688
11571,PetrMc,1,0.00023,91140,20.96676,434688
11572,petur,1,0.00023,91141,20.96699,434688
11573,Peyoz,1,0.00023,91142,20.96722,434688
11574,pgasca,1,0.00023,91143,20.96745,434688
11575,pgillich,1,0.00023,91144,20.96768,434688
11576,pgJordan,1,0.00023,91145,20.96791,434688
11577,pgressa,1,0.00023,91146,20.96814,434688
11578,pgschr,1,0.00023,91147,20.96837,434688
11579,Phanatic,1,0.00023,91148,20.96860,434688
11580,Phil0ctetes,1,0.00023,91149,20.96883,434688
11581,philraj,1,0.00023,91150,20.96906,434688
11582,philstutz,1,0.00023,91151,20.96929,434688
11583,PhilYue,1,0.00023,91152,20.96952,434688
11584,phntom,1,0.00023,91153,20.96975,434688
11585,phoefflin,1,0.00023,91154,20.96998,434688
11586,phreddrick,1,0.00023,91155,20.97021,434688
11587,phuongnq,1,0.00023,91156,20.97044,434688
11588,piellick,1,0.00023,91157,20.97067,434688
11589,pierlucg-xs,1,0.00023,91158,20.97090,434688
11590,PierreAdrienDelisle,1,0.00023,91159,20.97113,434688
11591,PierreR,1,0.00023,91160,20.97136,434688
11592,PierreRust,1,0.00023,91161,20.97159,434688
11593,pieterv-icloud-com,1,0.00023,91162,20.97182,434688
11594,pikhovkin,1,0.00023,91163,20.97205,434688
11595,pilipchik,1,0.00023,91164,20.97228,434688
11596,pimeys,1,0.00023,91165,20.97251,434688
11597,pingenglj,1,0.00023,91166,20.97274,434688
11598,pinowthebird,1,0.00023,91167,20.97297,434688
11599,pioneer-hash,1,0.00023,91168,20.97320,434688
11600,piotaixr,1,0.00023,91169,20.97343,434688
11601,piotrmsc,1,0.00023,91170,20.97366,434688
11602,piotrrotter,1,0.00023,91171,20.97389,434688
11603,pitinga,1,0.00023,91172,20.97412,434688
11604,pitrou,1,0.00023,91173,20.97435,434688
11605,piwicode,1,0.00023,91174,20.97458,434688
11606,Pixelatex,1,0.00023,91175,20.97481,434688
11607,pixiake,1,0.00023,91176,20.97504,434688
11608,piyush168713,1,0.00023,91177,20.97527,434688
11609,pjshort75,1,0.00023,91178,20.97550,434688
11610,pka23,1,0.00023,91179,20.97573,434688
11611,pkj-m,1,0.00023,91180,20.97596,434688
11612,pkumbharkar,1,0.00023,91181,20.97619,434688
11613,plakyda1,1,0.00023,91182,20.97642,434688
11614,platbr,1,0.00023,91183,20.97665,434688
11615,ploddi,1,0.00023,91184,20.97688,434688
11616,plu,1,0.00023,91185,20.97711,434688
11617,pmbeaumier,1,0.00023,91186,20.97734,434688
11618,pmcbride613,1,0.00023,91187,20.97757,434688
11619,pmcgrath,1,0.00023,91188,20.97780,434688
11620,pmialon,1,0.00023,91189,20.97803,434688
11621,pnaponoceno,1,0.00023,91190,20.97826,434688
11622,pnbrown,1,0.00023,91191,20.97849,434688
11623,pnl0dg7k,1,0.00023,91192,20.97872,434688
11624,pnorth1,1,0.00023,91193,20.97896,434688
11625,p-null,1,0.00023,91194,20.97919,434688
11626,poblish,1,0.00023,91195,20.97942,434688
11627,pogao,1,0.00023,91196,20.97965,434688
11628,pogossian,1,0.00023,91197,20.97988,434688
11629,polachok,1,0.00023,91198,20.98011,434688
11630,polatsinan,1,0.00023,91199,20.98034,434688
11631,politician,1,0.00023,91200,20.98057,434688
11632,pombredanne,1,0.00023,91201,20.98080,434688
11633,ponson-thankavel,1,0.00023,91202,20.98103,434688
11634,poojaghumre,1,0.00023,91203,20.98126,434688
11635,poonampawar28,1,0.00023,91204,20.98149,434688
11636,poor1017,1,0.00023,91205,20.98172,434688
11637,port3000,1,0.00023,91206,20.98195,434688
11638,potulabe,1,0.00023,91207,20.98218,434688
11639,powturns,1,0.00023,91208,20.98241,434688
11640,ppedrozzi,1,0.00023,91209,20.98264,434688
11641,ppmspetrovic,1,0.00023,91210,20.98287,434688
11642,ppoetz,1,0.00023,91211,20.98310,434688
11643,pporee,1,0.00023,91212,20.98333,434688
11644,ppp0,1,0.00023,91213,20.98356,434688
11645,prab2014,1,0.00023,91214,20.98379,434688
11646,prabhakar-oracle,1,0.00023,91215,20.98402,434688
11647,Pradeep2103,1,0.00023,91216,20.98425,434688
11648,pradpath8,1,0.00023,91217,20.98448,434688
11649,prahaladdarkin,1,0.00023,91218,20.98471,434688
11650,PrajwalShenoy,1,0.00023,91219,20.98494,434688
11651,prakash2033,1,0.00023,91220,20.98517,434688
11652,PrakashFromBunnings,1,0.00023,91221,20.98540,434688
11653,PrakashTrove,1,0.00023,91222,20.98563,434688
11654,pramenn,1,0.00023,91223,20.98586,434688
11655,pramodh941,1,0.00023,91224,20.98609,434688
11656,prankulmahajan,1,0.00023,91225,20.98632,434688
11657,prasad-acit,1,0.00023,91226,20.98655,434688
11658,prasadbhagwat93,1,0.00023,91227,20.98678,434688
11659,prasad-marne,1,0.00023,91228,20.98701,434688
11660,prasannavalluru,1,0.00023,91229,20.98724,434688
11661,prashanth26,1,0.00023,91230,20.98747,434688
11662,prashant-kush,1,0.00023,91231,20.98770,434688
11663,PrashantRaj18198,1,0.00023,91232,20.98793,434688
11664,prashilgupta,1,0.00023,91233,20.98816,434688
11665,prateeknayak,1,0.00023,91234,20.98839,434688
11666,prathamesh-gharat,1,0.00023,91235,20.98862,434688
11667,pratiklotia,1,0.00023,91236,20.98885,434688
11668,pratikpatil024,1,0.00023,91237,20.98908,434688
11669,praveentiru,1,0.00023,91238,20.98931,434688
11670,preetak,1,0.00023,91239,20.98954,434688
11671,prernasony,1,0.00023,91240,20.98977,434688
11672,preston,1,0.00023,91241,20.99000,434688
11673,prijks,1,0.00023,91242,20.99023,434688
11674,PringBlocks,1,0.00023,91243,20.99046,434688
11675,pritamdas1309,1,0.00023,91244,20.99069,434688
11676,prithulagta,1,0.00023,91245,20.99092,434688
11677,priyanka19-98,1,0.00023,91246,20.99115,434688
11678,P-riyanka-prasad,1,0.00023,91247,20.99138,434688
11679,probepark,1,0.00023,91248,20.99161,434688
11680,prodanlabs,1,0.00023,91249,20.99184,434688
11681,profhase,1,0.00023,91250,20.99207,434688
11682,programmerlc,1,0.00023,91251,20.99230,434688
11683,proohit,1,0.00023,91252,20.99253,434688
11684,ProsciaAdamLang,1,0.00023,91253,20.99276,434688
11685,pruchay,1,0.00023,91254,20.99299,434688
11686,PSanetra,1,0.00023,91255,20.99322,434688
11687,pschulten,1,0.00023,91256,20.99345,434688
11688,psi-4ward,1,0.00023,91257,20.99368,434688
11689,Psicologi-italiani,1,0.00023,91258,20.99391,434688
11690,psmorandi,1,0.00023,91259,20.99414,434688
11691,psprings,1,0.00023,91260,20.99437,434688
11692,pstray,1,0.00023,91261,20.99460,434688
11693,psvensson,1,0.00023,91262,20.99483,434688
11694,psychic-toaster,1,0.00023,91263,20.99506,434688
11695,pthalasta,1,0.00023,91264,20.99529,434688
11696,ptr-dorjin,1,0.00023,91265,20.99552,434688
11697,pulberg,1,0.00023,91266,20.99575,434688
11698,Puneethgr,1,0.00023,91267,20.99598,434688
11699,punitcse,1,0.00023,91268,20.99621,434688
11700,purohit14,1,0.00023,91269,20.99644,434688
11701,purpleHound,1,0.00023,91270,20.99667,434688
11702,puru86,1,0.00023,91271,20.99690,434688
11703,PushpamChoudhury,1,0.00023,91272,20.99713,434688
11704,pwoelfle,1,0.00023,91273,20.99736,434688
11705,pyfs,1,0.00023,91274,20.99759,434688
11706,pylgrym,1,0.00023,91275,20.99782,434688
11707,pymongo,1,0.00023,91276,20.99805,434688
11708,Pyppe,1,0.00023,91277,20.99828,434688
11709,pysen,1,0.00023,91278,20.99851,434688
11710,pythonInRelay,1,0.00023,91279,20.99874,434688
11711,python-it,1,0.00023,91280,20.99897,434688
11712,pythonwood,1,0.00023,91281,20.99920,434688
11713,pzdouglas,1,0.00023,91282,20.99943,434688
11714,q2dg,1,0.00023,91283,20.99966,434688
11715,qabpea,1,0.00023,91284,20.99989,434688
11716,qafro1,1,0.00023,91285,21.00012,434688
11717,qAison,1,0.00023,91286,21.00035,434688
11718,Qdigital,1,0.00023,91287,21.00058,434688
11719,qhanam,1,0.00023,91288,21.00081,434688
11720,qiaohao9,1,0.00023,91289,21.00104,434688
11721,qike-ms,1,0.00023,91290,21.00127,434688
11722,qingchen1203,1,0.00023,91291,21.00150,434688
11723,QiuToo,1,0.00023,91292,21.00173,434688
11724,qiuyuzhou,1,0.00023,91293,21.00196,434688
11725,qmhu,1,0.00023,91294,21.00219,434688
11726,qmonitoring,1,0.00023,91295,21.00242,434688
11727,qpzmtyv,1,0.00023,91296,21.00265,434688
11728,qrkourier,1,0.00023,91297,21.00288,434688
11729,quanbisen,1,0.00023,91298,21.00311,434688
11730,QuanJingHong,1,0.00023,91299,21.00334,434688
11731,QuanTran91,1,0.00023,91300,21.00357,434688
11732,quanuw,1,0.00023,91301,21.00380,434688
11733,questionmorc,1,0.00023,91302,21.00403,434688
11734,quickstar,1,0.00023,91303,21.00426,434688
11735,quimodotcom,1,0.00023,91304,21.00449,434688
11736,r1nc0n,1,0.00023,91305,21.00472,434688
11737,R4ZN1V,1,0.00023,91306,21.00495,434688
11738,ra-amitkumar,1,0.00023,91307,21.00518,434688
11739,r-a-c,1,0.00023,91308,21.00541,434688
11740,racarlosdavid,1,0.00023,91309,21.00564,434688
11741,racdev,1,0.00023,91310,21.00587,434688
11742,rachelis19,1,0.00023,91311,21.00610,434688
11743,rad1k4l,1,0.00023,91312,21.00633,434688
11744,radtraveller1,1,0.00023,91313,21.00656,434688
11745,radva,1,0.00023,91314,21.00679,434688
11746,rafaelaazevedo,1,0.00023,91315,21.00702,434688
11747,rafaelargenta-quanto,1,0.00023,91316,21.00725,434688
11748,rafaelfbs,1,0.00023,91317,21.00748,434688
11749,RafaelTCostella,1,0.00023,91318,21.00771,434688
11750,rafagsam,1,0.00023,91319,21.00794,434688
11751,RafalMaleska,1,0.00023,91320,21.00817,434688
11752,rageshkrishna,1,0.00023,91321,21.00840,434688
11753,rahulchandak22,1,0.00023,91322,21.00863,434688
11754,RahulGuptaNitro,1,0.00023,91323,21.00886,434688
11755,rainerschoe,1,0.00023,91324,21.00909,434688
11756,RajAdittan,1,0.00023,91325,21.00932,434688
11757,rajakshay,1,0.00023,91326,21.00955,434688
11758,rajasaur,1,0.00023,91327,21.00978,434688
11759,rajatjain1996,1,0.00023,91328,21.01001,434688
11760,Rajat-patel19,1,0.00023,91329,21.01024,434688
11761,rajeev2509,1,0.00023,91330,21.01047,434688
11762,rajendragosavi,1,0.00023,91331,21.01070,434688
11763,rajesh545862,1,0.00023,91332,21.01093,434688
11764,Rajith90,1,0.00023,91333,21.01116,434688
11765,rajmohanram,1,0.00023,91334,21.01139,434688
11766,Raj-Popat,1,0.00023,91335,21.01162,434688
11767,raju-lv,1,0.00023,91336,21.01185,434688
11768,rakeshgm,1,0.00023,91337,21.01208,434688
11769,ralbon,1,0.00023,91338,21.01231,434688
11770,ralphabouhaidar,1,0.00023,91339,21.01254,434688
11771,Rambatino,1,0.00023,91340,21.01277,434688
11772,ramdhakne,1,0.00023,91341,21.01300,434688
11773,ramih-saferide,1,0.00023,91342,21.01323,434688
11774,ramkumarmrk,1,0.00023,91343,21.01346,434688
11775,ramrajgupta1988,1,0.00023,91344,21.01369,434688
11776,rams3sh,1,0.00023,91345,21.01392,434688
11777,ramwissen,1,0.00023,91346,21.01415,434688
11778,Rancheroo,1,0.00023,91347,21.01438,434688
11779,randomvoids,1,0.00023,91348,21.01461,434688
11780,rangercyh,1,0.00023,91349,21.01484,434688
11781,ranjb,1,0.00023,91350,21.01507,434688
11782,ranjithcheguri,1,0.00023,91351,21.01530,434688
11783,rapgru,1,0.00023,91352,21.01553,434688
11784,raphox,1,0.00023,91353,21.01576,434688
11785,Rapiz1,1,0.00023,91354,21.01599,434688
11786,raptium,1,0.00023,91355,21.01622,434688
11787,rasapala,1,0.00023,91356,21.01645,434688
11788,rashad-farajullayev,1,0.00023,91357,21.01668,434688
11789,Ratuchetp,1,0.00023,91358,21.01691,434688
11790,raviatmaryh,1,0.00023,91359,21.01714,434688
11791,rawinng,1,0.00023,91360,21.01737,434688
11792,Ray-Eldath,1,0.00023,91361,21.01760,434688
11793,rayfordj,1,0.00023,91362,21.01783,434688
11794,RayHuangCN,1,0.00023,91363,21.01806,434688
11795,Raykuo,1,0.00023,91364,21.01829,434688
11796,raymondsze,1,0.00023,91365,21.01852,434688
11797,RayMountaineer,1,0.00023,91366,21.01875,434688
11798,raz3k,1,0.00023,91367,21.01898,434688
11799,razdenand,1,0.00023,91368,21.01921,434688
11800,razvan,1,0.00023,91369,21.01944,434688
11801,rbalaraman-c,1,0.00023,91370,21.01967,434688
11802,rbaybutt,1,0.00023,91371,21.01990,434688
11803,rbelfils,1,0.00023,91372,21.02013,434688
11804,rbenzair,1,0.00023,91373,21.02036,434688
11805,rbizos,1,0.00023,91374,21.02059,434688
11806,rbjorklin,1,0.00023,91375,21.02082,434688
11807,rbrondgeest,1,0.00023,91376,21.02105,434688
11808,rchrd,1,0.00023,91377,21.02128,434688
11809,rcmelendez,1,0.00023,91378,21.02151,434688
11810,r-daysleeper,1,0.00023,91379,21.02174,434688
11811,rdk31,1,0.00023,91380,21.02197,434688
11812,readyready15728,1,0.00023,91381,21.02220,434688
11813,realksj,1,0.00023,91382,21.02243,434688
11814,realSchoki,1,0.00023,91383,21.02266,434688
11815,realthered,1,0.00023,91384,21.02289,434688
11816,realvictorprm,1,0.00023,91385,21.02312,434688
11817,realwoobinlee,1,0.00023,91386,21.02335,434688
11818,reatang,1,0.00023,91387,21.02358,434688
11819,reckless-huang,1,0.00023,91388,21.02381,434688
11820,reda-sj,1,0.00023,91389,21.02404,434688
11821,red-lichtie,1,0.00023,91390,21.02427,434688
11822,reegeek,1,0.00023,91391,21.02450,434688
11823,reesericci,1,0.00023,91392,21.02473,434688
11824,ReeSilva,1,0.00023,91393,21.02497,434688
11825,reicheltp,1,0.00023,91394,21.02520,434688
11826,reimda,1,0.00023,91395,21.02543,434688
11827,reinoudk,1,0.00023,91396,21.02566,434688
11828,reitzig,1,0.00023,91397,21.02589,434688
11829,rekhachougule,1,0.00023,91398,21.02612,434688
11830,relovely,1,0.00023,91399,21.02635,434688
11831,remixtj,1,0.00023,91400,21.02658,434688
11832,remkolems,1,0.00023,91401,21.02681,434688
11833,renana,1,0.00023,91402,21.02704,434688
11834,ReneGa,1,0.00023,91403,21.02727,434688
11835,renegaderyu,1,0.00023,91404,21.02750,434688
11836,resec,1,0.00023,91405,21.02773,434688
11837,reshmahulagur,1,0.00023,91406,21.02796,434688
11838,resulyrt93,1,0.00023,91407,21.02819,434688
11839,ReubenMathew,1,0.00023,91408,21.02842,434688
11840,rexhsu1968,1,0.00023,91409,21.02865,434688
11841,reynaldliu,1,0.00023,91410,21.02888,434688
11842,reza-curtmola,1,0.00023,91411,21.02911,434688
11843,rfgunion,1,0.00023,91412,21.02934,434688
11844,rgonzlz,1,0.00023,91413,21.02957,434688
11845,rHermes,1,0.00023,91414,21.02980,434688
11846,rhowe,1,0.00023,91415,21.03003,434688
11847,rhtyd,1,0.00023,91416,21.03026,434688
11848,rhysjtevans,1,0.00023,91417,21.03049,434688
11849,Ri1a,1,0.00023,91418,21.03072,434688
11850,ricardbejarano,1,0.00023,91419,21.03095,434688
11851,RicardsRikmanis,1,0.00023,91420,21.03118,434688
11852,ricfeatherstone,1,0.00023,91421,21.03141,434688
11853,Richard1ybb,1,0.00023,91422,21.03164,434688
11854,richardfelkl,1,0.00023,91423,21.03187,434688
11855,richardmcsong,1,0.00023,91424,21.03210,434688
11856,richardstone,1,0.00023,91425,21.03233,434688
11857,RichVanderwal,1,0.00023,91426,21.03256,434688
11858,rickardgranberg,1,0.00023,91427,21.03279,434688
11859,rickgrade3,1,0.00023,91428,21.03302,434688
11860,Rick-lee01,1,0.00023,91429,21.03325,434688
11861,ricky1265,1,0.00023,91430,21.03348,434688
11862,ride808,1,0.00023,91431,21.03371,434688
11863,rienafairefr,1,0.00023,91432,21.03394,434688
11864,rieshy,1,0.00023,91433,21.03417,434688
11865,riezebosch,1,0.00023,91434,21.03440,434688
11866,riferrei,1,0.00023,91435,21.03463,434688
11867,rifqifatih,1,0.00023,91436,21.03486,434688
11868,RiichardCC,1,0.00023,91437,21.03509,434688
11869,rikcarve,1,0.00023,91438,21.03532,434688
11870,rimasgo,1,0.00023,91439,21.03555,434688
11871,Rina-Y,1,0.00023,91440,21.03578,434688
11872,Ring2381,1,0.00023,91441,21.03601,434688
11873,Riohyc,1,0.00023,91442,21.03624,434688
11874,rishabh-shah12,1,0.00023,91443,21.03647,434688
11875,RishiRavikumar,1,0.00023,91444,21.03670,434688
11876,riss-blake,1,0.00023,91445,21.03693,434688
11877,riteshvado,1,0.00023,91446,21.03716,434688
11878,ritwik-gopi,1,0.00023,91447,21.03739,434688
11879,riveryc,1,0.00023,91448,21.03762,434688
11880,RixTmobilender,1,0.00023,91449,21.03785,434688
11881,RiyaGupta89,1,0.00023,91450,21.03808,434688
11882,Riyazghub,1,0.00023,91451,21.03831,434688
11883,rjb4standards,1,0.00023,91452,21.03854,434688
11884,rjoly-qlik,1,0.00023,91453,21.03877,434688
11885,rjosephwright,1,0.00023,91454,21.03900,434688
11886,rjshk013,1,0.00023,91455,21.03923,434688
11887,rkbalgi,1,0.00023,91456,21.03946,434688
11888,r-kells,1,0.00023,91457,21.03969,434688
11889,rkennedy-tpl,1,0.00023,91458,21.03992,434688
11890,rkhudov,1,0.00023,91459,21.04015,434688
11891,rkitindi,1,0.00023,91460,21.04038,434688
11892,rkr-kununu,1,0.00023,91461,21.04061,434688
11893,rkul,1,0.00023,91462,21.04084,434688
11894,rkydybets,1,0.00023,91463,21.04107,434688
11895,rlandesman,1,0.00023,91464,21.04130,434688
11896,rlanting,1,0.00023,91465,21.04153,434688
11897,rlarss,1,0.00023,91466,21.04176,434688
11898,rlewkowicz-rcd,1,0.00023,91467,21.04199,434688
11899,rliskunov,1,0.00023,91468,21.04222,434688
11900,rmccarthy-ellevation,1,0.00023,91469,21.04245,434688
11901,rmclemente,1,0.00023,91470,21.04268,434688
11902,rmetcalf9,1,0.00023,91471,21.04291,434688
11903,rmilejcz,1,0.00023,91472,21.04314,434688
11904,rmkanda,1,0.00023,91473,21.04337,434688
11905,RmMsr,1,0.00023,91474,21.04360,434688
11906,rmntrvn,1,0.00023,91475,21.04383,434688
11907,rmoesbergen,1,0.00023,91476,21.04406,434688
11908,rmosolgo,1,0.00023,91477,21.04429,434688
11909,rmr-silicom,1,0.00023,91478,21.04452,434688
11910,rnishtala,1,0.00023,91479,21.04475,434688
11911,robbie-unlikelyai,1,0.00023,91480,21.04498,434688
11912,robermar23,1,0.00023,91481,21.04521,434688
11913,RobertFr0st,1,0.00023,91482,21.04544,434688
11914,RobertLemmens,1,0.00023,91483,21.04567,434688
11915,robertorubioguardia,1,0.00023,91484,21.04590,434688
11916,Robert-turbo,1,0.00023,91485,21.04613,434688
11917,Robin-floss,1,0.00023,91486,21.04636,434688
11918,robinfoe,1,0.00023,91487,21.04659,434688
11919,robinhuiser,1,0.00023,91488,21.04682,434688
11920,RobinMcCorkell,1,0.00023,91489,21.04705,434688
11921,robinverduijn,1,0.00023,91490,21.04728,434688
11922,robin-wittler,1,0.00023,91491,21.04751,434688
11923,robkooper,1,0.00023,91492,21.04774,434688
11924,roblappcoupa,1,0.00023,91493,21.04797,434688
11925,robotrapta,1,0.00023,91494,21.04820,434688
11926,robross0606,1,0.00023,91495,21.04843,434688
11927,robsclark,1,0.00023,91496,21.04866,434688
11928,robshelly,1,0.00023,91497,21.04889,434688
11929,robszy,1,0.00023,91498,21.04912,434688
11930,robtayl0r,1,0.00023,91499,21.04935,434688
11931,rockerhieu,1,0.00023,91500,21.04958,434688
11932,rockhowse,1,0.00023,91501,21.04981,434688
11933,rodoufu,1,0.00023,91502,21.05004,434688
11934,rodrigorras,1,0.00023,91503,21.05027,434688
11935,rodrigoscna,1,0.00023,91504,21.05050,434688
11936,RoesWibowo,1,0.00023,91505,21.05073,434688
11937,rofafor,1,0.00023,91506,21.05096,434688
11938,rogerhil,1,0.00023,91507,21.05119,434688
11939,rogeriorocha,1,0.00023,91508,21.05142,434688
11940,RogerParkinson,1,0.00023,91509,21.05165,434688
11941,rohitdumbre86,1,0.00023,91510,21.05188,434688
11942,rohith-mr-rao,1,0.00023,91511,21.05211,434688
11943,rohitsakala,1,0.00023,91512,21.05234,434688
11944,Roia5,1,0.00023,91513,21.05257,434688
11945,rolandsaven,1,0.00023,91514,21.05280,434688
11946,Roman513,1,0.00023,91515,21.05303,434688
11947,RomanBats,1,0.00023,91516,21.05326,434688
11948,romanchi12,1,0.00023,91517,21.05349,434688
11949,romanpanov993,1,0.00023,91518,21.05372,434688
11950,roman-parkhunovskyi-sp,1,0.00023,91519,21.05395,434688
11951,romdum,1,0.00023,91520,21.05418,434688
11952,romellfudi,1,0.00023,91521,21.05441,434688
11953,romfreiman,1,0.00023,91522,21.05464,434688
11954,ron1,1,0.00023,91523,21.05487,434688
11955,ronald,1,0.00023,91524,21.05510,434688
11956,Ronanb3,1,0.00023,91525,21.05533,434688
11957,ronengloat,1,0.00023,91526,21.05556,434688
11958,RonZhang724,1,0.00023,91527,21.05579,434688
11959,roropoh,1,0.00023,91528,21.05602,434688
11960,roscioli,1,0.00023,91529,21.05625,434688
11961,rossi-fi,1,0.00023,91530,21.05648,434688
11962,Rotonen,1,0.00023,91531,21.05671,434688
11963,rottenbytes,1,0.00023,91532,21.05694,434688
11964,rotty3000,1,0.00023,91533,21.05717,434688
11965,rounakpr,1,0.00023,91534,21.05740,434688
11966,Royal0302,1,0.00023,91535,21.05763,434688
11967,roytmanpiccoli,1,0.00023,91536,21.05786,434688
11968,rpasche,1,0.00023,91537,21.05809,434688
11969,rponcegarcia,1,0.00023,91538,21.05832,434688
11970,rpthms,1,0.00023,91539,21.05855,434688
11971,rpuserh,1,0.00023,91540,21.05878,434688
11972,rr0214,1,0.00023,91541,21.05901,434688
11973,rra,1,0.00023,91542,21.05924,434688
11974,rraisal,1,0.00023,91543,21.05947,434688
11975,rrondeau,1,0.00023,91544,21.05970,434688
11976,rrraaa1,1,0.00023,91545,21.05993,434688
11977,rsandwick,1,0.00023,91546,21.06016,434688
11978,rsanluis,1,0.00023,91547,21.06039,434688
11979,rseedorff,1,0.00023,91548,21.06062,434688
11980,rsitavares,1,0.00023,91549,21.06085,434688
11981,rslowe,1,0.00023,91550,21.06108,434688
11982,RSoodAMAT,1,0.00023,91551,21.06131,434688
11983,rstoermer,1,0.00023,91552,21.06154,434688
11984,rtttech,1,0.00023,91553,21.06177,434688
11985,ruanyulin2017,1,0.00023,91554,21.06200,434688
11986,rubans,1,0.00023,91555,21.06223,434688
11987,rubensyltek,1,0.00023,91556,21.06246,434688
11988,rubin55,1,0.00023,91557,21.06269,434688
11989,ruckc,1,0.00023,91558,21.06292,434688
11990,rudiheydra,1,0.00023,91559,21.06315,434688
11991,rudo-thomas,1,0.00023,91560,21.06338,434688
11992,rudrakhp,1,0.00023,91561,21.06361,434688
11993,ruffrey,1,0.00023,91562,21.06384,434688
11994,rugalcrimson,1,0.00023,91563,21.06407,434688
11995,ruici-hong,1,0.00023,91564,21.06430,434688
11996,rukundob451,1,0.00023,91565,21.06453,434688
11997,RumRogerz,1,0.00023,91566,21.06476,434688
11998,rundeks,1,0.00023,91567,21.06499,434688
11999,RunDevelopment,1,0.00023,91568,21.06522,434688
12000,runzhen,1,0.00023,91569,21.06545,434688
12001,ruruiye,1,0.00023,91570,21.06568,434688
12002,RusDenS,1,0.00023,91571,21.06591,434688
12003,rustlingwind,1,0.00023,91572,21.06614,434688
12004,rustrial,1,0.00023,91573,21.06637,434688
12005,rusucosmin,1,0.00023,91574,21.06660,434688
12006,rvanderp3,1,0.00023,91575,21.06683,434688
12007,rvishwas,1,0.00023,91576,21.06706,434688
12008,rwin-novo,1,0.00023,91577,21.06729,434688
12009,ryan-a-baker,1,0.00023,91578,21.06752,434688
12010,ryanberckmans,1,0.00023,91579,21.06775,434688
12011,ryan-dayrit,1,0.00023,91580,21.06798,434688
12012,ryandens,1,0.00023,91581,21.06821,434688
12013,ryanfakir,1,0.00023,91582,21.06844,434688
12014,ryan-hanchett,1,0.00023,91583,21.06867,434688
12015,ryanjwh,1,0.00023,91584,21.06890,434688
12016,ryanm101,1,0.00023,91585,21.06913,434688
12017,ryanmvazquez,1,0.00023,91586,21.06936,434688
12018,ryanpbrewster,1,0.00023,91587,21.06959,434688
12019,ryantiger658,1,0.00023,91588,21.06982,434688
12020,Ryukn219,1,0.00023,91589,21.07005,434688
12021,ryunchang,1,0.00023,91590,21.07028,434688
12022,rzmudatr,1,0.00023,91591,21.07051,434688
12023,rzyeleven,1,0.00023,91592,21.07074,434688
12024,Saad-Hussain1,1,0.00023,91593,21.07098,434688
12025,sabady,1,0.00023,91594,21.07121,434688
12026,sabattle,1,0.00023,91595,21.07144,434688
12027,sabdhagiri,1,0.00023,91596,21.07167,434688
12028,sachincalsoft-dev,1,0.00023,91597,21.07190,434688
12029,SachinKut,1,0.00023,91598,21.07213,434688
12030,sadavarterohit,1,0.00023,91599,21.07236,434688
12031,Sadiquedeveloper,1,0.00023,91600,21.07259,434688
12032,SadmiB,1,0.00023,91601,21.07282,434688
12033,safarishane,1,0.00023,91602,21.07305,434688
12034,SafaTinaztepe,1,0.00023,91603,21.07328,434688
12035,safredAAs,1,0.00023,91604,21.07351,434688
12036,safronovD,1,0.00023,91605,21.07374,434688
12037,sagarkal,1,0.00023,91606,21.07397,434688
12038,sagarkundral24,1,0.00023,91607,21.07420,434688
12039,sagarpatil23192,1,0.00023,91608,21.07443,434688
12040,sagarshrestha24,1,0.00023,91609,21.07466,434688
12041,saggar,1,0.00023,91610,21.07489,434688
12042,sah2ed,1,0.00023,91611,21.07512,434688
12043,sahejsingh,1,0.00023,91612,21.07535,434688
12044,sahilmalav,1,0.00023,91613,21.07558,434688
12045,sahsz123,1,0.00023,91614,21.07581,434688
12046,saibaldey,1,0.00023,91615,21.07604,434688
12047,saikarthikp9,1,0.00023,91616,21.07627,434688
12048,sai-kolluru,1,0.00023,91617,21.07650,434688
12049,saimanoj01,1,0.00023,91618,21.07673,434688
12050,saimonn,1,0.00023,91619,21.07696,434688
12051,sairamkollati,1,0.00023,91620,21.07719,434688
12052,saitoy1,1,0.00023,91621,21.07742,434688
12053,Sajotim,1,0.00023,91622,21.07765,434688
12054,sakomws,1,0.00023,91623,21.07788,434688
12055,salanhess,1,0.00023,91624,21.07811,434688
12056,salmank85,1,0.00023,91625,21.07834,434688
12057,salmanksears,1,0.00023,91626,21.07857,434688
12058,saltbo,1,0.00023,91627,21.07880,434688
12059,salzig,1,0.00023,91628,21.07903,434688
12060,SamBarker,1,0.00023,91629,21.07926,434688
12061,sambercovici,1,0.00023,91630,21.07949,434688
12062,samcday,1,0.00023,91631,21.07972,434688
12063,samhopwell,1,0.00023,91632,21.07995,434688
12064,Sami1309,1,0.00023,91633,21.08018,434688
12065,samifruit514,1,0.00023,91634,21.08041,434688
12066,SamirNabadov,1,0.00023,91635,21.08064,434688
12067,Sam-Lin-MillersLab,1,0.00023,91636,21.08087,434688
12068,sampaiodiego,1,0.00023,91637,21.08110,434688
12069,samrogers226,1,0.00023,91638,21.08133,434688
12070,samsrivastava,1,0.00023,91639,21.08156,434688
12071,samturton2,1,0.00023,91640,21.08179,434688
12072,samuaz,1,0.00023,91641,21.08202,434688
12073,samuelnoguchi,1,0.00023,91642,21.08225,434688
12074,Samuron,1,0.00023,91643,21.08248,434688
12075,sanarvaez,1,0.00023,91644,21.08271,434688
12076,Sanchit-20,1,0.00023,91645,21.08294,434688
12077,sandboxws,1,0.00023,91646,21.08317,434688
12078,sandeeplenka,1,0.00023,91647,21.08340,434688
12079,sandeep-robin,1,0.00023,91648,21.08363,434688
12080,SandraPAM,1,0.00023,91649,21.08386,434688
12081,sandy2008,1,0.00023,91650,21.08409,434688
12082,SangameswaranRS,1,0.00023,91651,21.08432,434688
12083,Sangshaai,1,0.00023,91652,21.08455,434688
12084,sanguis,1,0.00023,91653,21.08478,434688
12085,SanjayVas,1,0.00023,91654,21.08501,434688
12086,sanjbane,1,0.00023,91655,21.08524,434688
12087,SanjoDeundiak,1,0.00023,91656,21.08547,434688
12088,sanketrk,1,0.00023,91657,21.08570,434688
12089,SansDK,1,0.00023,91658,21.08593,434688
12090,santi-alvarez,1,0.00023,91659,21.08616,434688
12091,santisaez,1,0.00023,91660,21.08639,434688
12092,santoshverma608,1,0.00023,91661,21.08662,434688
12093,sanzende,1,0.00023,91662,21.08685,434688
12094,sapna-dentsu,1,0.00023,91663,21.08708,434688
12095,sappo,1,0.00023,91664,21.08731,434688
12096,saran001,1,0.00023,91665,21.08754,434688
12097,sarath-01,1,0.00023,91666,21.08777,434688
12098,SarathKumar-k,1,0.00023,91667,21.08800,434688
12099,saravanan19,1,0.00023,91668,21.08823,434688
12100,sarbian,1,0.00023,91669,21.08846,434688
12101,sarvesh-ranjan,1,0.00023,91670,21.08869,434688
12102,Sasasu,1,0.00023,91671,21.08892,434688
12103,sa-spag,1,0.00023,91672,21.08915,434688
12104,sastorsl,1,0.00023,91673,21.08938,434688
12105,sathish-kumar-narayanan,1,0.00023,91674,21.08961,434688
12106,sathyendrasaran,1,0.00023,91675,21.08984,434688
12107,satishweb,1,0.00023,91676,21.09007,434688
12108,sattsb,1,0.00023,91677,21.09030,434688
12109,satyavank1988,1,0.00023,91678,21.09053,434688
12110,sauhrabh,1,0.00023,91679,21.09076,434688
12111,saulobejo,1,0.00023,91680,21.09099,434688
12112,saurabh3796,1,0.00023,91681,21.09122,434688
12113,SaurabhGh-learn,1,0.00023,91682,21.09145,434688
12114,saurabrana,1,0.00023,91683,21.09168,434688
12115,saurav28,1,0.00023,91684,21.09191,434688
12116,sayalimohdikar1992,1,0.00023,91685,21.09214,434688
12117,sayf-eddine-scality,1,0.00023,91686,21.09237,434688
12118,Saykar,1,0.00023,91687,21.09260,434688
12119,sazzle2611,1,0.00023,91688,21.09283,434688
12120,sbienkow-ninja,1,0.00023,91689,21.09306,434688
12121,sbjetty,1,0.00023,91690,21.09329,434688
12122,sbkg0002,1,0.00023,91691,21.09352,434688
12123,sbogdanchuk,1,0.00023,91692,21.09375,434688
12124,S-Bohn,1,0.00023,91693,21.09398,434688
12125,sboobna,1,0.00023,91694,21.09421,434688
12126,sbreingan,1,0.00023,91695,21.09444,434688
12127,sc0ttbeardsley,1,0.00023,91696,21.09467,434688
12128,Scanz-beep,1,0.00023,91697,21.09490,434688
12129,scbunn-avalara,1,0.00023,91698,21.09513,434688
12130,sc-chad,1,0.00023,91699,21.09536,434688
12131,scepeda78,1,0.00023,91700,21.09559,434688
12132,schans,1,0.00023,91701,21.09582,434688
12133,schen2315,1,0.00023,91702,21.09605,434688
12134,Schille,1,0.00023,91703,21.09628,434688
12135,schlomo,1,0.00023,91704,21.09651,434688
12136,schmikei,1,0.00023,91705,21.09674,434688
12137,schwichti,1,0.00023,91706,21.09697,434688
12138,scMarkus,1,0.00023,91707,21.09720,434688
12139,scratchmex,1,0.00023,91708,21.09743,434688
12140,sct10876,1,0.00023,91709,21.09766,434688
12141,sd2020bs,1,0.00023,91710,21.09789,434688
12142,sdfordham,1,0.00023,91711,21.09812,434688
12143,sdickhoven,1,0.00023,91712,21.09835,434688
12144,sdmichelini,1,0.00023,91713,21.09858,434688
12145,sdvdxl,1,0.00023,91714,21.09881,434688
12146,seaiiok,1,0.00023,91715,21.09904,434688
12147,seancarroll,1,0.00023,91716,21.09927,434688
12148,SEANDDDDDD,1,0.00023,91717,21.09950,434688
12149,seankhliao,1,0.00023,91718,21.09973,434688
12150,seanlowcy77,1,0.00023,91719,21.09996,434688
12151,seanly,1,0.00023,91720,21.10019,434688
12152,Seann-Moser,1,0.00023,91721,21.10042,434688
12153,seanodea,1,0.00023,91722,21.10065,434688
12154,seanpianka,1,0.00023,91723,21.10088,434688
12155,sean-zou,1,0.00023,91724,21.10111,434688
12156,sebastian-curland,1,0.00023,91725,21.10134,434688
12157,SebastianGau,1,0.00023,91726,21.10157,434688
12158,sebastien-rosset,1,0.00023,91727,21.10180,434688
12159,sebnow,1,0.00023,91728,21.10203,434688
12160,SecLoop,1,0.00023,91729,21.10226,434688
12161,sedadas,1,0.00023,91730,21.10249,434688
12162,sed-i,1,0.00023,91731,21.10272,434688
12163,sedlund,1,0.00023,91732,21.10295,434688
12164,Segflow,1,0.00023,91733,21.10318,434688
12165,seg-lol,1,0.00023,91734,21.10341,434688
12166,sehrgut,1,0.00023,91735,21.10364,434688
12167,sejo412,1,0.00023,91736,21.10387,434688
12168,sekinet,1,0.00023,91737,21.10410,434688
12169,SekretOne,1,0.00023,91738,21.10433,434688
12170,selcuk-cofe,1,0.00023,91739,21.10456,434688
12171,selek55,1,0.00023,91740,21.10479,434688
12172,seljmov,1,0.00023,91741,21.10502,434688
12173,selste,1,0.00023,91742,21.10525,434688
12174,SemanticBeeng,1,0.00023,91743,21.10548,434688
12175,semos2k,1,0.00023,91744,21.10571,434688
12176,senalkularatne,1,0.00023,91745,21.10594,434688
12177,senior88oqz,1,0.00023,91746,21.10617,434688
12178,SeongJuMoon,1,0.00023,91747,21.10640,434688
12179,septatrix,1,0.00023,91748,21.10663,434688
12180,seraphico,1,0.00023,91749,21.10686,434688
12181,serega6531,1,0.00023,91750,21.10709,434688
12182,serewicz,1,0.00023,91751,21.10732,434688
12183,sergebasso,1,0.00023,91752,21.10755,434688
12184,SergeyHydra,1,0.00023,91753,21.10778,434688
12185,Sergii-Burtovyi,1,0.00023,91754,21.10801,434688
12186,sergiomanso,1,0.00023,91755,21.10824,434688
12187,SeriyBg,1,0.00023,91756,21.10847,434688
12188,serjteplov,1,0.00023,91757,21.10870,434688
12189,sersanherr,1,0.00023,91758,21.10893,434688
12190,servens,1,0.00023,91759,21.10916,434688
12191,setiadeepanshu01,1,0.00023,91760,21.10939,434688
12192,seveas,1,0.00023,91761,21.10962,434688
12193,SeVeNDuS,1,0.00023,91762,21.10985,434688
12194,sevenval-admins,1,0.00023,91763,21.11008,434688
12195,sevetseh28,1,0.00023,91764,21.11031,434688
12196,sfc-gh-cxu,1,0.00023,91765,21.11054,434688
12197,sford,1,0.00023,91766,21.11077,434688
12198,sfrank-mc,1,0.00023,91767,21.11100,434688
12199,SGStino,1,0.00023,91768,21.11123,434688
12200,sgtang,1,0.00023,91769,21.11146,434688
12201,sguidos,1,0.00023,91770,21.11169,434688
12202,sgulci,1,0.00023,91771,21.11192,434688
12203,sh3llf1sh,1,0.00023,91772,21.11215,434688
12204,Shabirmean,1,0.00023,91773,21.11238,434688
12205,shafeeqes,1,0.00023,91774,21.11261,434688
12206,shahar-h,1,0.00023,91775,21.11284,434688
12207,shahidv3,1,0.00023,91776,21.11307,434688
12208,ShaileshKumar007,1,0.00023,91777,21.11330,434688
12209,shakaluu,1,0.00023,91778,21.11353,434688
12210,shakhal,1,0.00023,91779,21.11376,434688
12211,shaktiprasadrath,1,0.00023,91780,21.11399,434688
12212,shakuzen,1,0.00023,91781,21.11422,434688
12213,shalevutnik,1,0.00023,91782,21.11445,434688
12214,shalver,1,0.00023,91783,21.11468,434688
12215,shamartor,1,0.00023,91784,21.11491,434688
12216,Shamsherocode,1,0.00023,91785,21.11514,434688
12217,Shanduur,1,0.00023,91786,21.11537,434688
12218,shanefay422,1,0.00023,91787,21.11560,434688
12219,shaneing,1,0.00023,91788,21.11583,434688
12220,shanishmohan,1,0.00023,91789,21.11606,434688
12221,shanproofpoint,1,0.00023,91790,21.11629,434688
12222,shantanugadgil,1,0.00023,91791,21.11652,434688
12223,shaobo76,1,0.00023,91792,21.11676,434688
12224,sharafcmr,1,0.00023,91793,21.11699,434688
12225,sharathfeb12,1,0.00023,91794,21.11722,434688
12226,sharmavijay1991,1,0.00023,91795,21.11745,434688
12227,sharonngetich,1,0.00023,91796,21.11768,434688
12228,Sharsie,1,0.00023,91797,21.11791,434688
12229,Shashankft9,1,0.00023,91798,21.11814,434688
12230,ShashankGirish,1,0.00023,91799,21.11837,434688
12231,shashijais789,1,0.00023,91800,21.11860,434688
12232,shashikdm,1,0.00023,91801,21.11883,434688
12233,Shavee2209,1,0.00023,91802,21.11906,434688
12234,Shawnyeungcf,1,0.00023,91803,21.11929,434688
12235,shawon100,1,0.00023,91804,21.11952,434688
12236,shazada,1,0.00023,91805,21.11975,434688
12237,shdvgj,1,0.00023,91806,21.11998,434688
12238,sheepdragon,1,0.00023,91807,21.12021,434688
12239,SheilaM1,1,0.00023,91808,21.12044,434688
12240,shelimingming,1,0.00023,91809,21.12067,434688
12241,ShellyKatz,1,0.00023,91810,21.12090,434688
12242,shemlar,1,0.00023,91811,21.12113,434688
12243,shengzhou1216,1,0.00023,91812,21.12136,434688
12244,shenqidebaozi,1,0.00023,91813,21.12159,434688
12245,shenwxopen,1,0.00023,91814,21.12182,434688
12246,ShethR,1,0.00023,91815,21.12205,434688
12247,shib1000,1,0.00023,91816,21.12228,434688
12248,shibd,1,0.00023,91817,21.12251,434688
12249,shiji-naoki,1,0.00023,91818,21.12274,434688
12250,shikanon,1,0.00023,91819,21.12297,434688
12251,shine-fire,1,0.00023,91820,21.12320,434688
12252,shineshane,1,0.00023,91821,21.12343,434688
12253,shinfan,1,0.00023,91822,21.12366,434688
12254,shingshing222,1,0.00023,91823,21.12389,434688
12255,shirama1212,1,0.00023,91824,21.12412,434688
12256,Shivkumar13,1,0.00023,91825,21.12435,434688
12257,shiwano,1,0.00023,91826,21.12458,434688
12258,shiyunjin,1,0.00023,91827,21.12481,434688
12259,shmilyhome,1,0.00023,91828,21.12504,434688
12260,shoaibjdev,1,0.00023,91829,21.12527,434688
12261,shobishani,1,0.00023,91830,21.12550,434688
12262,shoce,1,0.00023,91831,21.12573,434688
12263,shomeprasanjit,1,0.00023,91832,21.12596,434688
12264,shpalasara,1,0.00023,91833,21.12619,434688
12265,shraderdm,1,0.00023,91834,21.12642,434688
12266,shree007,1,0.00023,91835,21.12665,434688
12267,shreyansh2809,1,0.00023,91836,21.12688,434688
12268,shrivastavshubham34,1,0.00023,91837,21.12711,434688
12269,shuaigemarui,1,0.00023,91838,21.12734,434688
12270,shuaiming,1,0.00023,91839,21.12757,434688
12271,Shubham2900,1,0.00023,91840,21.12780,434688
12272,S-Hurion,1,0.00023,91841,21.12803,434688
12273,shwetanaganath,1,0.00023,91842,21.12826,434688
12274,shwetanshu-cldcvr,1,0.00023,91843,21.12849,434688
12275,siansiansu,1,0.00023,91844,21.12872,434688
12276,siarhei-karanets-epam,1,0.00023,91845,21.12895,434688
12277,SickoOrange,1,0.00023,91846,21.12918,434688
12278,sid226,1,0.00023,91847,21.12941,434688
12279,sidboy55555,1,0.00023,91848,21.12964,434688
12280,siddharthmak,1,0.00023,91849,21.12987,434688
12281,siddharth-mitra,1,0.00023,91850,21.13010,434688
12282,sidsj,1,0.00023,91851,21.13033,434688
12283,siebenmann,1,0.00023,91852,21.13056,434688
12284,siebertm,1,0.00023,91853,21.13079,434688
12285,sigi4,1,0.00023,91854,21.13102,434688
12286,SihYingChen,1,0.00023,91855,21.13125,434688
12287,silaing,1,0.00023,91856,21.13148,434688
12288,silvajp2,1,0.00023,91857,21.13171,434688
12289,simar7,1,0.00023,91858,21.13194,434688
12290,simonaTsenova,1,0.00023,91859,21.13217,434688
12291,SimonCqk,1,0.00023,91860,21.13240,434688
12292,SimonePomata,1,0.00023,91861,21.13263,434688
12293,SimonHarrisonSH,1,0.00023,91862,21.13286,434688
12294,simonhou,1,0.00023,91863,21.13309,434688
12295,SimonKienzler,1,0.00023,91864,21.13332,434688
12296,simonlsk,1,0.00023,91865,21.13355,434688
12297,simonwh,1,0.00023,91866,21.13378,434688
12298,Simoyd,1,0.00023,91867,21.13401,434688
12299,SimplicityGuy,1,0.00023,91868,21.13424,434688
12300,simplymihir,1,0.00023,91869,21.13447,434688
12301,sim-wangyan,1,0.00023,91870,21.13470,434688
12302,singaravelanIngka,1,0.00023,91871,21.13493,434688
12303,singhalok00188,1,0.00023,91872,21.13516,434688
12304,singhbalr,1,0.00023,91873,21.13539,434688
12305,singholt,1,0.00023,91874,21.13562,434688
12306,SinisterLight,1,0.00023,91875,21.13585,434688
12307,sinlang,1,0.00023,91876,21.13608,434688
12308,SinLess-Games,1,0.00023,91877,21.13631,434688
12309,sipmchimp,1,0.00023,91878,21.13654,434688
12310,sir-farfan,1,0.00023,91879,21.13677,434688
12311,sir-gon,1,0.00023,91880,21.13700,434688
12312,sirkrypt0,1,0.00023,91881,21.13723,434688
12313,SirZeck,1,0.00023,91882,21.13746,434688
12314,SISheogorath,1,0.00023,91883,21.13769,434688
12315,sithukyaw007,1,0.00023,91884,21.13792,434688
12316,SivaBharahi,1,0.00023,91885,21.13815,434688
12317,Sixstix,1,0.00023,91886,21.13838,434688
12318,sj,1,0.00023,91887,21.13861,434688
12319,sjansen1,1,0.00023,91888,21.13884,434688
12320,sjentzsch,1,0.00023,91889,21.13907,434688
12321,sjmittal,1,0.00023,91890,21.13930,434688
12322,sjohnsonaz,1,0.00023,91891,21.13953,434688
12323,Sjolus,1,0.00023,91892,21.13976,434688
12324,skamchiline,1,0.00023,91893,21.13999,434688
12325,skant7,1,0.00023,91894,21.14022,434688
12326,skdas2016,1,0.00023,91895,21.14045,434688
12327,skgandikota,1,0.00023,91896,21.14068,434688
12328,skrech,1,0.00023,91897,21.14091,434688
12329,skrobul,1,0.00023,91898,21.14114,434688
12330,SkrPaoWang,1,0.00023,91899,21.14137,434688
12331,skslacker,1,0.00023,91900,21.14160,434688
12332,skudriavtsev,1,0.00023,91901,21.14183,434688
12333,skuethe,1,0.00023,91902,21.14206,434688
12334,sky-amoncadot,1,0.00023,91903,21.14229,434688
12335,sl805,1,0.00023,91904,21.14252,434688
12336,slabko,1,0.00023,91905,21.14275,434688
12337,slaecker,1,0.00023,91906,21.14298,434688
12338,slayer,1,0.00023,91907,21.14321,434688
12339,Slezhuk,1,0.00023,91908,21.14344,434688
12340,slimamari,1,0.00023,91909,21.14367,434688
12341,slonopotamus,1,0.00023,91910,21.14390,434688
12342,slott56,1,0.00023,91911,21.14413,434688
12343,slukianets,1,0.00023,91912,21.14436,434688
12344,smallnest,1,0.00023,91913,21.14459,434688
12345,smarunich,1,0.00023,91914,21.14482,434688
12346,smerschjohann,1,0.00023,91915,21.14505,434688
12347,smijolovic,1,0.00023,91916,21.14528,434688
12348,SmileyJames,1,0.00023,91917,21.14551,434688
12349,smitjainsj,1,0.00023,91918,21.14574,434688
12350,smoogle,1,0.00023,91919,21.14597,434688
12351,smrutiranjantripathy,1,0.00023,91920,21.14620,434688
12352,SmrutiSikha,1,0.00023,91921,21.14643,434688
12353,smthpickboy,1,0.00023,91922,21.14666,434688
12354,smuda,1,0.00023,91923,21.14689,434688
12355,smueller18,1,0.00023,91924,21.14712,434688
12356,smyrman,1,0.00023,91925,21.14735,434688
12357,smythie86,1,0.00023,91926,21.14758,434688
12358,snahelou,1,0.00023,91927,21.14781,434688
12359,snakecharmer,1,0.00023,91928,21.14804,434688
12360,snaker95,1,0.00023,91929,21.14827,434688
12361,snasovich,1,0.00023,91930,21.14850,434688
12362,snd3r,1,0.00023,91931,21.14873,434688
12363,sndrr,1,0.00023,91932,21.14896,434688
12364,snehachavan50,1,0.00023,91933,21.14919,434688
12365,snoe925,1,0.00023,91934,21.14942,434688
12366,snowwolf007cn,1,0.00023,91935,21.14965,434688
12367,snsyzf,1,0.00023,91936,21.14988,434688
12368,sober-wang,1,0.00023,91937,21.15011,434688
12369,SoerenHenning,1,0.00023,91938,21.15034,434688
12370,solarist,1,0.00023,91939,21.15057,434688
12371,solarmosaic-kflorence,1,0.00023,91940,21.15080,434688
12372,soleares,1,0.00023,91941,21.15103,434688
12373,solidDoWant,1,0.00023,91942,21.15126,434688
12374,solox174,1,0.00023,91943,21.15149,434688
12375,somdoron,1,0.00023,91944,21.15172,434688
12376,SomeshJoshi19,1,0.00023,91945,21.15195,434688
12377,some-things,1,0.00023,91946,21.15218,434688
12378,Somsubhra1,1,0.00023,91947,21.15241,434688
12379,SonalJain1707,1,0.00023,91948,21.15264,434688
12380,sondercoder,1,0.00023,91949,21.15287,434688
12381,sonicbells,1,0.00023,91950,21.15310,434688
12382,son-la,1,0.00023,91951,21.15333,434688
12383,Sooryaa-A,1,0.00023,91952,21.15356,434688
12384,sophiewigmore,1,0.00023,91953,21.15379,434688
12385,sossickd,1,0.00023,91954,21.15402,434688
12386,soumitraj,1,0.00023,91955,21.15425,434688
12387,sourav1985,1,0.00023,91956,21.15448,434688
12388,soyArturo,1,0.00023,91957,21.15471,434688
12389,spagaldipti,1,0.00023,91958,21.15494,434688
12390,Spareo,1,0.00023,91959,21.15517,434688
12391,spasumalaithevan,1,0.00023,91960,21.15540,434688
12392,spdfnet,1,0.00023,91961,21.15563,434688
12393,SpecialYang,1,0.00023,91962,21.15586,434688
12394,speedst3r,1,0.00023,91963,21.15609,434688
12395,Speissi,1,0.00023,91964,21.15632,434688
12396,Spellchaser,1,0.00023,91965,21.15655,434688
12397,spence95,1,0.00023,91966,21.15678,434688
12398,spencerwilson,1,0.00023,91967,21.15701,434688
12399,spicysomtam,1,0.00023,91968,21.15724,434688
12400,SpiderHunter9ja,1,0.00023,91969,21.15747,434688
12401,spilchen,1,0.00023,91970,21.15770,434688
12402,spire-ffoston,1,0.00023,91971,21.15793,434688
12403,spotakash,1,0.00023,91972,21.15816,434688
12404,spothound,1,0.00023,91973,21.15839,434688
12405,spowers225,1,0.00023,91974,21.15862,434688
12406,SqiSch,1,0.00023,91975,21.15885,434688
12407,SQLJames,1,0.00023,91976,21.15908,434688
12408,squakez,1,0.00023,91977,21.15931,434688
12409,sr2ds,1,0.00023,91978,21.15954,434688
12410,srbhklkrn,1,0.00023,91979,21.15977,434688
12411,srd90,1,0.00023,91980,21.16000,434688
12412,sreber84,1,0.00023,91981,21.16023,434688
12413,sreecharanmanne2000,1,0.00023,91982,21.16046,434688
12414,srikanthnutigattu-tomo,1,0.00023,91983,21.16069,434688
12415,srikanthsama1,1,0.00023,91984,21.16092,434688
12416,Srilahari9,1,0.00023,91985,21.16115,434688
12417,srimadhavan,1,0.00023,91986,21.16138,434688
12418,sringel,1,0.00023,91987,21.16161,434688
12419,Srinidhi2301,1,0.00023,91988,21.16184,434688
12420,srinivasdas007,1,0.00023,91989,21.16207,434688
12421,srosell-uz,1,0.00023,91990,21.16230,434688
12422,sruby,1,0.00023,91991,21.16253,434688
12423,ssadok,1,0.00023,91992,21.16277,434688
12424,ssharma2089,1,0.00023,91993,21.16300,434688
12425,ssidhu-apm,1,0.00023,91994,21.16323,434688
12426,s-silvius,1,0.00023,91995,21.16346,434688
12427,sssd-dev,1,0.00023,91996,21.16369,434688
12428,sstent,1,0.00023,91997,21.16392,434688
12429,ssuganth,1,0.00023,91998,21.16415,434688
12430,ssuriyan7,1,0.00023,91999,21.16438,434688
12431,stackus,1,0.00023,92000,21.16461,434688
12432,stan-sz,1,0.00023,92001,21.16484,434688
12433,starchx,1,0.00023,92002,21.16507,434688
12434,StartloJ,1,0.00023,92003,21.16530,434688
12435,Startouf,1,0.00023,92004,21.16553,434688
12436,starypatyk,1,0.00023,92005,21.16576,434688
12437,stasburstsms,1,0.00023,92006,21.16599,434688
12438,staticdev,1,0.00023,92007,21.16622,434688
12439,ST-DDT,1,0.00023,92008,21.16645,434688
12440,steebchen,1,0.00023,92009,21.16668,434688
12441,stefanandres,1,0.00023,92010,21.16691,434688
12442,stefan-caraiman,1,0.00023,92011,21.16714,434688
12443,stefan-culafic-ck,1,0.00023,92012,21.16737,434688
12444,steffeneichler,1,0.00023,92013,21.16760,434688
12445,SteffenSeckler,1,0.00023,92014,21.16783,434688
12446,steinheber,1,0.00023,92015,21.16806,434688
12447,stepanbujnak,1,0.00023,92016,21.16829,434688
12448,StephanDollberg,1,0.00023,92017,21.16852,434688
12449,stephaneeybert,1,0.00023,92018,21.16875,434688
12450,StephanSalas,1,0.00023,92019,21.16898,434688
12451,stephenkingsley,1,0.00023,92020,21.16921,434688
12452,SteRoh,1,0.00023,92021,21.16944,434688
12453,stevedesmond-ca,1,0.00023,92022,21.16967,434688
12454,stevefan1999-personal,1,0.00023,92023,21.16990,434688
12455,stevelipinski,1,0.00023,92024,21.17013,434688
12456,StevenCaswellVR,1,0.00023,92025,21.17036,434688
12457,StevenLiekens,1,0.00023,92026,21.17059,434688
12458,stevensea-r,1,0.00023,92027,21.17082,434688
12459,steveoliver,1,0.00023,92028,21.17105,434688
12460,stgrace,1,0.00023,92029,21.17128,434688
12461,sthombare,1,0.00023,92030,21.17151,434688
12462,stig,1,0.00023,92031,21.17174,434688
12463,s-titov,1,0.00023,92032,21.17197,434688
12464,stoehdoi,1,0.00023,92033,21.17220,434688
12465,stoned,1,0.00023,92034,21.17243,434688
12466,StorkZ,1,0.00023,92035,21.17266,434688
12467,str8edgedave,1,0.00023,92036,21.17289,434688
12468,strajansebastian,1,0.00023,92037,21.17312,434688
12469,stuart23,1,0.00023,92038,21.17335,434688
12470,stuart-c,1,0.00023,92039,21.17358,434688
12471,stuertz,1,0.00023,92040,21.17381,434688
12472,sturfee-petrl,1,0.00023,92041,21.17404,434688
12473,sturman,1,0.00023,92042,21.17427,434688
12474,stvnksslr,1,0.00023,92043,21.17450,434688
12475,stylius,1,0.00023,92044,21.17473,434688
12476,StymiedSloth,1,0.00023,92045,21.17496,434688
12477,subash-nayak,1,0.00023,92046,21.17519,434688
12478,subhankarpati95,1,0.00023,92047,21.17542,434688
12479,subourbonite,1,0.00023,92048,21.17565,434688
12480,Subreptivus,1,0.00023,92049,21.17588,434688
12481,suby-fastly,1,0.00023,92050,21.17611,434688
12482,subzero112233,1,0.00023,92051,21.17634,434688
12483,suconghou,1,0.00023,92052,21.17657,434688
12484,suddendust,1,0.00023,92053,21.17680,434688
12485,sudeepagarwal,1,0.00023,92054,21.17703,434688
12486,sudhay23,1,0.00023,92055,21.17726,434688
12487,sudocraft,1,0.00023,92056,21.17749,434688
12488,suguptacastlighthealth,1,0.00023,92057,21.17772,434688
12489,suharevA,1,0.00023,92058,21.17795,434688
12490,SuheylZ,1,0.00023,92059,21.17818,434688
12491,SuitableProduce,1,0.00023,92060,21.17841,434688
12492,sujanks,1,0.00023,92061,21.17864,434688
12493,sukhdevkhade,1,0.00023,92062,21.17887,434688
12494,suleimanforever,1,0.00023,92063,21.17910,434688
12495,summersculture,1,0.00023,92064,21.17933,434688
12496,sumukha1994,1,0.00023,92065,21.17956,434688
12497,Sungjun-Ohh,1,0.00023,92066,21.17979,434688
12498,sunglim,1,0.00023,92067,21.18002,434688
12499,sunhubs,1,0.00023,92068,21.18025,434688
12500,sunielm7,1,0.00023,92069,21.18048,434688
12501,sunilkrg,1,0.00023,92070,21.18071,434688
12502,sunishsurendrank,1,0.00023,92071,21.18094,434688
12503,Sunny-2772,1,0.00023,92072,21.18117,434688
12504,sunqb,1,0.00023,92073,21.18140,434688
12505,Sunrisesd,1,0.00023,92074,21.18163,434688
12506,sunyuan300,1,0.00023,92075,21.18186,434688
12507,superbiche,1,0.00023,92076,21.18209,434688
12508,supernovae,1,0.00023,92077,21.18232,434688
12509,surajtikoo,1,0.00023,92078,21.18255,434688
12510,sured77,1,0.00023,92079,21.18278,434688
12511,sureleo,1,0.00023,92080,21.18301,434688
12512,suresh8447,1,0.00023,92081,21.18324,434688
12513,SureshUppelli,1,0.00023,92082,21.18347,434688
12514,surjsingh1,1,0.00023,92083,21.18370,434688
12515,surya4crowde,1,0.00023,92084,21.18393,434688
12516,suryapandian,1,0.00023,92085,21.18416,434688
12517,susana-garcia,1,0.00023,92086,21.18439,434688
12518,suseether,1,0.00023,92087,21.18462,434688
12519,Sushant20,1,0.00023,92088,21.18485,434688
12520,sushdive,1,0.00023,92089,21.18508,434688
12521,susmitasain,1,0.00023,92090,21.18531,434688
12522,susnux,1,0.00023,92091,21.18554,434688
12523,svaranasi-traderev,1,0.00023,92092,21.18577,434688
12524,svdHero,1,0.00023,92093,21.18600,434688
12525,svudutala,1,0.00023,92094,21.18623,434688
12526,SwapnaneelChowdhury,1,0.00023,92095,21.18646,434688
12527,swapster,1,0.00023,92096,21.18669,434688
12528,SWBSanjeewa,1,0.00023,92097,21.18692,434688
12529,switchbrad,1,0.00023,92098,21.18715,434688
12530,swood,1,0.00023,92099,21.18738,434688
12531,sxddhxrthx,1,0.00023,92100,21.18761,434688
12532,syamsullivan,1,0.00023,92101,21.18784,434688
12533,sydml,1,0.00023,92102,21.18807,434688
12534,sydorovdmytro,1,0.00023,92103,21.18830,434688
12535,syedkhalandar80,1,0.00023,92104,21.18853,434688
12536,syedrakib,1,0.00023,92105,21.18876,434688
12537,symbol-z-unique,1,0.00023,92106,21.18899,434688
12538,syncer,1,0.00023,92107,21.18922,434688
12539,syncroswitch,1,0.00023,92108,21.18945,434688
12540,Syntax3rror404,1,0.00023,92109,21.18968,434688
12541,syscod3,1,0.00023,92110,21.18991,434688
12542,sysnasri,1,0.00023,92111,21.19014,434688
12543,sysreport,1,0.00023,92112,21.19037,434688
12544,szalaci,1,0.00023,92113,21.19060,434688
12545,SzautnerB,1,0.00023,92114,21.19083,434688
12546,taaafka2,1,0.00023,92115,21.19106,434688
12547,tachylatus,1,0.00023,92116,21.19129,434688
12548,tacumai,1,0.00023,92117,21.19152,434688
12549,tadman,1,0.00023,92118,21.19175,434688
12550,Tafsiralam,1,0.00023,92119,21.19198,434688
12551,taga090,1,0.00023,92120,21.19221,434688
12552,taiyang-li,1,0.00023,92121,21.19244,434688
12553,taiyyu,1,0.00023,92122,21.19267,434688
12554,takotakot,1,0.00023,92123,21.19290,434688
12555,talhof8,1,0.00023,92124,21.19313,434688
12556,tallaxes,1,0.00023,92125,21.19336,434688
12557,tanagumo,1,0.00023,92126,21.19359,434688
12558,tandel-pratik,1,0.00023,92127,21.19382,434688
12559,tandrez,1,0.00023,92128,21.19405,434688
12560,tanelikantomaa,1,0.00023,92129,21.19428,434688
12561,tangerstein,1,0.00023,92130,21.19451,434688
12562,tangjizhou,1,0.00023,92131,21.19474,434688
12563,TangRufus,1,0.00023,92132,21.19497,434688
12564,Tangtn,1,0.00023,92133,21.19520,434688
12565,tanguitar,1,0.00023,92134,21.19543,434688
12566,Tanky-Zhang,1,0.00023,92135,21.19566,434688
12567,tantweiler,1,0.00023,92136,21.19589,434688
12568,tarekesmail,1,0.00023,92137,21.19612,434688
12569,tareks,1,0.00023,92138,21.19635,434688
12570,Tarick,1,0.00023,92139,21.19658,434688
12571,tarmath,1,0.00023,92140,21.19681,434688
12572,tarrencev,1,0.00023,92141,21.19704,434688
12573,tartale,1,0.00023,92142,21.19727,434688
12574,tarun-asthana,1,0.00023,92143,21.19750,434688
12575,tarvitz,1,0.00023,92144,21.19773,434688
12576,ta-shi,1,0.00023,92145,21.19796,434688
12577,tashian,1,0.00023,92146,21.19819,434688
12578,taspac,1,0.00023,92147,21.19842,434688
12579,tatemz,1,0.00023,92148,21.19865,434688
12580,Tatsinnit,1,0.00023,92149,21.19888,434688
12581,TavaresDylan,1,0.00023,92150,21.19911,434688
12582,Tayevans77,1,0.00023,92151,21.19934,434688
12583,TaylorPzreal,1,0.00023,92152,21.19957,434688
12584,tayritenour,1,0.00023,92153,21.19980,434688
12585,tbalzer,1,0.00023,92154,21.20003,434688
12586,TCeason,1,0.00023,92155,21.20026,434688
12587,tcervi,1,0.00023,92156,21.20049,434688
12588,tcharryz,1,0.00023,92157,21.20072,434688
12589,tchartron,1,0.00023,92158,21.20095,434688
12590,tchelovilar,1,0.00023,92159,21.20118,434688
12591,TChinaBen,1,0.00023,92160,21.20141,434688
12592,tcope0094,1,0.00023,92161,21.20164,434688
12593,tczekajlo,1,0.00023,92162,21.20187,434688
12594,tdbs,1,0.00023,92163,21.20210,434688
12595,teaglebuilt,1,0.00023,92164,21.20233,434688
12596,TeamDman,1,0.00023,92165,21.20256,434688
12597,teamktown,1,0.00023,92166,21.20279,434688
12598,tech4gk,1,0.00023,92167,21.20302,434688
12599,techjacker,1,0.00023,92168,21.20325,434688
12600,technicianted,1,0.00023,92169,21.20348,434688
12601,tech-novic,1,0.00023,92170,21.20371,434688
12602,teddybdc,1,0.00023,92171,21.20394,434688
12603,tedpatrick,1,0.00023,92172,21.20417,434688
12604,tedtramonte,1,0.00023,92173,21.20440,434688
12605,tedyage,1,0.00023,92174,21.20463,434688
12606,teeohhem,1,0.00023,92175,21.20486,434688
12607,teepee123,1,0.00023,92176,21.20509,434688
12608,tehale,1,0.00023,92177,21.20532,434688
12609,tehKapa,1,0.00023,92178,21.20555,434688
12610,TejasMadappa,1,0.00023,92179,21.20578,434688
12611,Teju367,1,0.00023,92180,21.20601,434688
12612,tekumara,1,0.00023,92181,21.20624,434688
12613,Ten0,1,0.00023,92182,21.20647,434688
12614,teng1,1,0.00023,92183,21.20670,434688
12615,teozkr,1,0.00023,92184,21.20693,434688
12616,teq0,1,0.00023,92185,21.20716,434688
12617,TernencezzZ,1,0.00023,92186,21.20739,434688
12618,terrafying,1,0.00023,92187,21.20762,434688
12619,terryzwt,1,0.00023,92188,21.20785,434688
12620,testeddoughnut,1,0.00023,92189,21.20808,434688
12621,TestFed,1,0.00023,92190,21.20831,434688
12622,tetsuo-miyakuni,1,0.00023,92191,21.20854,434688
12623,Text-only,1,0.00023,92192,21.20878,434688
12624,tfcace,1,0.00023,92193,21.20901,434688
12625,tfendt-belong-gg,1,0.00023,92194,21.20924,434688
12626,Tfmenard,1,0.00023,92195,21.20947,434688
12627,tfn220189,1,0.00023,92196,21.20970,434688
12628,tfoks,1,0.00023,92197,21.20993,434688
12629,th110,1,0.00023,92198,21.21016,434688
12630,th3w4y,1,0.00023,92199,21.21039,434688
12631,than6oz,1,0.00023,92200,21.21062,434688
12632,thanhiro,1,0.00023,92201,21.21085,434688
12633,thanhtoan1196,1,0.00023,92202,21.21108,434688
12634,thathireddy1982,1,0.00023,92203,21.21131,434688
12635,theartusz,1,0.00023,92204,21.21154,434688
12636,theaugy,1,0.00023,92205,21.21177,434688
12637,the-bets,1,0.00023,92206,21.21200,434688
12638,theboyisno-1,1,0.00023,92207,21.21223,434688
12639,TheeGreenBee,1,0.00023,92208,21.21246,434688
12640,TheFrisianClause,1,0.00023,92209,21.21269,434688
12641,TheGr8Nik,1,0.00023,92210,21.21292,434688
12642,TheKevJames,1,0.00023,92211,21.21315,434688
12643,thekrimm,1,0.00023,92212,21.21338,434688
12644,T-helper,1,0.00023,92213,21.21361,434688
12645,the-maldridge,1,0.00023,92214,21.21384,434688
12646,themonaminor,1,0.00023,92215,21.21407,434688
12647,thenovacreator,1,0.00023,92216,21.21430,434688
12648,theonewolf,1,0.00023,92217,21.21453,434688
12649,ThePazuzu,1,0.00023,92218,21.21476,434688
12650,thepip3r,1,0.00023,92219,21.21499,434688
12651,therealak12,1,0.00023,92220,21.21522,434688
12652,TheRealDwright,1,0.00023,92221,21.21545,434688
12653,thesamet,1,0.00023,92222,21.21568,434688
12654,thesobercoder,1,0.00023,92223,21.21591,434688
12655,thetestlabs,1,0.00023,92224,21.21614,434688
12656,TheWiresharkGuy,1,0.00023,92225,21.21637,434688
12657,theyough,1,0.00023,92226,21.21660,434688
12658,Thiago-Dantas,1,0.00023,92227,21.21683,434688
12659,thiagodsti,1,0.00023,92228,21.21706,434688
12660,thinkry,1,0.00023,92229,21.21729,434688
12661,thinzaung,1,0.00023,92230,21.21752,434688
12662,thirdcountry,1,0.00023,92231,21.21775,434688
12663,thobib,1,0.00023,92232,21.21798,434688
12664,thodquach,1,0.00023,92233,21.21821,434688
12665,thomas-goulet,1,0.00023,92234,21.21844,434688
12666,ThomasK33,1,0.00023,92235,21.21867,434688
12667,thomasliu623,1,0.00023,92236,21.21890,434688
12668,thomas-morrow-s,1,0.00023,92237,21.21913,434688
12669,thomasroot,1,0.00023,92238,21.21936,434688
12670,thomaswoeckinger,1,0.00023,92239,21.21959,434688
12671,thomschke,1,0.00023,92240,21.21982,434688
12672,thotypous,1,0.00023,92241,21.22005,434688
12673,Thrimbda,1,0.00023,92242,21.22028,434688
12674,thughes42,1,0.00023,92243,21.22051,434688
12675,tiagogba,1,0.00023,92244,21.22074,434688
12676,tiandaox,1,0.00023,92245,21.22097,434688
12677,Tibingeo,1,0.00023,92246,21.22120,434688
12678,tibordp,1,0.00023,92247,21.22143,434688
12679,tibulca,1,0.00023,92248,21.22166,434688
12680,tibz-enex,1,0.00023,92249,21.22189,434688
12681,tiegs,1,0.00023,92250,21.22212,434688
12682,tiejunhu,1,0.00023,92251,21.22235,434688
12683,tiekuhn,1,0.00023,92252,21.22258,434688
12684,tielou,1,0.00023,92253,21.22281,434688
12685,tiger7456,1,0.00023,92254,21.22304,434688
12686,tightime,1,0.00023,92255,21.22327,434688
12687,tilgovi,1,0.00023,92256,21.22350,434688
12688,TiloGit,1,0.00023,92257,21.22373,434688
12689,timothyclin,1,0.00023,92258,21.22396,434688
12690,timsanwald,1,0.00023,92259,21.22419,434688
12691,timsolov,1,0.00023,92260,21.22442,434688
12692,timvan,1,0.00023,92261,21.22465,434688
12693,tinder-nishantmehta,1,0.00023,92262,21.22488,434688
12694,t-indumathy,1,0.00023,92263,21.22511,434688
12695,tintranvan,1,0.00023,92264,21.22534,434688
12696,tippexs,1,0.00023,92265,21.22557,434688
12697,tippl,1,0.00023,92266,21.22580,434688
12698,titlisgupta,1,0.00023,92267,21.22603,434688
12699,titou10titou10,1,0.00023,92268,21.22626,434688
12700,tivizi,1,0.00023,92269,21.22649,434688
12701,tjorri,1,0.00023,92270,21.22672,434688
12702,tjq857,1,0.00023,92271,21.22695,434688
12703,tjungblu,1,0.00023,92272,21.22718,434688
12704,TKK123,1,0.00023,92273,21.22741,434688
12705,tkleczek,1,0.00023,92274,21.22764,434688
12706,tkoeck,1,0.00023,92275,21.22787,434688
12707,tkyz,1,0.00023,92276,21.22810,434688
12708,t-lo,1,0.00023,92277,21.22833,434688
12709,tmalinakis-vng,1,0.00023,92278,21.22856,434688
12710,tmancill,1,0.00023,92279,21.22879,434688
12711,tmbull,1,0.00023,92280,21.22902,434688
12712,tmehlinger,1,0.00023,92281,21.22925,434688
12713,tmetodie,1,0.00023,92282,21.22948,434688
12714,tndata,1,0.00023,92283,21.22971,434688
12715,tnkemdilim,1,0.00023,92284,21.22994,434688
12716,toamto94,1,0.00023,92285,21.23017,434688
12717,toasti,1,0.00023,92286,21.23040,434688
12718,tob123,1,0.00023,92287,21.23063,434688
12719,tobbbles,1,0.00023,92288,21.23086,434688
12720,tobiasbp,1,0.00023,92289,21.23109,434688
12721,TobiasRD,1,0.00023,92290,21.23132,434688
12722,tobias-trabelsi-sonarsource,1,0.00023,92291,21.23155,434688
12723,tobiaswi,1,0.00023,92292,21.23178,434688
12724,tobiaszheller,1,0.00023,92293,21.23201,434688
12725,toby1991,1,0.00023,92294,21.23224,434688
12726,toby20130333,1,0.00023,92295,21.23247,434688
12727,todd-berger,1,0.00023,92296,21.23270,434688
12728,toddfoust,1,0.00023,92297,21.23293,434688
12729,todor,1,0.00023,92298,21.23316,434688
12730,together-wang,1,0.00023,92299,21.23339,434688
12731,TOHUHM,1,0.00023,92300,21.23362,434688
12732,Tom13666,1,0.00023,92301,21.23385,434688
12733,tomasaschan,1,0.00023,92302,21.23408,434688
12734,TomaszKlosinski,1,0.00023,92303,21.23431,434688
12735,TomaszPawelecGL,1,0.00023,92304,21.23454,434688
12736,TomatoAres,1,0.00023,92305,21.23477,434688
12737,TomerHeber,1,0.00023,92306,21.23500,434688
12738,tomiszili,1,0.00023,92307,21.23523,434688
12739,tommy24b,1,0.00023,92308,21.23546,434688
12740,Tommyf,1,0.00023,92309,21.23569,434688
12741,TomOrth,1,0.00023,92310,21.23592,434688
12742,tomotvos,1,0.00023,92311,21.23615,434688
12743,tomwwright,1,0.00023,92312,21.23638,434688
12744,Tomy8s,1,0.00023,92313,21.23661,434688
12745,tonedefdev,1,0.00023,92314,21.23684,434688
12746,ToniCipriani,1,0.00023,92315,21.23707,434688
12747,toniz,1,0.00023,92316,21.23730,434688
12748,tontondematt,1,0.00023,92317,21.23753,434688
12749,tonus-sebastian,1,0.00023,92318,21.23776,434688
12750,TonyHuaPei,1,0.00023,92319,21.23799,434688
12751,tonytonyjan,1,0.00023,92320,21.23822,434688
12752,Torbik,1,0.00023,92321,21.23845,434688
12753,torblerone,1,0.00023,92322,21.23868,434688
12754,toringzhang,1,0.00023,92323,21.23891,434688
12755,tormentous,1,0.00023,92324,21.23914,434688
12756,tortex24,1,0.00023,92325,21.23937,434688
12757,totore86,1,0.00023,92326,21.23960,434688
12758,tpalashki,1,0.00023,92327,21.23983,434688
12759,tpoland,1,0.00023,92328,21.24006,434688
12760,TProhofsky,1,0.00023,92329,21.24029,434688
12761,tpvasconcelos,1,0.00023,92330,21.24052,434688
12762,tr2vil,1,0.00023,92331,21.24075,434688
12763,Trackhe,1,0.00023,92332,21.24098,434688
12764,Tragedian,1,0.00023,92333,21.24121,434688
12765,TraianSandu,1,0.00023,92334,21.24144,434688
12766,trainingUI,1,0.00023,92335,21.24167,434688
12767,transacid,1,0.00023,92336,21.24190,434688
12768,transient1,1,0.00023,92337,21.24213,434688
12769,travellingprog,1,0.00023,92338,21.24236,434688
12770,treethought,1,0.00023,92339,21.24259,434688
12771,trentcain,1,0.00023,92340,21.24282,434688
12772,treo,1,0.00023,92341,21.24305,434688
12773,trevor-dialpad,1,0.00023,92342,21.24328,434688
12774,treythomas123,1,0.00023,92343,21.24351,434688
12775,trietsch,1,0.00023,92344,21.24374,434688
12776,trillejs,1,0.00023,92345,21.24397,434688
12777,trippl,1,0.00023,92346,21.24420,434688
12778,Tristan971,1,0.00023,92347,21.24443,434688
12779,trojandg,1,0.00023,92348,21.24466,434688
12780,trollqaa,1,0.00023,92349,21.24489,434688
12781,TroyPang,1,0.00023,92350,21.24512,434688
12782,truong-hua,1,0.00023,92351,21.24535,434688
12783,Trustno11346,1,0.00023,92352,21.24558,434688
12784,trynaeat,1,0.00023,92353,21.24581,434688
12785,tsalm-pivotal,1,0.00023,92354,21.24604,434688
12786,tschechniker,1,0.00023,92355,21.24627,434688
12787,tschirmer,1,0.00023,92356,21.24650,434688
12788,tscswcn,1,0.00023,92357,21.24673,434688
12789,Tseian,1,0.00023,92358,21.24696,434688
12790,tsologub,1,0.00023,92359,21.24719,434688
12791,tstraley,1,0.00023,92360,21.24742,434688
12792,tszmytka,1,0.00023,92361,21.24765,434688
12793,ttony,1,0.00023,92362,21.24788,434688
12794,tuannh99,1,0.00023,92363,21.24811,434688
12795,tuannvm01,1,0.00023,92364,21.24834,434688
12796,tuapuikia,1,0.00023,92365,21.24857,434688
12797,tuckcodes,1,0.00023,92366,21.24880,434688
12798,tudou34,1,0.00023,92367,21.24903,434688
12799,tulanian,1,0.00023,92368,21.24926,434688
12800,tulsluper,1,0.00023,92369,21.24949,434688
12801,Tuyuantao,1,0.00023,92370,21.24972,434688
12802,twiny,1,0.00023,92371,21.24995,434688
12803,tyanko1,1,0.00023,92372,21.25018,434688
12804,Tyghe,1,0.00023,92373,21.25041,434688
12805,tyler-jachetta,1,0.00023,92374,21.25064,434688
12806,tylerXMD,1,0.00023,92375,21.25087,434688
12807,typez,1,0.00023,92376,21.25110,434688
12808,tysonclugg,1,0.00023,92377,21.25133,434688
12809,Ubereil,1,0.00023,92378,21.25156,434688
12810,ucarbehlul,1,0.00023,92379,21.25179,434688
12811,Uchiha007,1,0.00023,92380,21.25202,434688
12812,udesaiitrs,1,0.00023,92381,21.25225,434688
12813,udnjf79034,1,0.00023,92382,21.25248,434688
12814,udoratin,1,0.00023,92383,21.25271,434688
12815,ujslxw,1,0.00023,92384,21.25294,434688
12816,ulfmansson,1,0.00023,92385,21.25317,434688
12817,ulrichoke,1,0.00023,92386,21.25340,434688
12818,ultra-baba,1,0.00023,92387,21.25363,434688
12819,Umair841,1,0.00023,92388,21.25386,434688
12820,UmairHassanKhan,1,0.00023,92389,21.25409,434688
12821,umairm-tw,1,0.00023,92390,21.25432,434688
12822,umutkacar,1,0.00023,92391,21.25455,434688
12823,unai-ttxu,1,0.00023,92392,21.25479,434688
12824,uncelvel,1,0.00023,92393,21.25502,434688
12825,undassa,1,0.00023,92394,21.25525,434688
12826,UnderTreeTech,1,0.00023,92395,21.25548,434688
12827,unibeck,1,0.00023,92396,21.25571,434688
12828,universam1,1,0.00023,92397,21.25594,434688
12829,unixkartik01,1,0.00023,92398,21.25617,434688
12830,unixlab,1,0.00023,92399,21.25640,434688
12831,unleashit,1,0.00023,92400,21.25663,434688
12832,upkash,1,0.00023,92401,21.25686,434688
12833,uptownaravi,1,0.00023,92402,21.25709,434688
12834,uri-tech,1,0.00023,92403,21.25732,434688
12835,urmet,1,0.00023,92404,21.25755,434688
12836,urwah1996,1,0.00023,92405,21.25778,434688
12837,usernameisnull,1,0.00023,92406,21.25801,434688
12838,userzj,1,0.00023,92407,21.25824,434688
12839,ushabapat,1,0.00023,92408,21.25847,434688
12840,ustuzhanin,1,0.00023,92409,21.25870,434688
12841,usuryadevara,1,0.00023,92410,21.25893,434688
12842,utamori,1,0.00023,92411,21.25916,434688
12843,utegental,1,0.00023,92412,21.25939,434688
12844,utkarsh39,1,0.00023,92413,21.25962,434688
12845,uvletter,1,0.00023,92414,21.25985,434688
12846,v1b1,1,0.00023,92415,21.26008,434688
12847,v1nc3nt27,1,0.00023,92416,21.26031,434688
12848,V1nceZhang,1,0.00023,92417,21.26054,434688
12849,v4ld3r5,1,0.00023,92418,21.26077,434688
12850,va3093,1,0.00023,92419,21.26100,434688
12851,VahidFarahmandian,1,0.00023,92420,21.26123,434688
12852,vaibhavepatel,1,0.00023,92421,21.26146,434688
12853,vaibhavraizada-hcl,1,0.00023,92422,21.26169,434688
12854,VajiraPrabuddhaka,1,0.00023,92423,21.26192,434688
12855,vakaobr,1,0.00023,92424,21.26215,434688
12856,vallbuy,1,0.00023,92425,21.26238,434688
12857,valsen,1,0.00023,92426,21.26261,434688
12858,vanand-conga,1,0.00023,92427,21.26284,434688
12859,vanni-giachin,1,0.00023,92428,21.26307,434688
12860,vanthome,1,0.00023,92429,21.26330,434688
12861,vanzin,1,0.00023,92430,21.26353,434688
12862,varkey,1,0.00023,92431,21.26376,434688
12863,Varun-garg,1,0.00023,92432,21.26399,434688
12864,varungupta19,1,0.00023,92433,21.26422,434688
12865,VarunSAthreya,1,0.00023,92434,21.26445,434688
12866,varunshaji,1,0.00023,92435,21.26468,434688
12867,varuzam,1,0.00023,92436,21.26491,434688
12868,vasily-22,1,0.00023,92437,21.26514,434688
12869,vaskozl,1,0.00023,92438,21.26537,434688
12870,Vasundharashukla,1,0.00023,92439,21.26560,434688
12871,VatslavDS,1,0.00023,92440,21.26583,434688
12872,vazmin,1,0.00023,92441,21.26606,434688
12873,vbkunin,1,0.00023,92442,21.26629,434688
12874,vchepkov,1,0.00023,92443,21.26652,434688
12875,vct4433,1,0.00023,92444,21.26675,434688
12876,VCuzmin,1,0.00023,92445,21.26698,434688
12877,vdiravka,1,0.00023,92446,21.26721,434688
12878,vearutop,1,0.00023,92447,21.26744,434688
12879,vebbeb,1,0.00023,92448,21.26767,434688
12880,Vedadiyan,1,0.00023,92449,21.26790,434688
12881,vedangj044,1,0.00023,92450,21.26813,434688
12882,VedantParanjape,1,0.00023,92451,21.26836,434688
12883,vegetablesalad,1,0.00023,92452,21.26859,434688
12884,venamis,1,0.00023,92453,21.26882,434688
12885,venkat330,1,0.00023,92454,21.26905,434688
12886,venkiit58,1,0.00023,92455,21.26928,434688
12887,Ventsislav86,1,0.00023,92456,21.26951,434688
12888,verdie-g,1,0.00023,92457,21.26974,434688
12889,veresij,1,0.00023,92458,21.26997,434688
12890,vetyy,1,0.00023,92459,21.27020,434688
12891,VF-mbrauer,1,0.00023,92460,21.27043,434688
12892,vgorbenko,1,0.00023,92461,21.27066,434688
12893,vguaglione,1,0.00023,92462,21.27089,434688
12894,vhmatura,1,0.00023,92463,21.27112,434688
12895,vhuezo,1,0.00023,92464,21.27135,434688
12896,viatcheslavmogilevsky,1,0.00023,92465,21.27158,434688
12897,vibhutisawant,1,0.00023,92466,21.27181,434688
12898,viceice,1,0.00023,92467,21.27204,434688
12899,victorhahn,1,0.00023,92468,21.27227,434688
12900,VictorLowther,1,0.00023,92469,21.27250,434688
12901,VictorViana,1,0.00023,92470,21.27273,434688
12902,vidaks,1,0.00023,92471,21.27296,434688
12903,viditganpi,1,0.00023,92472,21.27319,434688
12904,vietanhduong,1,0.00023,92473,21.27342,434688
12905,vijay2308,1,0.00023,92474,21.27365,434688
12906,Vijayakumar0328,1,0.00023,92475,21.27388,434688
12907,vijay-at-work,1,0.00023,92476,21.27411,434688
12908,vijaynag-bs,1,0.00023,92477,21.27434,434688
12909,vikasLstar,1,0.00023,92478,21.27457,434688
12910,vikrantsde,1,0.00023,92479,21.27480,434688
12911,viktoriaas,1,0.00023,92480,21.27503,434688
12912,VinayagamBabu,1,0.00023,92481,21.27526,434688
12913,vincent-163,1,0.00023,92482,21.27549,434688
12914,vincentbaeten,1,0.00023,92483,21.27572,434688
12915,vincentchong1,1,0.00023,92484,21.27595,434688
12916,Vineesh314,1,0.00023,92485,21.27618,434688
12917,vineetmadan,1,0.00023,92486,21.27641,434688
12918,vinicius73,1,0.00023,92487,21.27664,434688
12919,vin-mad,1,0.00023,92488,21.27687,434688
12920,vinoski,1,0.00023,92489,21.27710,434688
12921,VinothChinnadurai,1,0.00023,92490,21.27733,434688
12922,VioletCranberry,1,0.00023,92491,21.27756,434688
12923,violette,1,0.00023,92492,21.27779,434688
12924,vipmaha1,1,0.00023,92493,21.27802,434688
12925,VipulZopSmart,1,0.00023,92494,21.27825,434688
12926,virtualstaticvoid,1,0.00023,92495,21.27848,434688
12927,virtyos,1,0.00023,92496,21.27871,434688
12928,vishalct,1,0.00023,92497,21.27894,434688
12929,vishumindtree,1,0.00023,92498,21.27917,434688
12930,vishwaskumar58,1,0.00023,92499,21.27940,434688
12931,visit1985,1,0.00023,92500,21.27963,434688
12932,vitaliyf,1,0.00023,92501,21.27986,434688
12933,vitalyrychkov,1,0.00023,92502,21.28009,434688
12934,vit-zikmund,1,0.00023,92503,21.28032,434688
12935,vivekanandpoojari,1,0.00023,92504,21.28055,434688
12936,vivekjainx86,1,0.00023,92505,21.28078,434688
12937,vivekpd15,1,0.00023,92506,21.28101,434688
12938,VivekSubr,1,0.00023,92507,21.28124,434688
12939,vivid392845427,1,0.00023,92508,21.28147,434688
12940,vizcay,1,0.00023,92509,21.28170,434688
12941,vizgin,1,0.00023,92510,21.28193,434688
12942,v-khtruo,1,0.00023,92511,21.28216,434688
12943,VKorelin,1,0.00023,92512,21.28239,434688
12944,vkrishnamoorthy-sift,1,0.00023,92513,21.28262,434688
12945,vlad2010,1,0.00023,92514,21.28285,434688
12946,vladiceanu,1,0.00023,92515,21.28308,434688
12947,vladimir259,1,0.00023,92516,21.28331,434688
12948,vladimirkhs,1,0.00023,92517,21.28354,434688
12949,vladimir-setka-form3,1,0.00023,92518,21.28377,434688
12950,vladst3f,1,0.00023,92519,21.28400,434688
12951,vlcty,1,0.00023,92520,21.28423,434688
12952,vlk-charles,1,0.00023,92521,21.28446,434688
12953,vmacarrein,1,0.00023,92522,21.28469,434688
12954,vnredmon,1,0.00023,92523,21.28492,434688
12955,vnugent,1,0.00023,92524,21.28515,434688
12956,voarsh2,1,0.00023,92525,21.28538,434688
12957,voidlily,1,0.00023,92526,21.28561,434688
12958,volanja,1,0.00023,92527,21.28584,434688
12959,Volatus,1,0.00023,92528,21.28607,434688
12960,Voltronically,1,0.00023,92529,21.28630,434688
12961,vonera,1,0.00023,92530,21.28653,434688
12962,vonguard,1,0.00023,92531,21.28676,434688
12963,voroninman,1,0.00023,92532,21.28699,434688
12964,vorsel,1,0.00023,92533,21.28722,434688
12965,vosmax,1,0.00023,92534,21.28745,434688
12966,vovasazonov,1,0.00023,92535,21.28768,434688
12967,voyachek,1,0.00023,92536,21.28791,434688
12968,vperi1730,1,0.00023,92537,21.28814,434688
12969,vpopescu,1,0.00023,92538,21.28837,434688
12970,vprus,1,0.00023,92539,21.28860,434688
12971,vrivellino,1,0.00023,92540,21.28883,434688
12972,vsevel,1,0.00023,92541,21.28906,434688
12973,vsharma23,1,0.00023,92542,21.28929,434688
12974,vsile,1,0.00023,92543,21.28952,434688
12975,vskovzgird,1,0.00023,92544,21.28975,434688
12976,vudodov,1,0.00023,92545,21.28998,434688
12977,vugardzhamalov,1,0.00023,92546,21.29021,434688
12978,vulture990,1,0.00023,92547,21.29044,434688
12979,vvazharksi,1,0.00023,92548,21.29067,434688
12980,vzaitsev77,1,0.00023,92549,21.29090,434688
12981,vzaitsev77ionos,1,0.00023,92550,21.29113,434688
12982,w0wka91,1,0.00023,92551,21.29136,434688
12983,w4rgrum,1,0.00023,92552,21.29159,434688
12984,w7089,1,0.00023,92553,21.29182,434688
12985,wacken89,1,0.00023,92554,21.29205,434688
12986,waeljammal,1,0.00023,92555,21.29228,434688
12987,waffle999,1,0.00023,92556,21.29251,434688
12988,WaffleLapkin,1,0.00023,92557,21.29274,434688
12989,waiariki-koia,1,0.00023,92558,21.29297,434688
12990,waldo2188,1,0.00023,92559,21.29320,434688
12991,waleed-git,1,0.00023,92560,21.29343,434688
12992,wallies,1,0.00023,92561,21.29366,434688
12993,wamayall,1,0.00023,92562,21.29389,434688
12994,wang007,1,0.00023,92563,21.29412,434688
12995,wanggujin,1,0.00023,92564,21.29435,434688
12996,wanglilin0628,1,0.00023,92565,21.29458,434688
12997,wangrongjun,1,0.00023,92566,21.29481,434688
12998,wangshishuo,1,0.00023,92567,21.29504,434688
12999,wangweilica,1,0.00023,92568,21.29527,434688
13000,wangxiaoq,1,0.00023,92569,21.29550,434688
13001,wangxiyuan,1,0.00023,92570,21.29573,434688
13002,wangyijie7,1,0.00023,92571,21.29596,434688
13003,WangYunT,1,0.00023,92572,21.29619,434688
13004,wangzilong,1,0.00023,92573,21.29642,434688
13005,warrenstephens,1,0.00023,92574,21.29665,434688
13006,washanhanzi,1,0.00023,92575,21.29688,434688
13007,wavemoran,1,0.00023,92576,21.29711,434688
13008,waymen,1,0.00023,92577,21.29734,434688
13009,wayne-cheng,1,0.00023,92578,21.29757,434688
13010,waynexia,1,0.00023,92579,21.29780,434688
13011,waypoint100,1,0.00023,92580,21.29803,434688
13012,wcc526,1,0.00023,92581,21.29826,434688
13013,wchaws,1,0.00023,92582,21.29849,434688
13014,wdbetts,1,0.00023,92583,21.29872,434688
13015,wdec,1,0.00023,92584,21.29895,434688
13016,wdfinch,1,0.00023,92585,21.29918,434688
13017,webark,1,0.00023,92586,21.29941,434688
13018,webchi,1,0.00023,92587,21.29964,434688
13019,webdavis,1,0.00023,92588,21.29987,434688
13020,webdevrahul,1,0.00023,92589,21.30010,434688
13021,weh,1,0.00023,92590,21.30033,434688
13022,weiqiangt,1,0.00023,92591,21.30057,434688
13023,weiwei02,1,0.00023,92592,21.30080,434688
13024,weixiao619,1,0.00023,92593,21.30103,434688
13025,welborntellis,1,0.00023,92594,21.30126,434688
13026,wendao8469759,1,0.00023,92595,21.30149,434688
13027,wendaotao,1,0.00023,92596,21.30172,434688
13028,wenhx8,1,0.00023,92597,21.30195,434688
13029,wenwugu,1,0.00023,92598,21.30218,434688
13030,WenwuPeng,1,0.00023,92599,21.30241,434688
13031,wenxinax,1,0.00023,92600,21.30264,434688
13032,wenzizone,1,0.00023,92601,21.30287,434688
13033,wesleimp,1,0.00023,92602,21.30310,434688
13034,wesselvdv,1,0.00023,92603,21.30333,434688
13035,WesternStar,1,0.00023,92604,21.30356,434688
13036,westonpace,1,0.00023,92605,21.30379,434688
13037,wgerlach,1,0.00023,92606,21.30402,434688
13038,whatwewant,1,0.00023,92607,21.30425,434688
13039,whesse,1,0.00023,92608,21.30448,434688
13040,whg517,1,0.00023,92609,21.30471,434688
13041,whh32,1,0.00023,92610,21.30494,434688
13042,WhiteHatTux,1,0.00023,92611,21.30517,434688
13043,whut,1,0.00023,92612,21.30540,434688
13044,whyando,1,0.00023,92613,21.30563,434688
13045,Whyeasy,1,0.00023,92614,21.30586,434688
13046,wibbly13,1,0.00023,92615,21.30609,434688
13047,wigeric,1,0.00023,92616,21.30632,434688
13048,wikidog,1,0.00023,92617,21.30655,434688
13049,Wikiwix,1,0.00023,92618,21.30678,434688
13050,willbennett-kaltura,1,0.00023,92619,21.30701,434688
13051,williamd5,1,0.00023,92620,21.30724,434688
13052,williamhanseneric,1,0.00023,92621,21.30747,434688
13053,willianpaixao,1,0.00023,92622,21.30770,434688
13054,WillyRL,1,0.00023,92623,21.30793,434688
13055,windingroad100hf,1,0.00023,92624,21.30816,434688
13056,wingman-chakra,1,0.00023,92625,21.30839,434688
13057,WingT,1,0.00023,92626,21.30862,434688
13058,WinJayX,1,0.00023,92627,21.30885,434688
13059,WinnerSong,1,0.00023,92628,21.30908,434688
13060,WisWang,1,0.00023,92629,21.30931,434688
13061,witdur,1,0.00023,92630,21.30954,434688
13062,wite27,1,0.00023,92631,21.30977,434688
13063,withernet,1,0.00023,92632,21.31000,434688
13064,WizardVan,1,0.00023,92633,21.31023,434688
13065,wjam,1,0.00023,92634,21.31046,434688
13066,wjun,1,0.00023,92635,21.31069,434688
13067,wkit23,1,0.00023,92636,21.31092,434688
13068,wkjun,1,0.00023,92637,21.31115,434688
13069,wknapik,1,0.00023,92638,21.31138,434688
13070,wmgroot,1,0.00023,92639,21.31161,434688
13071,WnP,1,0.00023,92640,21.31184,434688
13072,Woazboat,1,0.00023,92641,21.31207,434688
13073,wobo-mattmencel,1,0.00023,92642,21.31230,434688
13074,wochanda,1,0.00023,92643,21.31253,434688
13075,wojtaseu,1,0.00023,92644,21.31276,434688
13076,wolf99,1,0.00023,92645,21.31299,434688
13077,wondersong,1,0.00023,92646,21.31322,434688
13078,wonnyz,1,0.00023,92647,21.31345,434688
13079,WoodpeckerBaby,1,0.00023,92648,21.31368,434688
13080,Wood-Xia,1,0.00023,92649,21.31391,434688
13081,wookietreiber,1,0.00023,92650,21.31414,434688
13082,woraccmsq,1,0.00023,92651,21.31437,434688
13083,workhorse2020,1,0.00023,92652,21.31460,434688
13084,WouldYouKindly,1,0.00023,92653,21.31483,434688
13085,wowq,1,0.00023,92654,21.31506,434688
13086,woxiang-H,1,0.00023,92655,21.31529,434688
13087,wperezp,1,0.00023,92656,21.31552,434688
13088,Wraith2,1,0.00023,92657,21.31575,434688
13089,wranders,1,0.00023,92658,21.31598,434688
13090,wsams,1,0.00023,92659,21.31621,434688
13091,wsquan171,1,0.00023,92660,21.31644,434688
13092,wsscc2021,1,0.00023,92661,21.31667,434688
13093,wsxiaozhang,1,0.00023,92662,21.31690,434688
13094,wuji1020,1,0.00023,92663,21.31713,434688
13095,wujun369,1,0.00023,92664,21.31736,434688
13096,WuK0,1,0.00023,92665,21.31759,434688
13097,wutongjie23hao,1,0.00023,92666,21.31782,434688
13098,wuvs,1,0.00023,92667,21.31805,434688
13099,wuxinsuoqiu,1,0.00023,92668,21.31828,434688
13100,wuzhengxuan,1,0.00023,92669,21.31851,434688
13101,wvalianty,1,0.00023,92670,21.31874,434688
13102,wwalexander,1,0.00023,92671,21.31897,434688
13103,wwwlde,1,0.00023,92672,21.31920,434688
13104,wyaow,1,0.00023,92673,21.31943,434688
13105,Wykiki,1,0.00023,92674,21.31966,434688
13106,wyljpn,1,0.00023,92675,21.31989,434688
13107,wyndigo,1,0.00023,92676,21.32012,434688
13108,XabierGoros,1,0.00023,92677,21.32035,434688
13109,xaocon,1,0.00023,92678,21.32058,434688
13110,xaverkapeller,1,0.00023,92679,21.32081,434688
13111,xavidop,1,0.00023,92680,21.32104,434688
13112,xavierpecheur,1,0.00023,92681,21.32127,434688
13113,xblaster,1,0.00023,92682,21.32150,434688
13114,xbmono,1,0.00023,92683,21.32173,434688
13115,xbnrxout,1,0.00023,92684,21.32196,434688
13116,X-dark,1,0.00023,92685,21.32219,434688
13117,XDavidT,1,0.00023,92686,21.32242,434688
13118,xdvpser,1,0.00023,92687,21.32265,434688
13119,xen0n,1,0.00023,92688,21.32288,434688
13120,xi2817-aajgaonkar,1,0.00023,92689,21.32311,434688
13121,xialanpu,1,0.00023,92690,21.32334,434688
13122,xiamx,1,0.00023,92691,21.32357,434688
13123,xiang17,1,0.00023,92692,21.32380,434688
13124,xianglinboy,1,0.00023,92693,21.32403,434688
13125,xiaoheng1,1,0.00023,92694,21.32426,434688
13126,xiaoma2015,1,0.00023,92695,21.32449,434688
13127,xiaoping8385,1,0.00023,92696,21.32472,434688
13128,xiaoweihong,1,0.00023,92697,21.32495,434688
13129,XiaoXiaoSN,1,0.00023,92698,21.32518,434688
13130,xiazemin,1,0.00023,92699,21.32541,434688
13131,xibuka,1,0.00023,92700,21.32564,434688
13132,xiehaoina,1,0.00023,92701,21.32587,434688
13133,xinau,1,0.00023,92702,21.32610,434688
13134,xluffy,1,0.00023,92703,21.32633,434688
13135,xor222xor,1,0.00023,92704,21.32656,434688
13136,XRarach,1,0.00023,92705,21.32679,434688
13137,xs3c,1,0.00023,92706,21.32702,434688
13138,xShteff,1,0.00023,92707,21.32725,434688
13139,xtenduke,1,0.00023,92708,21.32748,434688
13140,xuanyuanaosheng,1,0.00023,92709,21.32771,434688
13141,xuhrc,1,0.00023,92710,21.32794,434688
13142,xunleii,1,0.00023,92711,21.32817,434688
13143,xutongqing,1,0.00023,92712,21.32840,434688
13144,xvdy,1,0.00023,92713,21.32863,434688
13145,xx720527,1,0.00023,92714,21.32886,434688
13146,xxj123go,1,0.00023,92715,21.32909,434688
13147,xxltju324,1,0.00023,92716,21.32932,434688
13148,xy7668,1,0.00023,92717,21.32955,434688
13149,xylonx,1,0.00023,92718,21.32978,434688
13150,xyzkpz,1,0.00023,92719,21.33001,434688
13151,xyzzen,1,0.00023,92720,21.33024,434688
13152,y93x08y05,1,0.00023,92721,21.33047,434688
13153,yaa110,1,0.00023,92722,21.33070,434688
13154,yaboeing,1,0.00023,92723,21.33093,434688
13155,yacir,1,0.00023,92724,21.33116,434688
13156,yafanasiev,1,0.00023,92725,21.33139,434688
13157,yanehi,1,0.00023,92726,21.33162,434688
13158,yanggeorge,1,0.00023,92727,21.33185,434688
13159,yangsongx,1,0.00023,92728,21.33208,434688
13160,yangyaofei,1,0.00023,92729,21.33231,434688
13161,yanmin950122,1,0.00023,92730,21.33254,434688
13162,yannickb85,1,0.00023,92731,21.33277,434688
13163,yannizhang2019,1,0.00023,92732,21.33300,434688
13164,yan-v,1,0.00023,92733,21.33323,434688
13165,yan-zhao-unity,1,0.00023,92734,21.33346,434688
13166,yartat,1,0.00023,92735,21.33369,434688
13167,yaser-hameed,1,0.00023,92736,21.33392,434688
13168,yaskinny,1,0.00023,92737,21.33415,434688
13169,Yassineelkasmy,1,0.00023,92738,21.33438,434688
13170,yatakoi,1,0.00023,92739,21.33461,434688
13171,yati1998,1,0.00023,92740,21.33484,434688
13172,YavarVazir,1,0.00023,92741,21.33507,434688
13173,yayfeng,1,0.00023,92742,21.33530,434688
13174,ycr-oss,1,0.00023,92743,21.33553,434688
13175,ycwdaaaa,1,0.00023,92744,21.33576,434688
13176,yeDor,1,0.00023,92745,21.33599,434688
13177,yedukondalurd,1,0.00023,92746,21.33622,434688
13178,yeikel,1,0.00023,92747,21.33645,434688
13179,yelinaung,1,0.00023,92748,21.33668,434688
13180,Yellow-L,1,0.00023,92749,21.33691,434688
13181,yellowmegaman,1,0.00023,92750,21.33714,434688
13182,yelnylee,1,0.00023,92751,21.33737,434688
13183,yesudeep,1,0.00023,92752,21.33760,434688
13184,yevheniilukashov,1,0.00023,92753,21.33783,434688
13185,yevsh,1,0.00023,92754,21.33806,434688
13186,ygxxii,1,0.00023,92755,21.33829,434688
13187,Yharooer,1,0.00023,92756,21.33852,434688
13188,yhvicey,1,0.00023,92757,21.33875,434688
13189,yilas,1,0.00023,92758,21.33898,434688
13190,yilmi,1,0.00023,92759,21.33921,434688
13191,YiniXu9506,1,0.00023,92760,21.33944,434688
13192,yinyangsx,1,0.00023,92761,21.33967,434688
13193,yinzara,1,0.00023,92762,21.33990,434688
13194,yiwiz-sai,1,0.00023,92763,21.34013,434688
13195,YJSdream,1,0.00023,92764,21.34036,434688
13196,ykcilborw,1,0.00023,92765,21.34059,434688
13197,ykitamura-mdsol,1,0.00023,92766,21.34082,434688
13198,yllekz,1,0.00023,92767,21.34105,434688
13199,ymwfish,1,0.00023,92768,21.34128,434688
13200,ynnt,1,0.00023,92769,21.34151,434688
13201,yoe,1,0.00023,92770,21.34174,434688
13202,yogendratamang48,1,0.00023,92771,21.34197,434688
13203,yogit2020,1,0.00023,92772,21.34220,434688
13204,yoichiro,1,0.00023,92773,21.34243,434688
13205,yojay11717,1,0.00023,92774,21.34266,434688
13206,yokowu,1,0.00023,92775,21.34289,434688
13207,Yomanz,1,0.00023,92776,21.34312,434688
13208,yongw5,1,0.00023,92777,21.34335,434688
13209,yongyct,1,0.00023,92778,21.34358,434688
13210,yonkeltron,1,0.00023,92779,21.34381,434688
13211,yosefkri,1,0.00023,92780,21.34404,434688
13212,yoseihouyn,1,0.00023,92781,21.34427,434688
13213,yosensen,1,0.00023,92782,21.34450,434688
13214,yossicohn,1,0.00023,92783,21.34473,434688
13215,YousefHaggy,1,0.00023,92784,21.34496,434688
13216,youzeliang,1,0.00023,92785,21.34519,434688
13217,yrsurya,1,0.00023,92786,21.34542,434688
13218,ysongshan,1,0.00023,92787,21.34565,434688
13219,ysweid,1,0.00023,92788,21.34588,434688
13220,yteraoka,1,0.00023,92789,21.34611,434688
13221,yuanhuaiwang,1,0.00023,92790,21.34634,434688
13222,yuanlinios,1,0.00023,92791,21.34658,434688
13223,yudkeh,1,0.00023,92792,21.34681,434688
13224,yudonglinyy,1,0.00023,92793,21.34704,434688
13225,yudoutingle,1,0.00023,92794,21.34727,434688
13226,yuecchen,1,0.00023,92795,21.34750,434688
13227,yueqiao1,1,0.00023,92796,21.34773,434688
13228,yuezhuangshi,1,0.00023,92797,21.34796,434688
13229,yukihiko-shinoda,1,0.00023,92798,21.34819,434688
13230,yukihonhk,1,0.00023,92799,21.34842,434688
13231,yukinying,1,0.00023,92800,21.34865,434688
13232,yulian-tw,1,0.00023,92801,21.34888,434688
13233,yumoL,1,0.00023,92802,21.34911,434688
13234,YunXu6139,1,0.00023,92803,21.34934,434688
13235,yunzhe99,1,0.00023,92804,21.34957,434688
13236,yunzoud,1,0.00023,92805,21.34980,434688
13237,Yurevich-Andrey,1,0.00023,92806,21.35003,434688
13238,YuriiBarninets,1,0.00023,92807,21.35026,434688
13239,yurkeen,1,0.00023,92808,21.35049,434688
13240,yurykats,1,0.00023,92809,21.35072,434688
13241,yurymuski,1,0.00023,92810,21.35095,434688
13242,yuryu,1,0.00023,92811,21.35118,434688
13243,YuvalAvra,1,0.00023,92812,21.35141,434688
13244,yuvalbaryochay,1,0.00023,92813,21.35164,434688
13245,yuvalman,1,0.00023,92814,21.35187,434688
13246,yuyaojin,1,0.00023,92815,21.35210,434688
13247,yuyue0225sc,1,0.00023,92816,21.35233,434688
13248,yuzhenlei,1,0.00023,92817,21.35256,434688
13249,yuzsun,1,0.00023,92818,21.35279,434688
13250,ywan2017,1,0.00023,92819,21.35302,434688
13251,yws-ss,1,0.00023,92820,21.35325,434688
13252,Yy199902,1,0.00023,92821,21.35348,434688
13253,yyy1000,1,0.00023,92822,21.35371,434688
13254,yzxz1996,1,0.00023,92823,21.35394,434688
13255,z3ke1r,1,0.00023,92824,21.35417,434688
13256,Zaba505,1,0.00023,92825,21.35440,434688
13257,zackb,1,0.00023,92826,21.35463,434688
13258,zagr0,1,0.00023,92827,21.35486,434688
13259,zaisongz,1,0.00023,92828,21.35509,434688
13260,zak905,1,0.00023,92829,21.35532,434688
13261,zakaf,1,0.00023,92830,21.35555,434688
13262,zakov-kara,1,0.00023,92831,21.35578,434688
13263,zaldnoay,1,0.00023,92832,21.35601,434688
13264,zalegrala,1,0.00023,92833,21.35624,434688
13265,zamog,1,0.00023,92834,21.35647,434688
13266,zamrokk,1,0.00023,92835,21.35670,434688
13267,Zamyatin,1,0.00023,92836,21.35693,434688
13268,zap23,1,0.00023,92837,21.35716,434688
13269,zapman449,1,0.00023,92838,21.35739,434688
13270,ZarifS,1,0.00023,92839,21.35762,434688
13271,zavety,1,0.00023,92840,21.35785,434688
13272,zawadaa,1,0.00023,92841,21.35808,434688
13273,zbh2021,1,0.00023,92842,21.35831,434688
13274,zcalusic,1,0.00023,92843,21.35854,434688
13275,ZChunnian,1,0.00023,92844,21.35877,434688
13276,zcnzcnzcn,1,0.00023,92845,21.35900,434688
13277,zczc0128,1,0.00023,92846,21.35923,434688
13278,Zeleksonob,1,0.00023,92847,21.35946,434688
13279,zemek,1,0.00023,92848,21.35969,434688
13280,zendevil,1,0.00023,92849,21.35992,434688
13281,zengzezheng,1,0.00023,92850,21.36015,434688
13282,zenhighzer,1,0.00023,92851,21.36038,434688
13283,zestysoft,1,0.00023,92852,21.36061,434688
13284,zet809,1,0.00023,92853,21.36084,434688
13285,zettaRepo,1,0.00023,92854,21.36107,434688
13286,ZeWaka,1,0.00023,92855,21.36130,434688
13287,zfalen-deloitte,1,0.00023,92856,21.36153,434688
13288,zh2k3ang,1,0.00023,92857,21.36176,434688
13289,zhangchao1210,1,0.00023,92858,21.36199,434688
13290,zhangfu266,1,0.00023,92859,21.36222,434688
13291,zhanggok,1,0.00023,92860,21.36245,434688
13292,zhangtreefish,1,0.00023,92861,21.36268,434688
13293,zhangwenlong8911,1,0.00023,92862,21.36291,434688
13294,zhangyoufu,1,0.00023,92863,21.36314,434688
13295,zhantaof,1,0.00023,92864,21.36337,434688
13296,zhaogaolong,1,0.00023,92865,21.36360,434688
13297,zhaojinxin409,1,0.00023,92866,21.36383,434688
13298,zhaoli2333,1,0.00023,92867,21.36406,434688
13299,zhaoxi0703,1,0.00023,92868,21.36429,434688
13300,Zhaoyu1123,1,0.00023,92869,21.36452,434688
13301,zhengcan,1,0.00023,92870,21.36475,434688
13302,zhengdehui,1,0.00023,92871,21.36498,434688
13303,zhengqisong,1,0.00023,92872,21.36521,434688
13304,ZhengRui,1,0.00023,92873,21.36544,434688
13305,zhenisduissekov,1,0.00023,92874,21.36567,434688
13306,zhguoi,1,0.00023,92875,21.36590,434688
13307,zhichli,1,0.00023,92876,21.36613,434688
13308,zhilyaev,1,0.00023,92877,21.36636,434688
13309,zhixunjie,1,0.00023,92878,21.36659,434688
13310,zhiyuone,1,0.00023,92879,21.36682,434688
13311,ZhongWeichang001,1,0.00023,92880,21.36705,434688
13312,zhoujianwen,1,0.00023,92881,21.36728,434688
13313,zhouxihonghong,1,0.00023,92882,21.36751,434688
13314,zhq734,1,0.00023,92883,21.36774,434688
13315,zhqqqy,1,0.00023,92884,21.36797,434688
13316,zhucanhong,1,0.00023,92885,21.36820,434688
13317,Zhuce123456789,1,0.00023,92886,21.36843,434688
13318,zhuchance,1,0.00023,92887,21.36866,434688
13319,zhucheng01,1,0.00023,92888,21.36889,434688
13320,zhuo1angT,1,0.00023,92889,21.36912,434688
13321,zhuzeyu22,1,0.00023,92890,21.36935,434688
13322,ziemerz,1,0.00023,92891,21.36958,434688
13323,zifter,1,0.00023,92892,21.36981,434688
13324,zimivanende,1,0.00023,92893,21.37004,434688
13325,zionsofer,1,0.00023,92894,21.37027,434688
13326,zishiguo,1,0.00023,92895,21.37050,434688
13327,zivfuture,1,0.00023,92896,21.37073,434688
13328,ziye-dm,1,0.00023,92897,21.37096,434688
13329,zlatin,1,0.00023,92898,21.37119,434688
13330,zmb3,1,0.00023,92899,21.37142,434688
13331,znqerz,1,0.00023,92900,21.37165,434688
13332,zodiac182,1,0.00023,92901,21.37188,434688
13333,zodiac403,1,0.00023,92902,21.37211,434688
13334,zonito,1,0.00023,92903,21.37234,434688
13335,zooks1138,1,0.00023,92904,21.37257,434688
13336,zoroyihan,1,0.00023,92905,21.37280,434688
13337,ZPerling,1,0.00023,92906,21.37303,434688
13338,Zsolt-LazarZsolt,1,0.00023,92907,21.37326,434688
13339,zswanson,1,0.00023,92908,21.37349,434688
13340,zuoshaoyi,1,0.00023,92909,21.37372,434688
13341,zwd1208,1,0.00023,92910,21.37395,434688
13342,zwmcoder,1,0.00023,92911,21.37418,434688
13343,zxdvd,1,0.00023,92912,21.37441,434688
13344,zxia-wish,1,0.00023,92913,21.37464,434688
13345,zyayun,1,0.00023,92914,21.37487,434688
13346,zychina,1,0.00023,92915,21.37510,434688
13347,zzashpaupat,1,0.00023,92916,21.37533,434688
13348,zzguang520,1,0.00023,92917,21.37556,434688
13349,zzswang,1,0.00023,92918,21.37579,434688
13350,zzvara,1,0.00023,92919,21.37602,434688
13351,zzzz465,1,0.00023,92920,21.37625,434688
