rank_number,actor,contributions,percent,cumulative_sum,cumulative_percent,all_contributions
1,ianvernon,19041,8.53439,19041,8.53439,223109
2,raybejjani,6101,2.73454,25142,11.26893,223109
3,gandro,4479,2.00754,29621,13.27647,223109
4,jrfastab,3238,1.45131,32859,14.72778,223109
5,michi-covalent,2446,1.09633,35305,15.82410,223109
6,manalibhutiyani,2435,1.09139,37740,16.91550,223109
7,Rolinh,2000,0.89642,39740,17.81192,223109
8,aditighag,1681,0.75344,41421,18.56536,223109
9,jibi,1550,0.69473,42971,19.26009,223109
10,fristonio,1291,0.57864,44262,19.83873,223109
11,rolinh,1040,0.46614,45302,20.30487,223109
12,Weil0ng,895,0.40115,46197,20.70602,223109
13,glibsm,805,0.36081,47002,21.06683,223109
14,yandzee,706,0.31644,47708,21.38327,223109
15,kaworu,573,0.25683,48281,21.64010,223109
16,geakstr,522,0.23397,48803,21.87406,223109
17,soumynathan,485,0.21738,49288,22.09144,223109
18,ashwinp,401,0.17973,49689,22.27118,223109
19,seanmwinn,386,0.17301,50075,22.44419,223109
20,krishgobinath,346,0.15508,50421,22.59927,223109
21,kAworu,339,0.15194,50760,22.75121,223109
22,Jianlin-lv,307,0.13760,51067,22.88881,223109
23,genbit,297,0.13312,51364,23.02193,223109
24,jaffcheng,273,0.12236,51637,23.14429,223109
25,iffyio,249,0.11160,51886,23.25590,223109
26,techcet,244,0.10936,52130,23.36526,223109
27,joamaki,243,0.10892,52373,23.47418,223109
28,florianl,220,0.09861,52593,23.57278,223109
29,ackerman80,203,0.09099,52796,23.66377,223109
30,ciliumbot,182,0.08157,52978,23.74534,223109
31,MasterZ40,169,0.07575,53147,23.82109,223109
32,h3llix,164,0.07351,53311,23.89460,223109
33,ap4y,154,0.06902,53465,23.96362,223109
34,mmat11,154,0.06902,53619,24.03265,223109
35,amreshakim,151,0.06768,53770,24.10033,223109
36,brandshaide,130,0.05827,53900,24.15860,223109
37,gvidon,126,0.05647,54026,24.21507,223109
38,liuyuan10,118,0.05289,54144,24.26796,223109
39,brycekahle,103,0.04617,54247,24.31412,223109
40,vannyle,101,0.04527,54348,24.35939,223109
41,ruigulala,94,0.04213,54442,24.40153,223109
42,romanspb80,93,0.04168,54535,24.44321,223109
43,xinyuannn,91,0.04079,54626,24.48400,223109
44,zeffron,82,0.03675,54708,24.52075,223109
45,kvaster,77,0.03451,54785,24.55526,223109
46,CBVenkataReddy,72,0.03227,54857,24.58753,223109
47,navarrothiago,68,0.03048,54925,24.61801,223109
48,zhiyuan0x,67,0.03003,54992,24.64804,223109
49,johngv2,63,0.02824,55055,24.67628,223109
50,rgo3,63,0.02824,55118,24.70452,223109
51,lrouter,60,0.02689,55178,24.73141,223109
52,nyrahul,57,0.02555,55235,24.75696,223109
53,tom-hadlaw-hs,56,0.02510,55291,24.78206,223109
54,chez-shanpu,55,0.02465,55346,24.80671,223109
55,konghui,55,0.02465,55401,24.83136,223109
56,Maddy007-maha,55,0.02465,55456,24.85601,223109
57,l1b0k,54,0.02420,55510,24.88022,223109
58,stevenceuppens,53,0.02376,55563,24.90397,223109
59,abhide15,50,0.02241,55613,24.92638,223109
60,GoGstickGo,46,0.02062,55659,24.94700,223109
61,elfadel,42,0.01882,55701,24.96582,223109
62,eyanulis,41,0.01838,55742,24.98420,223109
63,peiqi-caicloud,40,0.01793,55782,25.00213,223109
64,Ropes,40,0.01793,55822,25.02006,223109
65,vladdy,38,0.01703,55860,25.03709,223109
66,willdeuschle,38,0.01703,55898,25.05412,223109
67,Ankurk99,37,0.01658,55935,25.07071,223109
68,rscampos,37,0.01658,55972,25.08729,223109
69,knfoo,36,0.01614,56008,25.10342,223109
70,borancar,35,0.01569,56043,25.11911,223109
71,PranaviRoy,35,0.01569,56078,25.13480,223109
72,Neelajacques,34,0.01524,56112,25.15004,223109
73,yuriydzobak,34,0.01524,56146,25.16528,223109
74,arthurfabre,33,0.01479,56179,25.18007,223109
75,jraby,33,0.01479,56212,25.19486,223109
76,mskarbek,33,0.01479,56245,25.20965,223109
77,trvll,32,0.01434,56277,25.22399,223109
78,acholt,31,0.01389,56308,25.23789,223109
79,myugan,31,0.01389,56339,25.25178,223109
80,UnwashedMeme,30,0.01345,56369,25.26523,223109
81,weirdwiz,29,0.01300,56398,25.27823,223109
82,gpl,27,0.01210,56425,25.29033,223109
83,martin31821,27,0.01210,56452,25.30243,223109
84,tonylambiris,27,0.01210,56479,25.31453,223109
85,AdamKorcz,26,0.01165,56505,25.32619,223109
86,kovalyukm,26,0.01165,56531,25.33784,223109
87,ybialik,26,0.01165,56557,25.34949,223109
88,CybrPunk,25,0.01121,56582,25.36070,223109
89,joulaud,24,0.01076,56606,25.37146,223109
90,hao-lee,23,0.01031,56629,25.38176,223109
91,iecedge,21,0.00941,56650,25.39118,223109
92,oneiro-naut,21,0.00941,56671,25.40059,223109
93,valas,21,0.00941,56692,25.41000,223109
94,christian-2,20,0.00896,56712,25.41897,223109
95,enzian,20,0.00896,56732,25.42793,223109
96,vsk-coding,20,0.00896,56752,25.43689,223109
97,xyz-li,20,0.00896,56772,25.44586,223109
98,cyrilcros,19,0.00852,56791,25.45437,223109
99,gnahckire,19,0.00852,56810,25.46289,223109
100,jomenxiao,19,0.00852,56829,25.47141,223109
101,nr17,19,0.00852,56848,25.47992,223109
102,sergey-safarov,19,0.00852,56867,25.48844,223109
103,splushii,19,0.00852,56886,25.49695,223109
104,umesh3034,19,0.00852,56905,25.50547,223109
105,zhujik,19,0.00852,56924,25.51399,223109
106,buglloc,17,0.00762,56941,25.52161,223109
107,sugangli,17,0.00762,56958,25.52923,223109
108,takehaya,17,0.00762,56975,25.53685,223109
109,thejosephstevens,17,0.00762,56992,25.54446,223109
110,llivingstone,16,0.00717,57008,25.55164,223109
111,lyveng,16,0.00717,57024,25.55881,223109
112,Mengkzhaoyun,16,0.00717,57040,25.56598,223109
113,nplanel,16,0.00717,57056,25.57315,223109
114,Subreptivus,16,0.00717,57072,25.58032,223109
115,asteven,15,0.00672,57087,25.58704,223109
116,brant4test,15,0.00672,57102,25.59377,223109
117,ByteAlex,15,0.00672,57117,25.60049,223109
118,ddelnano,15,0.00672,57132,25.60721,223109
119,jenningsloy318,15,0.00672,57147,25.61394,223109
120,skuffe,15,0.00672,57162,25.62066,223109
121,sstoner,15,0.00672,57177,25.62738,223109
122,h2cw2l,14,0.00627,57191,25.63366,223109
123,lyind,14,0.00627,57205,25.63993,223109
124,rewiko,14,0.00627,57219,25.64621,223109
125,Robert-Stam,14,0.00627,57233,25.65248,223109
126,simar7,14,0.00627,57247,25.65876,223109
127,tobiaskohlbau,14,0.00627,57261,25.66503,223109
128,uykusuz,14,0.00627,57275,25.67131,223109
129,velp,14,0.00627,57289,25.67758,223109
130,WingkaiHo,14,0.00627,57303,25.68386,223109
131,bretagne-peiqi,13,0.00583,57316,25.68969,223109
132,ChristopherBiscardi,13,0.00583,57329,25.69551,223109
133,f0,13,0.00583,57342,25.70134,223109
134,mpeiffer,13,0.00583,57355,25.70717,223109
135,oujunli,13,0.00583,57368,25.71299,223109
136,rockdaboot,13,0.00583,57381,25.71882,223109
137,b3a-dev,12,0.00538,57393,25.72420,223109
138,Buffer0x7cd,12,0.00538,57405,25.72958,223109
139,camilo-schoeningh-sociomantic,12,0.00538,57417,25.73495,223109
140,dbaumgarten,12,0.00538,57429,25.74033,223109
141,dcasati,12,0.00538,57441,25.74571,223109
142,gaffneyd4,12,0.00538,57453,25.75109,223109
143,imathu,12,0.00538,57465,25.75647,223109
144,nevermosby,12,0.00538,57477,25.76185,223109
145,nzhuang123,12,0.00538,57489,25.76723,223109
146,pszymanski-intel,12,0.00538,57501,25.77260,223109
147,smnmtzgr,12,0.00538,57513,25.77798,223109
148,Starblade42,12,0.00538,57525,25.78336,223109
149,teyuchang,12,0.00538,57537,25.78874,223109
150,whaber,12,0.00538,57549,25.79412,223109
151,arvindsoni80,11,0.00493,57560,25.79905,223109
152,charlyx,11,0.00493,57571,25.80398,223109
153,D1abloRUS,11,0.00493,57582,25.80891,223109
154,dragan,11,0.00493,57593,25.81384,223109
155,fdawg4l,11,0.00493,57604,25.81877,223109
156,flier,11,0.00493,57615,25.82370,223109
157,gecube,11,0.00493,57626,25.82863,223109
158,jamesongithub,11,0.00493,57637,25.83356,223109
159,kh34,11,0.00493,57648,25.83849,223109
160,markpash,11,0.00493,57659,25.84342,223109
161,rpthms,11,0.00493,57670,25.84835,223109
162,SimpCosm,11,0.00493,57681,25.85328,223109
163,smijolovic,11,0.00493,57692,25.85821,223109
164,tbachman,11,0.00493,57703,25.86314,223109
165,wangli8850,11,0.00493,57714,25.86807,223109
166,weizhouBlue,11,0.00493,57725,25.87300,223109
167,yongming,11,0.00493,57736,25.87793,223109
168,ammmk,10,0.00448,57746,25.88242,223109
169,bai,10,0.00448,57756,25.88690,223109
170,blairw-brk,10,0.00448,57766,25.89138,223109
171,BolotskyDev,10,0.00448,57776,25.89586,223109
172,domgoodwin,10,0.00448,57786,25.90034,223109
173,llhhbc,10,0.00448,57796,25.90483,223109
174,MaiReo,10,0.00448,57806,25.90931,223109
175,manojbadam,10,0.00448,57816,25.91379,223109
176,Mierdin,10,0.00448,57826,25.91827,223109
177,mkjpryor,10,0.00448,57836,25.92276,223109
178,ntaylor1781,10,0.00448,57846,25.92724,223109
179,stimmerman,10,0.00448,57856,25.93172,223109
180,tonyluj,10,0.00448,57866,25.93620,223109
181,tushar00jain,10,0.00448,57876,25.94068,223109
182,vignesh-codes,10,0.00448,57886,25.94517,223109
183,wofanli,10,0.00448,57896,25.94965,223109
184,zhiyanfoo,10,0.00448,57906,25.95413,223109
185,bradwhitfield,9,0.00403,57915,25.95816,223109
186,CH-anhngo,9,0.00403,57924,25.96220,223109
187,ChenYahui2019,9,0.00403,57933,25.96623,223109
188,cocatrice,9,0.00403,57942,25.97027,223109
189,Elegant996,9,0.00403,57951,25.97430,223109
190,FirmlyReality,9,0.00403,57960,25.97833,223109
191,gtsjamesbond,9,0.00403,57969,25.98237,223109
192,Jack-qing,9,0.00403,57978,25.98640,223109
193,jochenseeber,9,0.00403,57987,25.99044,223109
194,luanguimaraesla,9,0.00403,57996,25.99447,223109
195,mikeinton,9,0.00403,58005,25.99850,223109
196,nickb937,9,0.00403,58014,26.00254,223109
197,nishantburte,9,0.00403,58023,26.00657,223109
198,raokolagan,9,0.00403,58032,26.01060,223109
199,rreinurm,9,0.00403,58041,26.01464,223109
200,rueian,9,0.00403,58050,26.01867,223109
201,stloma,9,0.00403,58059,26.02271,223109
202,subrnath,9,0.00403,58068,26.02674,223109
203,symphony233,9,0.00403,58077,26.03077,223109
204,thomasdba,9,0.00403,58086,26.03481,223109
205,waynr,9,0.00403,58095,26.03884,223109
206,a-a-abramov,8,0.00359,58103,26.04243,223109
207,ChristineTChen,8,0.00359,58111,26.04601,223109
208,clrxbl,8,0.00359,58119,26.04960,223109
209,djcass44,8,0.00359,58127,26.05318,223109
210,djwmarks2020,8,0.00359,58135,26.05677,223109
211,fnzv,8,0.00359,58143,26.06036,223109
212,folbricht,8,0.00359,58151,26.06394,223109
213,glennWang,8,0.00359,58159,26.06753,223109
214,iii-i,8,0.00359,58167,26.07111,223109
215,juliengk,8,0.00359,58175,26.07470,223109
216,kiranbond,8,0.00359,58183,26.07828,223109
217,mdnix,8,0.00359,58191,26.08187,223109
218,peter-slovak,8,0.00359,58199,26.08546,223109
219,renzhendev,8,0.00359,58207,26.08904,223109
220,rhcu,8,0.00359,58215,26.09263,223109
221,rubenhak,8,0.00359,58223,26.09621,223109
222,Ruilkyu,8,0.00359,58231,26.09980,223109
223,sarveshr7,8,0.00359,58239,26.10338,223109
224,Shinzu,8,0.00359,58247,26.10697,223109
225,vishnugs,8,0.00359,58255,26.11056,223109
226,bluikko,7,0.00314,58262,26.11369,223109
227,brichins,7,0.00314,58269,26.11683,223109
228,daviddyball,7,0.00314,58276,26.11997,223109
229,deesee04,7,0.00314,58283,26.12311,223109
230,fredhsu,7,0.00314,58290,26.12624,223109
231,fvigotti,7,0.00314,58297,26.12938,223109
232,gerl1ng,7,0.00314,58304,26.13252,223109
233,gzdaodao,7,0.00314,58311,26.13566,223109
234,hyunsooda,7,0.00314,58318,26.13879,223109
235,JCahu,7,0.00314,58325,26.14193,223109
236,juan-daishogroup,7,0.00314,58332,26.14507,223109
237,kekoav,7,0.00314,58339,26.14821,223109
238,kenieevan,7,0.00314,58346,26.15134,223109
239,liuqun,7,0.00314,58353,26.15448,223109
240,llussy,7,0.00314,58360,26.15762,223109
241,mellotron,7,0.00314,58367,26.16076,223109
242,miko-epam,7,0.00314,58374,26.16389,223109
243,RaveNoX,7,0.00314,58381,26.16703,223109
244,rkage,7,0.00314,58388,26.17017,223109
245,vdavidoff,7,0.00314,58395,26.17331,223109
246,YesemKebede,7,0.00314,58402,26.17644,223109
247,adamwgray,6,0.00269,58408,26.17913,223109
248,andreek,6,0.00269,58414,26.18182,223109
249,asm76,6,0.00269,58420,26.18451,223109
250,autumn0207,6,0.00269,58426,26.18720,223109
251,bsiravara,6,0.00269,58432,26.18989,223109
252,ChangyuWang,6,0.00269,58438,26.19258,223109
253,ch-dimitri,6,0.00269,58444,26.19527,223109
254,daemon1024,6,0.00269,58450,26.19796,223109
255,donch,6,0.00269,58456,26.20065,223109
256,EPinci,6,0.00269,58462,26.20334,223109
257,fafucoder,6,0.00269,58468,26.20602,223109
258,gandalfmagic,6,0.00269,58474,26.20871,223109
259,gravis,6,0.00269,58480,26.21140,223109
260,guilledipa,6,0.00269,58486,26.21409,223109
261,hamburgerbun,6,0.00269,58492,26.21678,223109
262,izaakschroeder,6,0.00269,58498,26.21947,223109
263,Jasper-Ben,6,0.00269,58504,26.22216,223109
264,jek-a,6,0.00269,58510,26.22485,223109
265,jMuzsik,6,0.00269,58516,26.22754,223109
266,John-Moya,6,0.00269,58522,26.23023,223109
267,karthikt-yahoo,6,0.00269,58528,26.23292,223109
268,kylin-D-ZZ,6,0.00269,58534,26.23561,223109
269,m4rx0,6,0.00269,58540,26.23830,223109
270,mabis,6,0.00269,58546,26.24099,223109
271,manicole,6,0.00269,58552,26.24367,223109
272,mengxifl,6,0.00269,58558,26.24636,223109
273,messiahUA,6,0.00269,58564,26.24905,223109
274,michaelpetrov,6,0.00269,58570,26.25174,223109
275,nberlee,6,0.00269,58576,26.25443,223109
276,netflash,6,0.00269,58582,26.25712,223109
277,ombre9,6,0.00269,58588,26.25981,223109
278,oppopeng,6,0.00269,58594,26.26250,223109
279,petreski,6,0.00269,58600,26.26519,223109
280,PinchasLev,6,0.00269,58606,26.26788,223109
281,rearden-steel,6,0.00269,58612,26.27057,223109
282,seaunderwater,6,0.00269,58618,26.27326,223109
283,sharjeelaziz,6,0.00269,58624,26.27595,223109
284,suyogp30,6,0.00269,58630,26.27864,223109
285,swami-dvr,6,0.00269,58636,26.28132,223109
286,swimablefish,6,0.00269,58642,26.28401,223109
287,unixdaddy,6,0.00269,58648,26.28670,223109
288,xentobias,6,0.00269,58654,26.28939,223109
289,xiajidexue,6,0.00269,58660,26.29208,223109
290,alex-berger,5,0.00224,58665,26.29432,223109
291,alex-solovev,5,0.00224,58670,26.29656,223109
292,amitrintzler,5,0.00224,58675,26.29880,223109
293,christiancloudical,5,0.00224,58680,26.30105,223109
294,csomm,5,0.00224,58685,26.30329,223109
295,CXinsect,5,0.00224,58690,26.30553,223109
296,donghaichuan,5,0.00224,58695,26.30777,223109
297,eldin77,5,0.00224,58700,26.31001,223109
298,frelon,5,0.00224,58705,26.31225,223109
299,gowthamkarthick,5,0.00224,58710,26.31449,223109
300,huntermassey,5,0.00224,58715,26.31673,223109
301,Joerg-Tech,5,0.00224,58720,26.31897,223109
302,juanmanuel-tirado,5,0.00224,58725,26.32122,223109
303,kbkm,5,0.00224,58730,26.32346,223109
304,kevholditch-f3,5,0.00224,58735,26.32570,223109
305,LeoQuote,5,0.00224,58740,26.32794,223109
306,lic17,5,0.00224,58745,26.33018,223109
307,MahaPanch,5,0.00224,58750,26.33242,223109
308,maxaudron,5,0.00224,58755,26.33466,223109
309,mikefaraponov,5,0.00224,58760,26.33690,223109
310,msibrichins,5,0.00224,58765,26.33914,223109
311,nebulon42,5,0.00224,58770,26.34138,223109
312,ppancake,5,0.00224,58775,26.34363,223109
313,r3mattia,5,0.00224,58780,26.34587,223109
314,RobertTheProfessional,5,0.00224,58785,26.34811,223109
315,roodkcab,5,0.00224,58790,26.35035,223109
316,runiq,5,0.00224,58795,26.35259,223109
317,rustrial,5,0.00224,58800,26.35483,223109
318,salbertson,5,0.00224,58805,26.35707,223109
319,samling,5,0.00224,58810,26.35931,223109
320,Sen666666,5,0.00224,58815,26.36155,223109
321,seraphsea,5,0.00224,58820,26.36380,223109
322,SleepingShell,5,0.00224,58825,26.36604,223109
323,spyder-ian,5,0.00224,58830,26.36828,223109
324,toptai,5,0.00224,58835,26.37052,223109
325,UbiquitousBear,5,0.00224,58840,26.37276,223109
326,vishjain,5,0.00224,58845,26.37500,223109
327,vpnachev,5,0.00224,58850,26.37724,223109
328,whl739,5,0.00224,58855,26.37948,223109
329,xlejo,5,0.00224,58860,26.38172,223109
330,yanirj,5,0.00224,58865,26.38396,223109
331,yiannisy,5,0.00224,58870,26.38621,223109
332,zhangjianghua,5,0.00224,58875,26.38845,223109
333,adityabond,4,0.00179,58879,26.39024,223109
334,aryantaheri,4,0.00179,58883,26.39203,223109
335,braudel,4,0.00179,58887,26.39383,223109
336,ChaosEternal,4,0.00179,58891,26.39562,223109
337,chenger,4,0.00179,58895,26.39741,223109
338,code-merc,4,0.00179,58899,26.39920,223109
339,Combustible,4,0.00179,58903,26.40100,223109
340,csturgess93,4,0.00179,58907,26.40279,223109
341,cuonglm,4,0.00179,58911,26.40458,223109
342,DaveWK,4,0.00179,58915,26.40638,223109
343,David0922,4,0.00179,58919,26.40817,223109
344,dbirks,4,0.00179,58923,26.40996,223109
345,djboris9,4,0.00179,58927,26.41175,223109
346,dthaler,4,0.00179,58931,26.41355,223109
347,egsysoev,4,0.00179,58935,26.41534,223109
348,elfring,4,0.00179,58939,26.41713,223109
349,enkov,4,0.00179,58943,26.41893,223109
350,firemiles,4,0.00179,58947,26.42072,223109
351,hz-kelpie,4,0.00179,58951,26.42251,223109
352,leguandemomotou,4,0.00179,58955,26.42430,223109
353,linecolumn,4,0.00179,58959,26.42610,223109
354,LuigiBaute,4,0.00179,58963,26.42789,223109
355,mariuskiessling,4,0.00179,58967,26.42968,223109
356,mehrdadrad,4,0.00179,58971,26.43148,223109
357,msheldyakov,4,0.00179,58975,26.43327,223109
358,nam-jaehyun,4,0.00179,58979,26.43506,223109
359,oivindoh,4,0.00179,58983,26.43685,223109
360,owainow,4,0.00179,58987,26.43865,223109
361,renaudhager,4,0.00179,58991,26.44044,223109
362,reneluria,4,0.00179,58995,26.44223,223109
363,rock-andy,4,0.00179,58999,26.44403,223109
364,rootkamil,4,0.00179,59003,26.44582,223109
365,ScottKGregory,4,0.00179,59007,26.44761,223109
366,sebfaerber,4,0.00179,59011,26.44940,223109
367,skurfuerst,4,0.00179,59015,26.45120,223109
368,thefallentree,4,0.00179,59019,26.45299,223109
369,Vacant0mens,4,0.00179,59023,26.45478,223109
370,vifino,4,0.00179,59027,26.45658,223109
371,vniche,4,0.00179,59031,26.45837,223109
372,ysksuzuki,4,0.00179,59035,26.46016,223109
373,zez3,4,0.00179,59039,26.46195,223109
374,0xcaff,3,0.00134,59042,26.46330,223109
375,aigarm,3,0.00134,59045,26.46464,223109
376,AirbornWdd,3,0.00134,59048,26.46599,223109
377,ajitre,3,0.00134,59051,26.46733,223109
378,alandtsang,3,0.00134,59054,26.46868,223109
379,amorenoz,3,0.00134,59057,26.47002,223109
380,ankurkothiwal,3,0.00134,59060,26.47137,223109
381,arnoldpistorius,3,0.00134,59063,26.47271,223109
382,arzarif,3,0.00134,59066,26.47406,223109
383,asannes,3,0.00134,59069,26.47540,223109
384,bobbui,3,0.00134,59072,26.47674,223109
385,bruun365,3,0.00134,59075,26.47809,223109
386,CentUser,3,0.00134,59078,26.47943,223109
387,charlesgreat,3,0.00134,59081,26.48078,223109
388,chrismessiah,3,0.00134,59084,26.48212,223109
389,cjmakes,3,0.00134,59087,26.48347,223109
390,cmacrae,3,0.00134,59090,26.48481,223109
391,Cordius,3,0.00134,59093,26.48616,223109
392,craigbryson,3,0.00134,59096,26.48750,223109
393,cryptk,3,0.00134,59099,26.48885,223109
394,ctrahey,3,0.00134,59102,26.49019,223109
395,dhawaskar,3,0.00134,59105,26.49154,223109
396,dhsathiya,3,0.00134,59108,26.49288,223109
397,dimitri-fert,3,0.00134,59111,26.49422,223109
398,dotSlashLu,3,0.00134,59114,26.49557,223109
399,elagree,3,0.00134,59117,26.49691,223109
400,etherandrius,3,0.00134,59120,26.49826,223109
401,fabianallendorf,3,0.00134,59123,26.49960,223109
402,fahlke,3,0.00134,59126,26.50095,223109
403,felixheinonen,3,0.00134,59129,26.50229,223109
404,Gui774ume,3,0.00134,59132,26.50364,223109
405,haoyixin,3,0.00134,59135,26.50498,223109
406,hazelnutsgz,3,0.00134,59138,26.50633,223109
407,iAklis,3,0.00134,59141,26.50767,223109
408,iczero,3,0.00134,59144,26.50902,223109
409,imran-kn,3,0.00134,59147,26.51036,223109
410,ipochi,3,0.00134,59150,26.51171,223109
411,Jakob3xD,3,0.00134,59153,26.51305,223109
412,jhead-slg,3,0.00134,59156,26.51439,223109
413,jose-ledesma,3,0.00134,59159,26.51574,223109
414,LiangZhou-CTY,3,0.00134,59162,26.51708,223109
415,LinFCai,3,0.00134,59165,26.51843,223109
416,liweilun0408,3,0.00134,59168,26.51977,223109
417,MaciejGawel,3,0.00134,59171,26.52112,223109
418,Managarmrr,3,0.00134,59174,26.52246,223109
419,mxdblcf,3,0.00134,59177,26.52381,223109
420,narun4sk,3,0.00134,59180,26.52515,223109
421,NBruijn,3,0.00134,59183,26.52650,223109
422,noe-charmet,3,0.00134,59186,26.52784,223109
423,othmane399,3,0.00134,59189,26.52919,223109
424,pedro823,3,0.00134,59192,26.53053,223109
425,psinghal04,3,0.00134,59195,26.53187,223109
426,PTEpzb,3,0.00134,59198,26.53322,223109
427,Purushotham233,3,0.00134,59201,26.53456,223109
428,ReillyTevera,3,0.00134,59204,26.53591,223109
429,riccardomanfrin,3,0.00134,59207,26.53725,223109
430,rkulow,3,0.00134,59210,26.53860,223109
431,rohit0718,3,0.00134,59213,26.53994,223109
432,roko99,3,0.00134,59216,26.54129,223109
433,sakharovaan,3,0.00134,59219,26.54263,223109
434,samueltorres,3,0.00134,59222,26.54398,223109
435,sdhoward,3,0.00134,59225,26.54532,223109
436,sduranc,3,0.00134,59228,26.54667,223109
437,seanpowell-f5,3,0.00134,59231,26.54801,223109
438,sedooe,3,0.00134,59234,26.54935,223109
439,sunvim,3,0.00134,59237,26.55070,223109
440,timricese,3,0.00134,59240,26.55204,223109
441,tjamet,3,0.00134,59243,26.55339,223109
442,ToroNZ,3,0.00134,59246,26.55473,223109
443,ulm0,3,0.00134,59249,26.55608,223109
444,Vesnica,3,0.00134,59252,26.55742,223109
445,wazir-ahmed,3,0.00134,59255,26.55877,223109
446,wenma,3,0.00134,59258,26.56011,223109
447,wsdlll,3,0.00134,59261,26.56146,223109
448,xeviknal,3,0.00134,59264,26.56280,223109
449,yarochewsky,3,0.00134,59267,26.56415,223109
450,yeze,3,0.00134,59270,26.56549,223109
451,yunbo-xufeng,3,0.00134,59273,26.56684,223109
452,abckey,2,0.00090,59275,26.56773,223109
453,AkkyOrz,2,0.00090,59277,26.56863,223109
454,amilanoski,2,0.00090,59279,26.56952,223109
455,ankit-ls,2,0.00090,59281,26.57042,223109
456,antonyantony,2,0.00090,59283,26.57132,223109
457,arpit1912,2,0.00090,59285,26.57221,223109
458,asgarciap,2,0.00090,59287,26.57311,223109
459,azyobuzin,2,0.00090,59289,26.57401,223109
460,barath1997,2,0.00090,59291,26.57490,223109
461,batistein,2,0.00090,59293,26.57580,223109
462,bh90210,2,0.00090,59295,26.57670,223109
463,bianhua2015,2,0.00090,59297,26.57759,223109
464,blankburian,2,0.00090,59299,26.57849,223109
465,blanquicet,2,0.00090,59301,26.57938,223109
466,blinkiz,2,0.00090,59303,26.58028,223109
467,bobcob7,2,0.00090,59305,26.58118,223109
468,Bun,2,0.00090,59307,26.58207,223109
469,CadenOf,2,0.00090,59309,26.58297,223109
470,chilcano,2,0.00090,59311,26.58387,223109
471,CitadelCore,2,0.00090,59313,26.58476,223109
472,citosid,2,0.00090,59315,26.58566,223109
473,clamchowder,2,0.00090,59317,26.58656,223109
474,cristi-,2,0.00090,59319,26.58745,223109
475,Cyrus008,2,0.00090,59321,26.58835,223109
476,darkdatter,2,0.00090,59323,26.58925,223109
477,dawgwe1,2,0.00090,59325,26.59014,223109
478,designanderror,2,0.00090,59327,26.59104,223109
479,devidasjadhav,2,0.00090,59329,26.59193,223109
480,Dixon3,2,0.00090,59331,26.59283,223109
481,dmusicant-dk,2,0.00090,59333,26.59373,223109
482,dominik318,2,0.00090,59335,26.59462,223109
483,dorkolog,2,0.00090,59337,26.59552,223109
484,dsx,2,0.00090,59339,26.59642,223109
485,emogua,2,0.00090,59341,26.59731,223109
486,enicholson125,2,0.00090,59343,26.59821,223109
487,eyvind,2,0.00090,59345,26.59911,223109
488,FlogFr,2,0.00090,59347,26.60000,223109
489,fnature,2,0.00090,59349,26.60090,223109
490,fr19k,2,0.00090,59351,26.60180,223109
491,fruffy,2,0.00090,59353,26.60269,223109
492,GabrielAlacchi,2,0.00090,59355,26.60359,223109
493,gaurang2001,2,0.00090,59357,26.60448,223109
494,githubcdr,2,0.00090,59359,26.60538,223109
495,gretel,2,0.00090,59361,26.60628,223109
496,guotie,2,0.00090,59363,26.60717,223109
497,hichihara,2,0.00090,59365,26.60807,223109
498,hittingnote,2,0.00090,59367,26.60897,223109
499,hmassey-ts,2,0.00090,59369,26.60986,223109
500,HuxyUK,2,0.00090,59371,26.61076,223109
501,iam-TJ,2,0.00090,59373,26.61166,223109
502,IgorSor,2,0.00090,59375,26.61255,223109
503,internetionals,2,0.00090,59377,26.61345,223109
504,James203,2,0.00090,59379,26.61435,223109
505,jiaxuanzhou,2,0.00090,59381,26.61524,223109
506,joebowbeerxealth,2,0.00090,59383,26.61614,223109
507,joe-carpenter,2,0.00090,59385,26.61703,223109
508,jony-one,2,0.00090,59387,26.61793,223109
509,jsdelivrbot,2,0.00090,59389,26.61883,223109
510,juliuss86,2,0.00090,59391,26.61972,223109
511,kailunshi,2,0.00090,59393,26.62062,223109
512,kbaegis,2,0.00090,59395,26.62152,223109
513,ken-letter,2,0.00090,59397,26.62241,223109
514,krishnabigdata,2,0.00090,59399,26.62331,223109
515,leonliao,2,0.00090,59401,26.62421,223109
516,maq123,2,0.00090,59403,26.62510,223109
517,marshalWS,2,0.00090,59405,26.62600,223109
518,mehrdadpfg,2,0.00090,59407,26.62690,223109
519,milipili,2,0.00090,59409,26.62779,223109
520,mmisono,2,0.00090,59411,26.62869,223109
521,mmochan,2,0.00090,59413,26.62958,223109
522,mpdude,2,0.00090,59415,26.63048,223109
523,mstarostik,2,0.00090,59417,26.63138,223109
524,mwalle,2,0.00090,59419,26.63227,223109
525,mysticaltech,2,0.00090,59421,26.63317,223109
526,mzahorik,2,0.00090,59423,26.63407,223109
527,naude-r,2,0.00090,59425,26.63496,223109
528,ncolesummers,2,0.00090,59427,26.63586,223109
529,nnahaliel,2,0.00090,59429,26.63676,223109
530,opengers,2,0.00090,59431,26.63765,223109
531,palsivertsen,2,0.00090,59433,26.63855,223109
532,pandarun,2,0.00090,59435,26.63945,223109
533,PaulFurtado,2,0.00090,59437,26.64034,223109
534,pavels,2,0.00090,59439,26.64124,223109
535,phongvdoan,2,0.00090,59441,26.64213,223109
536,pielu,2,0.00090,59443,26.64303,223109
537,platten,2,0.00090,59445,26.64393,223109
538,qingyunha,2,0.00090,59447,26.64482,223109
539,qLb,2,0.00090,59449,26.64572,223109
540,raghus-hub,2,0.00090,59451,26.64662,223109
541,ryanmt,2,0.00090,59453,26.64751,223109
542,sharlns,2,0.00090,59455,26.64841,223109
543,shayn1234,2,0.00090,59457,26.64931,223109
544,Shreyas1717,2,0.00090,59459,26.65020,223109
545,siqidu,2,0.00090,59461,26.65110,223109
546,sleerssen,2,0.00090,59463,26.65200,223109
547,svenschnelle,2,0.00090,59465,26.65289,223109
548,Svinto,2,0.00090,59467,26.65379,223109
549,sznmaran,2,0.00090,59469,26.65468,223109
550,tardich,2,0.00090,59471,26.65558,223109
551,thanhlong9x,2,0.00090,59473,26.65648,223109
552,thehunt33r,2,0.00090,59475,26.65737,223109
553,tomaik,2,0.00090,59477,26.65827,223109
554,tommyp1ckles,2,0.00090,59479,26.65917,223109
555,trinhpham,2,0.00090,59481,26.66006,223109
556,vietwow,2,0.00090,59483,26.66096,223109
557,voatsap,2,0.00090,59485,26.66186,223109
558,xaque208,2,0.00090,59487,26.66275,223109
559,XieGP,2,0.00090,59489,26.66365,223109
560,yorg1st,2,0.00090,59491,26.66455,223109
561,Zebaz,2,0.00090,59493,26.66544,223109
562,zhengzepeng,2,0.00090,59495,26.66634,223109
563,aceqbaceq,1,0.00045,59496,26.66679,223109
564,adamskibickipd,1,0.00045,59497,26.66723,223109
565,adriananeci,1,0.00045,59498,26.66768,223109
566,akubala,1,0.00045,59499,26.66813,223109
567,alexanderheckel,1,0.00045,59500,26.66858,223109
568,alexminder,1,0.00045,59501,26.66903,223109
569,alkarp,1,0.00045,59502,26.66948,223109
570,allanyung,1,0.00045,59503,26.66992,223109
571,amit-handa,1,0.00045,59504,26.67037,223109
572,amon-ra,1,0.00045,59505,26.67082,223109
573,amstee,1,0.00045,59506,26.67127,223109
574,anemptyair,1,0.00045,59507,26.67172,223109
575,annajeanine,1,0.00045,59508,26.67216,223109
576,Anna-Katona,1,0.00045,59509,26.67261,223109
577,anunay007,1,0.00045,59510,26.67306,223109
578,ArsenyBelorukov,1,0.00045,59511,26.67351,223109
579,ascendedco,1,0.00045,59512,26.67396,223109
580,AttilaUngvari,1,0.00045,59513,26.67441,223109
581,audrey-bond,1,0.00045,59514,26.67485,223109
582,azat,1,0.00045,59515,26.67530,223109
583,azenk,1,0.00045,59516,26.67575,223109
584,BeeHoh,1,0.00045,59517,26.67620,223109
585,benjaminp,1,0.00045,59518,26.67665,223109
586,betula,1,0.00045,59519,26.67710,223109
587,bigg01,1,0.00045,59520,26.67754,223109
588,bikram20,1,0.00045,59521,26.67799,223109
589,brandon-mcrae-hs,1,0.00045,59522,26.67844,223109
590,brandt,1,0.00045,59523,26.67889,223109
591,brunomiguelcustodioform3,1,0.00045,59524,26.67934,223109
592,BurlyLuo,1,0.00045,59525,26.67978,223109
593,burton1982,1,0.00045,59526,26.68023,223109
594,bycEEE,1,0.00045,59527,26.68068,223109
595,cblomart,1,0.00045,59528,26.68113,223109
596,ceridwen,1,0.00045,59529,26.68158,223109
597,cgoudie,1,0.00045,59530,26.68203,223109
598,champtar,1,0.00045,59531,26.68247,223109
599,chenhengqi,1,0.00045,59532,26.68292,223109
600,chgl,1,0.00045,59533,26.68337,223109
601,chingyi-lin,1,0.00045,59534,26.68382,223109
602,CiiDyR,1,0.00045,59535,26.68427,223109
603,ckuduvalli,1,0.00045,59536,26.68471,223109
604,clarence-zhou,1,0.00045,59537,26.68516,223109
605,clcc2019,1,0.00045,59538,26.68561,223109
606,clementnuss,1,0.00045,59539,26.68606,223109
607,cndoit18,1,0.00045,59540,26.68651,223109
608,cokabug,1,0.00045,59541,26.68696,223109
609,Croissong,1,0.00045,59542,26.68740,223109
610,crystal-leesj,1,0.00045,59543,26.68785,223109
611,damnwidget,1,0.00045,59544,26.68830,223109
612,danielsand,1,0.00045,59545,26.68875,223109
613,Danielybl,1,0.00045,59546,26.68920,223109
614,davetashner,1,0.00045,59547,26.68964,223109
615,DavidLeeUX,1,0.00045,59548,26.69009,223109
616,davitmadoyan,1,0.00045,59549,26.69054,223109
617,dcorbe,1,0.00045,59550,26.69099,223109
618,debMan,1,0.00045,59551,26.69144,223109
619,DevAndrewGeorge,1,0.00045,59552,26.69189,223109
620,digibank-rons,1,0.00045,59553,26.69233,223109
621,dimitri,1,0.00045,59554,26.69278,223109
622,dinh-linux,1,0.00045,59555,26.69323,223109
623,divfor,1,0.00045,59556,26.69368,223109
624,divialth,1,0.00045,59557,26.69413,223109
625,d-m,1,0.00045,59558,26.69458,223109
626,DockToFuture,1,0.00045,59559,26.69502,223109
627,douglmil,1,0.00045,59560,26.69547,223109
628,dunnleaddress,1,0.00045,59561,26.69592,223109
629,dwdrajesh,1,0.00045,59562,26.69637,223109
630,e36-cicd,1,0.00045,59563,26.69682,223109
631,edgarriba,1,0.00045,59564,26.69726,223109
632,efenex,1,0.00045,59565,26.69771,223109
633,egoisz,1,0.00045,59566,26.69816,223109
634,eleblebici,1,0.00045,59567,26.69861,223109
635,Erisa,1,0.00045,59568,26.69906,223109
636,Ewocker,1,0.00045,59569,26.69951,223109
637,faicker,1,0.00045,59570,26.69995,223109
638,fbegyn,1,0.00045,59571,26.70040,223109
639,fkpwolf,1,0.00045,59572,26.70085,223109
640,frcai,1,0.00045,59573,26.70130,223109
641,ftiannew,1,0.00045,59574,26.70175,223109
642,G3ph4z,1,0.00045,59575,26.70219,223109
643,GalSagie,1,0.00045,59576,26.70264,223109
644,geekifier,1,0.00045,59577,26.70309,223109
645,GingerGeek,1,0.00045,59578,26.70354,223109
646,githubixx,1,0.00045,59579,26.70399,223109
647,gjmzj,1,0.00045,59580,26.70444,223109
648,grahamoptibrium,1,0.00045,59581,26.70488,223109
649,grealish,1,0.00045,59582,26.70533,223109
650,guodongzz,1,0.00045,59583,26.70578,223109
651,gurayyildirim,1,0.00045,59584,26.70623,223109
652,Gyeah11,1,0.00045,59585,26.70668,223109
653,HackToHell,1,0.00045,59586,26.70713,223109
654,hanipouspilot,1,0.00045,59587,26.70757,223109
655,haraldsk,1,0.00045,59588,26.70802,223109
656,hardoverflow,1,0.00045,59589,26.70847,223109
657,hariharan-a,1,0.00045,59590,26.70892,223109
658,helix-loop,1,0.00045,59591,26.70937,223109
659,henrysfx,1,0.00045,59592,26.70981,223109
660,hodgesds,1,0.00045,59593,26.71026,223109
661,hoeg,1,0.00045,59594,26.71071,223109
662,hongfeioo,1,0.00045,59595,26.71116,223109
663,Houwenda,1,0.00045,59596,26.71161,223109
664,imilchev,1,0.00045,59597,26.71206,223109
665,intel-dlanders,1,0.00045,59598,26.71250,223109
666,invalid-email-address,1,0.00045,59599,26.71295,223109
667,IronCore864,1,0.00045,59600,26.71340,223109
668,ishaannarang,1,0.00045,59601,26.71385,223109
669,ivgenich73,1,0.00045,59602,26.71430,223109
670,jakuub42,1,0.00045,59603,26.71474,223109
671,jan2ary,1,0.00045,59604,26.71519,223109
672,jaysiyani,1,0.00045,59605,26.71564,223109
673,jcodybaker,1,0.00045,59606,26.71609,223109
674,jedblack,1,0.00045,59607,26.71654,223109
675,jelisejev,1,0.00045,59608,26.71699,223109
676,jellor,1,0.00045,59609,26.71743,223109
677,jhutchins,1,0.00045,59610,26.71788,223109
678,JigneshVasoya3292,1,0.00045,59611,26.71833,223109
679,jmcdonagh,1,0.00045,59612,26.71878,223109
680,johnlanni,1,0.00045,59613,26.71923,223109
681,johnnyrun,1,0.00045,59614,26.71968,223109
682,Joshi425,1,0.00045,59615,26.72012,223109
683,jpmondet,1,0.00045,59616,26.72057,223109
684,jshin47,1,0.00045,59617,26.72102,223109
685,juergenthomann,1,0.00045,59618,26.72147,223109
686,JukieWalsh,1,0.00045,59619,26.72192,223109
687,jxiaobin,1,0.00045,59620,26.72236,223109
688,k3a,1,0.00045,59621,26.72281,223109
689,kangco-de,1,0.00045,59622,26.72326,223109
690,katherinealbany,1,0.00045,59623,26.72371,223109
691,kolloch,1,0.00045,59624,26.72416,223109
692,krasenn,1,0.00045,59625,26.72461,223109
693,kstiehl,1,0.00045,59626,26.72505,223109
694,kubebc,1,0.00045,59627,26.72550,223109
695,kvalo,1,0.00045,59628,26.72595,223109
696,lachlanmunro,1,0.00045,59629,26.72640,223109
697,Lakers817,1,0.00045,59630,26.72685,223109
698,lemaral,1,0.00045,59631,26.72729,223109
699,lgbaldoni,1,0.00045,59632,26.72774,223109
700,lgogolin,1,0.00045,59633,26.72819,223109
701,liqd1,1,0.00045,59634,26.72864,223109
702,LucasRouckhout,1,0.00045,59635,26.72909,223109
703,lucioveloso,1,0.00045,59636,26.72954,223109
704,LuckySB,1,0.00045,59637,26.72998,223109
705,Lyt99,1,0.00045,59638,26.73043,223109
706,malikkirchner,1,0.00045,59639,26.73088,223109
707,mannytoledo,1,0.00045,59640,26.73133,223109
708,MarkPash,1,0.00045,59641,26.73178,223109
709,MartijnStraatman,1,0.00045,59642,26.73223,223109
710,marty-buly,1,0.00045,59643,26.73267,223109
711,massoudasadi,1,0.00045,59644,26.73312,223109
712,matin-nayob,1,0.00045,59645,26.73357,223109
713,mbugeia,1,0.00045,59646,26.73402,223109
714,Meai,1,0.00045,59647,26.73447,223109
715,mehranhadidi,1,0.00045,59648,26.73491,223109
716,mengzhuo,1,0.00045,59649,26.73536,223109
717,mevam,1,0.00045,59650,26.73581,223109
718,michaelasp,1,0.00045,59651,26.73626,223109
719,michaelforney,1,0.00045,59652,26.73671,223109
720,mikberg,1,0.00045,59653,26.73716,223109
721,miynat,1,0.00045,59654,26.73760,223109
722,mkindalov,1,0.00045,59655,26.73805,223109
723,mlvzk,1,0.00045,59656,26.73850,223109
724,mmr,1,0.00045,59657,26.73895,223109
725,mogindi,1,0.00045,59658,26.73940,223109
726,mohahmed13,1,0.00045,59659,26.73984,223109
727,montaguethomas,1,0.00045,59660,26.74029,223109
728,morlay,1,0.00045,59661,26.74074,223109
729,MrCull,1,0.00045,59662,26.74119,223109
730,MS52390,1,0.00045,59663,26.74164,223109
731,mtneug,1,0.00045,59664,26.74209,223109
732,murphye,1,0.00045,59665,26.74253,223109
733,MUzairS15,1,0.00045,59666,26.74298,223109
734,nailuenlue,1,0.00045,59667,26.74343,223109
735,nanzhong,1,0.00045,59668,26.74388,223109
736,narehayrapetyan,1,0.00045,59669,26.74433,223109
737,natim626,1,0.00045,59670,26.74477,223109
738,nea,1,0.00045,59671,26.74522,223109
739,netjordan,1,0.00045,59672,26.74567,223109
740,nickray,1,0.00045,59673,26.74612,223109
741,Nigma1337,1,0.00045,59674,26.74657,223109
742,nmcfaul,1,0.00045,59675,26.74702,223109
743,nniehoff,1,0.00045,59676,26.74746,223109
744,ntx-ben,1,0.00045,59677,26.74791,223109
745,Nyatsume,1,0.00045,59678,26.74836,223109
746,okanaganrusty,1,0.00045,59679,26.74881,223109
747,okeer,1,0.00045,59680,26.74926,223109
748,Palerion,1,0.00045,59681,26.74971,223109
749,paolodedios,1,0.00045,59682,26.75015,223109
750,pavelmachek,1,0.00045,59683,26.75060,223109
751,pierrecdn,1,0.00045,59684,26.75105,223109
752,pmahoney,1,0.00045,59685,26.75150,223109
753,puppet-py,1,0.00045,59686,26.75195,223109
754,racarvalho1987,1,0.00045,59687,26.75239,223109
755,RamAnvesh,1,0.00045,59688,26.75284,223109
756,ravkishu,1,0.00045,59689,26.75329,223109
757,RayRay10460,1,0.00045,59690,26.75374,223109
758,rcorrear,1,0.00045,59691,26.75419,223109
759,ReillyBrogan,1,0.00045,59692,26.75464,223109
760,revolutionlabs,1,0.00045,59693,26.75508,223109
761,Rishav0809,1,0.00045,59694,26.75553,223109
762,rjwysocki,1,0.00045,59695,26.75598,223109
763,rnsv,1,0.00045,59696,26.75643,223109
764,robodendron,1,0.00045,59697,26.75688,223109
765,roobre,1,0.00045,59698,26.75732,223109
766,Sangu80,1,0.00045,59699,26.75777,223109
767,sauercrowd,1,0.00045,59700,26.75822,223109
768,schamane,1,0.00045,59701,26.75867,223109
769,schmurfy,1,0.00045,59702,26.75912,223109
770,sciolgono,1,0.00045,59703,26.75957,223109
771,scopher128,1,0.00045,59704,26.76001,223109
772,sdxdata,1,0.00045,59705,26.76046,223109
773,secustor,1,0.00045,59706,26.76091,223109
774,seungsoo-lee,1,0.00045,59707,26.76136,223109
775,sharkymcdongles,1,0.00045,59708,26.76181,223109
776,shenshouer,1,0.00045,59709,26.76226,223109
777,shib1000,1,0.00045,59710,26.76270,223109
778,shosti,1,0.00045,59711,26.76315,223109
779,shrkamat,1,0.00045,59712,26.76360,223109
780,skgsergio,1,0.00045,59713,26.76405,223109
781,sogrady,1,0.00045,59714,26.76450,223109
782,springroll12,1,0.00045,59715,26.76494,223109
783,SPYFF,1,0.00045,59716,26.76539,223109
784,sramabad1,1,0.00045,59717,26.76584,223109
785,srinathhs,1,0.00045,59718,26.76629,223109
786,srinicrick65,1,0.00045,59719,26.76674,223109
787,stafordtituss,1,0.00045,59720,26.76719,223109
788,stefan-caraiman,1,0.00045,59721,26.76763,223109
789,swapnilpotnis,1,0.00045,59722,26.76808,223109
790,swift1911,1,0.00045,59723,26.76853,223109
791,taktv6,1,0.00045,59724,26.76898,223109
792,theminecoder,1,0.00045,59725,26.76943,223109
793,thyn,1,0.00045,59726,26.76987,223109
794,tmthrgd,1,0.00045,59727,26.77032,223109
795,trevorrobertsjr,1,0.00045,59728,26.77077,223109
796,TrevorRobertsJr,1,0.00045,59729,26.77122,223109
797,trynity,1,0.00045,59730,26.77167,223109
798,tumasgiu,1,0.00045,59731,26.77212,223109
799,uhthomas,1,0.00045,59732,26.77256,223109
800,ukcuf,1,0.00045,59733,26.77301,223109
801,ulfox,1,0.00045,59734,26.77346,223109
802,utku-kigroup,1,0.00045,59735,26.77391,223109
803,vaibhavmew,1,0.00045,59736,26.77436,223109
804,ve2xe4,1,0.00045,59737,26.77481,223109
805,VerosK,1,0.00045,59738,26.77525,223109
806,verysonglaa,1,0.00045,59739,26.77570,223109
807,viveksahu26,1,0.00045,59740,26.77615,223109
808,vjykrthk,1,0.00045,59741,26.77660,223109
809,vosdev,1,0.00045,59742,26.77705,223109
810,wallies,1,0.00045,59743,26.77749,223109
811,wangyi1310,1,0.00045,59744,26.77794,223109
812,warbaque,1,0.00045,59745,26.77839,223109
813,Waret,1,0.00045,59746,26.77884,223109
814,wenxinlee2015,1,0.00045,59747,26.77929,223109
815,westonsteimel,1,0.00045,59748,26.77974,223109
816,will,1,0.00045,59749,26.78018,223109
817,XDMonkey,1,0.00045,59750,26.78063,223109
818,xs3c,1,0.00045,59751,26.78108,223109
819,xu1zhou,1,0.00045,59752,26.78153,223109
820,xylk256,1,0.00045,59753,26.78198,223109
821,yanivagman,1,0.00045,59754,26.78242,223109
822,yuzibo,1,0.00045,59755,26.78287,223109
823,zachidan,1,0.00045,59756,26.78332,223109
824,ZaMaZaN4iK,1,0.00045,59757,26.78377,223109
825,zf1575192187,1,0.00045,59758,26.78422,223109
826,zhangyongsu,1,0.00045,59759,26.78467,223109
827,zweizeichen,1,0.00045,59760,26.78511,223109
