rank_number,actor,contributions,percent,cumulative_sum,cumulative_percent,all_contributions
1,amanbha,2468,4.15041,2468,4.15041,59464
2,wcs1only,2227,3.74512,4695,7.89553,59464
3,AaronCrawfis,2157,3.62740,6852,11.52294,59464
4,mukundansundar,1870,3.14476,8722,14.66770,59464
5,shalabhms,1559,2.62175,10281,17.28945,59464
6,orizohar,1518,2.55281,11799,19.84226,59464
7,msfussell,1486,2.49899,13285,22.34125,59464
8,LMWF,1195,2.00962,14480,24.35087,59464
9,vinayada1,1162,1.95412,15642,26.30499,59464
10,pruthvidhodda,806,1.35544,16448,27.66043,59464
11,berndverst,673,1.13178,17121,28.79221,59464
12,jjcollinge,556,0.93502,17677,29.72723,59464
13,CodeMonkeyLeet,515,0.86607,18192,30.59330,59464
14,halspang,461,0.77526,18653,31.36856,59464
15,1046102779,318,0.53478,18971,31.90334,59464
16,greenie-msft,285,0.47928,19256,32.38262,59464
17,RicardoNiepel,265,0.44565,19521,32.82827,59464
18,XavierGeerinck,195,0.32793,19716,33.15620,59464
19,Haishi2016,189,0.31784,19905,33.47403,59464
20,jigargandhi,186,0.31279,20091,33.78683,59464
21,beiwei30,182,0.30607,20273,34.09290,59464
22,Taction,178,0.29934,20451,34.39224,59464
23,willdavsmith,169,0.28421,20620,34.67644,59464
24,DarqueWarrior,161,0.27075,20781,34.94719,59464
25,willtsai,145,0.24385,20926,35.19104,59464
26,fjvela,117,0.19676,21043,35.38780,59464
27,tanvigour,116,0.19508,21159,35.58287,59464
28,newbe36524,106,0.17826,21265,35.76113,59464
29,akkie,97,0.16312,21362,35.92426,59464
30,amolenk,97,0.16312,21459,36.08738,59464
31,ItalyPaleAle,96,0.16144,21555,36.24882,59464
32,ksivamuthu,94,0.15808,21649,36.40690,59464
33,georgestevens99,92,0.15472,21741,36.56162,59464
34,chinzhiweiblank,91,0.15303,21832,36.71465,59464
35,ryanvolum,87,0.14631,21919,36.86096,59464
36,javageek79,80,0.13454,21999,36.99549,59464
37,shaggygi,77,0.12949,22076,37.12498,59464
38,abogdanov37,76,0.12781,22152,37.25279,59464
39,codeputer,76,0.12781,22228,37.38060,59464
40,lynn-orrell,75,0.12613,22303,37.50673,59464
41,emptymalei,72,0.12108,22375,37.62781,59464
42,yittg,70,0.11772,22445,37.74553,59464
43,fbeltrao,66,0.11099,22511,37.85652,59464
44,cshi0,65,0.10931,22576,37.96583,59464
45,dybxin,64,0.10763,22640,38.07346,59464
46,luckyxiaoqiang,64,0.10763,22704,38.18108,59464
47,juazasan,61,0.10258,22765,38.28367,59464
48,AndresRoblesMX,60,0.10090,22825,38.38457,59464
49,a-elsheikh,59,0.09922,22884,38.48379,59464
50,xiazuojie,59,0.09922,22943,38.58301,59464
51,mthmulders,58,0.09754,23001,38.68055,59464
52,cvictory,57,0.09586,23058,38.77640,59464
53,doddgu,57,0.09586,23115,38.87226,59464
54,LukePammant,56,0.09417,23171,38.96643,59464
55,fbridger,52,0.08745,23223,39.05388,59464
56,ksashikumar,52,0.08745,23275,39.14133,59464
57,CarlosLanderas,50,0.08408,23325,39.22541,59464
58,heavenwing,49,0.08240,23374,39.30782,59464
59,LaurenceLiZhixin,49,0.08240,23423,39.39022,59464
60,stephaneey,49,0.08240,23472,39.47262,59464
61,eNeRGy164,48,0.08072,23520,39.55334,59464
62,KaiWalter,48,0.08072,23568,39.63406,59464
63,EdwinVW,46,0.07736,23614,39.71142,59464
64,JuanJose-Herrera,46,0.07736,23660,39.78878,59464
65,slacksach,46,0.07736,23706,39.86614,59464
66,CrazyHZM,45,0.07568,23751,39.94181,59464
67,paulyuk,45,0.07568,23796,40.01749,59464
68,dev-drprasad,44,0.07399,23840,40.09148,59464
69,flier,44,0.07399,23884,40.16548,59464
70,perokvist,44,0.07399,23928,40.23947,59464
71,h2floh,43,0.07231,23971,40.31179,59464
72,bjorkstromm,39,0.06559,24010,40.37737,59464
73,jocko-wowza,39,0.06559,24049,40.44296,59464
74,samcov,39,0.06559,24088,40.50854,59464
75,khous,37,0.06222,24125,40.57077,59464
76,theonefx,37,0.06222,24162,40.63299,59464
77,apuzyrevsky,35,0.05886,24197,40.69185,59464
78,darren-wang,35,0.05886,24232,40.75071,59464
79,l0ll098,35,0.05886,24267,40.80957,59464
80,li1234yun,35,0.05886,24302,40.86842,59464
81,jasonviviano,34,0.05718,24336,40.92560,59464
82,wmeints,33,0.05550,24369,40.98110,59464
83,brooke-hamilton,32,0.05381,24401,41.03491,59464
84,LaurentLesle,32,0.05381,24433,41.08873,59464
85,andreatosato,31,0.05213,24464,41.14086,59464
86,lukekim,31,0.05213,24495,41.19299,59464
87,RadoslavGatev,31,0.05213,24526,41.24512,59464
88,rrylee,31,0.05213,24557,41.29726,59464
89,aktxyz,29,0.04877,24586,41.34602,59464
90,harrykimpel,29,0.04877,24615,41.39479,59464
91,kumaya,29,0.04877,24644,41.44356,59464
92,pzou19741,29,0.04877,24673,41.49233,59464
93,thebillkidy,29,0.04877,24702,41.54110,59464
94,amimimor,28,0.04709,24730,41.58819,59464
95,MohsenMahdieh,28,0.04709,24758,41.63528,59464
96,programaka,28,0.04709,24786,41.68236,59464
97,fabistb,27,0.04541,24813,41.72777,59464
98,aloneguid,26,0.04372,24839,41.77149,59464
99,amirmm11,26,0.04372,24865,41.81522,59464
100,saber-wang,26,0.04372,24891,41.85894,59464
101,shchauh,26,0.04372,24917,41.90266,59464
102,alvinhenrick,25,0.04204,24942,41.94471,59464
103,mtaghavi2005,25,0.04204,24967,41.98675,59464
104,qt-luigi,25,0.04204,24992,42.02879,59464
105,veselfil,25,0.04204,25017,42.07083,59464
106,jkears,24,0.04036,25041,42.11119,59464
107,cilerler,23,0.03868,25064,42.14987,59464
108,TenSt,23,0.03868,25087,42.18855,59464
109,wanton7,23,0.03868,25110,42.22723,59464
110,ji11er,22,0.03700,25132,42.26423,59464
111,mestizoLopez,22,0.03700,25154,42.30122,59464
112,seeflood,22,0.03700,25176,42.33822,59464
113,yaoliu,22,0.03700,25198,42.37522,59464
114,yoDon,22,0.03700,25220,42.41222,59464
115,gunniwho,21,0.03532,25241,42.44753,59464
116,hokandil,21,0.03532,25262,42.48285,59464
117,htzhang2,21,0.03532,25283,42.51816,59464
118,hugobarona,21,0.03532,25304,42.55348,59464
119,iamazy,21,0.03532,25325,42.58879,59464
120,malotho,21,0.03532,25346,42.62411,59464
121,RChrisCoble,21,0.03532,25367,42.65942,59464
122,Shawn-Fan,21,0.03532,25388,42.69474,59464
123,JMayrbaeurl,20,0.03363,25408,42.72837,59464
124,marcosreyes05,20,0.03363,25428,42.76201,59464
125,nmlc,20,0.03363,25448,42.79564,59464
126,rovangju,20,0.03363,25468,42.82927,59464
127,sk593,20,0.03363,25488,42.86291,59464
128,tuapuikia,20,0.03363,25508,42.89654,59464
129,VenkateshSrini,20,0.03363,25528,42.93018,59464
130,ddobric,19,0.03195,25547,42.96213,59464
131,jsacapdev,19,0.03195,25566,42.99408,59464
132,behoyh,18,0.03027,25584,43.02435,59464
133,Fabian-Schmidt,18,0.03027,25602,43.05462,59464
134,jjindrich,18,0.03027,25620,43.08489,59464
135,jpiquot,18,0.03027,25638,43.11516,59464
136,msftgits,18,0.03027,25656,43.14543,59464
137,stather,18,0.03027,25674,43.17570,59464
138,Betula-L,17,0.02859,25691,43.20429,59464
139,dancadana,17,0.02859,25708,43.23288,59464
140,denis111,17,0.02859,25725,43.26147,59464
141,jeastham1993,17,0.02859,25742,43.29006,59464
142,Masahigo,17,0.02859,25759,43.31865,59464
143,nobodyiam,17,0.02859,25776,43.34724,59464
144,PeterGerrard,17,0.02859,25793,43.37582,59464
145,satishviswanathan,17,0.02859,25810,43.40441,59464
146,cecilphillip,16,0.02691,25826,43.43132,59464
147,cinience,16,0.02691,25842,43.45823,59464
148,gaoxinge,16,0.02691,25858,43.48513,59464
149,gmanvel,16,0.02691,25874,43.51204,59464
150,mfcollins3,16,0.02691,25890,43.53895,59464
151,pacodelacruz,16,0.02691,25906,43.56585,59464
152,TomCools,16,0.02691,25922,43.59276,59464
153,a121984376,15,0.02523,25937,43.61799,59464
154,anuragprafulla,15,0.02523,25952,43.64321,59464
155,kamesh1677,15,0.02523,25967,43.66844,59464
156,mareklinka,15,0.02523,25982,43.69366,59464
157,robinmanuelthiel,15,0.02523,25997,43.71889,59464
158,wenxuwan,15,0.02523,26012,43.74411,59464
159,kzmake,14,0.02354,26026,43.76766,59464
160,mjtansin,14,0.02354,26040,43.79120,59464
161,omidb,14,0.02354,26054,43.81475,59464
162,sd797994,14,0.02354,26068,43.83829,59464
163,tiankanghello,14,0.02354,26082,43.86183,59464
164,zhonghaochen,14,0.02354,26096,43.88538,59464
165,a641545621,13,0.02186,26109,43.90724,59464
166,kdbeall,13,0.02186,26122,43.92910,59464
167,letmerecall,13,0.02186,26135,43.95096,59464
168,MedAnd,13,0.02186,26148,43.97282,59464
169,pulkitmehra,13,0.02186,26161,43.99469,59464
170,qqeasonchen,13,0.02186,26174,44.01655,59464
171,SamuelMcAravey,13,0.02186,26187,44.03841,59464
172,sapinderpalsingh,13,0.02186,26200,44.06027,59464
173,theperm,13,0.02186,26213,44.08213,59464
174,voipengineer,13,0.02186,26226,44.10400,59464
175,vzdesic,13,0.02186,26239,44.12586,59464
176,WhoAteDaCake,13,0.02186,26252,44.14772,59464
177,Abhith,12,0.02018,26264,44.16790,59464
178,avvijeet,12,0.02018,26276,44.18808,59464
179,bhummerstone,12,0.02018,26288,44.20826,59464
180,cesarfong,12,0.02018,26300,44.22844,59464
181,DaveBben,12,0.02018,26312,44.24862,59464
182,dwhiteddsoft,12,0.02018,26324,44.26880,59464
183,jacoblroberts,12,0.02018,26336,44.28898,59464
184,mhoad,12,0.02018,26348,44.30916,59464
185,pagufler,12,0.02018,26360,44.32934,59464
186,peterjot,12,0.02018,26372,44.34952,59464
187,ricardf,12,0.02018,26384,44.36970,59464
188,riezebosch,12,0.02018,26396,44.38988,59464
189,sebader,12,0.02018,26408,44.41006,59464
190,sejnub,12,0.02018,26420,44.43024,59464
191,yanjianlong,12,0.02018,26432,44.45042,59464
192,yanxinyuan,12,0.02018,26444,44.47060,59464
193,yordan-pavlov,12,0.02018,26456,44.49078,59464
194,bgelens,11,0.01850,26467,44.50928,59464
195,blackstorm,11,0.01850,26478,44.52778,59464
196,bvwells,11,0.01850,26489,44.54628,59464
197,ChrisProlls,11,0.01850,26500,44.56478,59464
198,gbaeke,11,0.01850,26511,44.58328,59464
199,HansK-p,11,0.01850,26522,44.60178,59464
200,jbw,11,0.01850,26533,44.62027,59464
201,kevinten10,11,0.01850,26544,44.63877,59464
202,laurentkempe,11,0.01850,26555,44.65727,59464
203,maiorfi,11,0.01850,26566,44.67577,59464
204,mcain12,11,0.01850,26577,44.69427,59464
205,richgo,11,0.01850,26588,44.71277,59464
206,sau-lanvy,11,0.01850,26599,44.73127,59464
207,TalalMahmoodChaudhry,11,0.01850,26610,44.74976,59464
208,tonysneed,11,0.01850,26621,44.76826,59464
209,trumhemcut,11,0.01850,26632,44.78676,59464
210,wajika,11,0.01850,26643,44.80526,59464
211,WillEastbury,11,0.01850,26654,44.82376,59464
212,xavidram,11,0.01850,26665,44.84226,59464
213,your-azure-coach,11,0.01850,26676,44.86076,59464
214,amitHansda,10,0.01682,26686,44.87757,59464
215,chleit,10,0.01682,26696,44.89439,59464
216,daniv-msft,10,0.01682,26706,44.91121,59464
217,darraghjones,10,0.01682,26716,44.92802,59464
218,dasiths,10,0.01682,26726,44.94484,59464
219,drishtirai,10,0.01682,26736,44.96166,59464
220,elyst,10,0.01682,26746,44.97847,59464
221,iamalexmang,10,0.01682,26756,44.99529,59464
222,idjohnson,10,0.01682,26766,45.01211,59464
223,issacg,10,0.01682,26776,45.02893,59464
224,karishma-chawla,10,0.01682,26786,45.04574,59464
225,krutsko,10,0.01682,26796,45.06256,59464
226,matthewgaim,10,0.01682,26806,45.07938,59464
227,mittz,10,0.01682,26816,45.09619,59464
228,mrchypark,10,0.01682,26826,45.11301,59464
229,nmeisenzahl,10,0.01682,26836,45.12983,59464
230,rajibmitra,10,0.01682,26846,45.14664,59464
231,SoMeDay-Zhang,10,0.01682,26856,45.16346,59464
232,techgeek03,10,0.01682,26866,45.18028,59464
233,ajaysingh77,9,0.01514,26875,45.19541,59464
234,andrey-dubnik,9,0.01514,26884,45.21055,59464
235,David-Kunz,9,0.01514,26893,45.22568,59464
236,ianrocha,9,0.01514,26902,45.24082,59464
237,kshitijcode,9,0.01514,26911,45.25595,59464
238,laveeshb,9,0.01514,26920,45.27109,59464
239,manjeetbhatia,9,0.01514,26929,45.28622,59464
240,naichowdhury,9,0.01514,26938,45.30136,59464
241,NitishGawde,9,0.01514,26947,45.31649,59464
242,puzpuzpuz,9,0.01514,26956,45.33163,59464
243,quickstar,9,0.01514,26965,45.34676,59464
244,seanfitzg,9,0.01514,26974,45.36190,59464
245,zcong1993,9,0.01514,26983,45.37703,59464
246,zivfuture,9,0.01514,26992,45.39217,59464
247,alanwales,8,0.01345,27000,45.40562,59464
248,altinoren,8,0.01345,27008,45.41908,59464
249,amulyavarote,8,0.01345,27016,45.43253,59464
250,clintsinger,8,0.01345,27024,45.44598,59464
251,csharpknife2002,8,0.01345,27032,45.45944,59464
252,daft300punk,8,0.01345,27040,45.47289,59464
253,delvh,8,0.01345,27048,45.48634,59464
254,dlemstra,8,0.01345,27056,45.49980,59464
255,drriguz,8,0.01345,27064,45.51325,59464
256,eluchsinger,8,0.01345,27072,45.52671,59464
257,frochi42,8,0.01345,27080,45.54016,59464
258,gcameo,8,0.01345,27088,45.55361,59464
259,goh-chunlin,8,0.01345,27096,45.56707,59464
260,igorpalant,8,0.01345,27104,45.58052,59464
261,iskandersierra,8,0.01345,27112,45.59397,59464
262,JochenKienzle,8,0.01345,27120,45.60743,59464
263,JoeMayo,8,0.01345,27128,45.62088,59464
264,Li-Yanzhi,8,0.01345,27136,45.63433,59464
265,LLKennedy,8,0.01345,27144,45.64779,59464
266,pejovski,8,0.01345,27152,45.66124,59464
267,qmhu,8,0.01345,27160,45.67469,59464
268,robvet,8,0.01345,27168,45.68815,59464
269,rspaulino,8,0.01345,27176,45.70160,59464
270,seanyen,8,0.01345,27184,45.71505,59464
271,shubham1172,8,0.01345,27192,45.72851,59464
272,simonrhart,8,0.01345,27200,45.74196,59464
273,SnowflyW,8,0.01345,27208,45.75542,59464
274,stefanJ-hub,8,0.01345,27216,45.76887,59464
275,stulzq,8,0.01345,27224,45.78232,59464
276,taojwmware,8,0.01345,27232,45.79578,59464
277,ubhanja,8,0.01345,27240,45.80923,59464
278,weibubli,8,0.01345,27248,45.82268,59464
279,Admiralkheir,7,0.01177,27255,45.83445,59464
280,aldelar,7,0.01177,27262,45.84623,59464
281,alydersen,7,0.01177,27269,45.85800,59464
282,Amenocy,7,0.01177,27276,45.86977,59464
283,AndreasM009,7,0.01177,27283,45.88154,59464
284,aquamme,7,0.01177,27290,45.89331,59464
285,attiqeurrehman,7,0.01177,27297,45.90509,59464
286,bign8,7,0.01177,27304,45.91686,59464
287,cero-t,7,0.01177,27311,45.92863,59464
288,clarkezone,7,0.01177,27318,45.94040,59464
289,czmirek,7,0.01177,27325,45.95217,59464
290,dmytrohridin,7,0.01177,27332,45.96394,59464
291,ElderJames,7,0.01177,27339,45.97572,59464
292,Geertvdc,7,0.01177,27346,45.98749,59464
293,GennadiiSvichinskyi,7,0.01177,27353,45.99926,59464
294,heyanwei,7,0.01177,27360,46.01103,59464
295,horihiro,7,0.01177,27367,46.02280,59464
296,ipfans,7,0.01177,27374,46.03458,59464
297,Johnsonxd4,7,0.01177,27381,46.04635,59464
298,jthin,7,0.01177,27388,46.05812,59464
299,kb2ma,7,0.01177,27395,46.06989,59464
300,lgmorand,7,0.01177,27402,46.08166,59464
301,loic-sharma,7,0.01177,27409,46.09343,59464
302,Lordieolore,7,0.01177,27416,46.10521,59464
303,markrussinovich,7,0.01177,27423,46.11698,59464
304,MauRiEEZZZ,7,0.01177,27430,46.12875,59464
305,mehmetuken,7,0.01177,27437,46.14052,59464
306,mikalst,7,0.01177,27444,46.15229,59464
307,piotrmsc,7,0.01177,27451,46.16407,59464
308,pranavq212,7,0.01177,27458,46.17584,59464
309,sebastus,7,0.01177,27465,46.18761,59464
310,StevenJDH,7,0.01177,27472,46.19938,59464
311,tanekim77,7,0.01177,27479,46.21115,59464
312,vimorra,7,0.01177,27486,46.22292,59464
313,workfigure,7,0.01177,27493,46.23470,59464
314,xewn,7,0.01177,27500,46.24647,59464
315,yglcode,7,0.01177,27507,46.25824,59464
316,zhangqing132155,7,0.01177,27514,46.27001,59464
317,abatishchev,6,0.01009,27520,46.28010,59464
318,abnormall,6,0.01009,27526,46.29019,59464
319,akourbat,6,0.01009,27532,46.30028,59464
320,anedelko,6,0.01009,27538,46.31037,59464
321,brunocascio,6,0.01009,27544,46.32046,59464
322,dabedin,6,0.01009,27550,46.33055,59464
323,dolencd,6,0.01009,27556,46.34064,59464
324,Edward-Roshan,6,0.01009,27562,46.35073,59464
325,eibrunorodrigues,6,0.01009,27568,46.36082,59464
326,emattiza,6,0.01009,27574,46.37091,59464
327,esimkowitz,6,0.01009,27580,46.38100,59464
328,filenda,6,0.01009,27586,46.39109,59464
329,francescocristallo,6,0.01009,27592,46.40118,59464
330,frvasquezjaquez,6,0.01009,27598,46.41127,59464
331,garretmagin,6,0.01009,27604,46.42136,59464
332,geffzhang,6,0.01009,27610,46.43145,59464
333,GregorBiswanger,6,0.01009,27616,46.44154,59464
334,HitNoBug,6,0.01009,27622,46.45163,59464
335,JhouXerox,6,0.01009,27628,46.46172,59464
336,jwenjian,6,0.01009,27634,46.47181,59464
337,kakridge,6,0.01009,27640,46.48191,59464
338,kaypee90,6,0.01009,27646,46.49200,59464
339,kylehuan,6,0.01009,27652,46.50209,59464
340,latala43,6,0.01009,27658,46.51218,59464
341,leenux,6,0.01009,27664,46.52227,59464
342,lnquy,6,0.01009,27670,46.53236,59464
343,marxxxx,6,0.01009,27676,46.54245,59464
344,mhozhda-agiliway,6,0.01009,27682,46.55254,59464
345,moluzhui,6,0.01009,27688,46.56263,59464
346,ptrubini,6,0.01009,27694,46.57272,59464
347,RickBullotta,6,0.01009,27700,46.58281,59464
348,Rob623,6,0.01009,27706,46.59290,59464
349,robsondepaula,6,0.01009,27712,46.60299,59464
350,ryzam,6,0.01009,27718,46.61308,59464
351,ShrayRastogi,6,0.01009,27724,46.62317,59464
352,springe2004,6,0.01009,27730,46.63326,59464
353,stepro71,6,0.01009,27736,46.64335,59464
354,tdcare,6,0.01009,27742,46.65344,59464
355,tianjipeng,6,0.01009,27748,46.66353,59464
356,tieudaotu90,6,0.01009,27754,46.67362,59464
357,tpiperatgod,6,0.01009,27760,46.68371,59464
358,tstojecki,6,0.01009,27766,46.69380,59464
359,UmutComlekci,6,0.01009,27772,46.70389,59464
360,vik-borisov,6,0.01009,27778,46.71398,59464
361,wdjhu,6,0.01009,27784,46.72407,59464
362,wwulfric,6,0.01009,27790,46.73416,59464
363,Xorpio,6,0.01009,27796,46.74425,59464
364,yosiat,6,0.01009,27802,46.75434,59464
365,Zonciu,6,0.01009,27808,46.76443,59464
366,AI-Marvel,5,0.00841,27813,46.77284,59464
367,alex-doe,5,0.00841,27818,46.78125,59464
368,anishj0shi,5,0.00841,27823,46.78965,59464
369,araxis,5,0.00841,27828,46.79806,59464
370,asumner,5,0.00841,27833,46.80647,59464
371,calebcartwright,5,0.00841,27838,46.81488,59464
372,cheimu,5,0.00841,27843,46.82329,59464
373,cuongvo,5,0.00841,27848,46.83170,59464
374,daneel3001,5,0.00841,27853,46.84010,59464
375,danp11,5,0.00841,27858,46.84851,59464
376,DexManx,5,0.00841,27863,46.85692,59464
377,drk9999,5,0.00841,27868,46.86533,59464
378,drmcghee,5,0.00841,27873,46.87374,59464
379,espenaolsen,5,0.00841,27878,46.88215,59464
380,etuboko,5,0.00841,27883,46.89056,59464
381,farhadnowzari,5,0.00841,27888,46.89896,59464
382,gidich,5,0.00841,27893,46.90737,59464
383,gmusial-obj,5,0.00841,27898,46.91578,59464
384,gogi2811,5,0.00841,27903,46.92419,59464
385,hirensharma,5,0.00841,27908,46.93260,59464
386,igalfsg,5,0.00841,27913,46.94101,59464
387,iOnline247,5,0.00841,27918,46.94941,59464
388,jia-zhengwei,5,0.00841,27923,46.95782,59464
389,kevgo,5,0.00841,27928,46.96623,59464
390,lewisbenge,5,0.00841,27933,46.97464,59464
391,lhx6538665,5,0.00841,27938,46.98305,59464
392,liamgib,5,0.00841,27943,46.99146,59464
393,Liriel,5,0.00841,27948,46.99987,59464
394,litan1106,5,0.00841,27953,47.00827,59464
395,macon,5,0.00841,27958,47.01668,59464
396,maminio,5,0.00841,27963,47.02509,59464
397,modabas,5,0.00841,27968,47.03350,59464
398,MoienTajik,5,0.00841,27973,47.04191,59464
399,natrem,5,0.00841,27978,47.05032,59464
400,nicro950,5,0.00841,27983,47.05872,59464
401,olitomlinson,5,0.00841,27988,47.06713,59464
402,ooeygui,5,0.00841,27993,47.07554,59464
403,pandagodyyy,5,0.00841,27998,47.08395,59464
404,pankona,5,0.00841,28003,47.09236,59464
405,pattisapu01,5,0.00841,28008,47.10077,59464
406,readefries,5,0.00841,28013,47.10918,59464
407,regul4rj0hn,5,0.00841,28018,47.11758,59464
408,repne,5,0.00841,28023,47.12599,59464
409,reymarx,5,0.00841,28028,47.13440,59464
410,rishabhsaha,5,0.00841,28033,47.14281,59464
411,RobberPhex,5,0.00841,28038,47.15122,59464
412,saintmalik,5,0.00841,28043,47.15963,59464
413,shlyopin,5,0.00841,28048,47.16803,59464
414,sora-kashiwagi,5,0.00841,28053,47.17644,59464
415,speedfl,5,0.00841,28058,47.18485,59464
416,ssabih,5,0.00841,28063,47.19326,59464
417,stanspotts,5,0.00841,28068,47.20167,59464
418,thanhlq,5,0.00841,28073,47.21008,59464
419,tianvan,5,0.00841,28078,47.21849,59464
420,tomzx,5,0.00841,28083,47.22689,59464
421,ToonVanhoutte,5,0.00841,28088,47.23530,59464
422,viv718918,5,0.00841,28093,47.24371,59464
423,wenhzha,5,0.00841,28098,47.25212,59464
424,xqianwang,5,0.00841,28103,47.26053,59464
425,ystyle,5,0.00841,28108,47.26894,59464
426,ziez,5,0.00841,28113,47.27734,59464
427,znzn007007,5,0.00841,28118,47.28575,59464
428,afedyashov,4,0.00673,28122,47.29248,59464
429,andmos,4,0.00673,28126,47.29921,59464
430,Ashnam1100,4,0.00673,28130,47.30593,59464
431,badgeratu,4,0.00673,28134,47.31266,59464
432,bd-g,4,0.00673,28138,47.31939,59464
433,bvahdat,4,0.00673,28142,47.32611,59464
434,c0h1b4,4,0.00673,28146,47.33284,59464
435,cdennig,4,0.00673,28150,47.33957,59464
436,DannyvanderKraan,4,0.00673,28154,47.34629,59464
437,dinggh,4,0.00673,28158,47.35302,59464
438,dkapellusch,4,0.00673,28162,47.35975,59464
439,DStoyanoff,4,0.00673,28166,47.36647,59464
440,fduman,4,0.00673,28170,47.37320,59464
441,fengmk2,4,0.00673,28174,47.37993,59464
442,fffej,4,0.00673,28178,47.38665,59464
443,Flern,4,0.00673,28182,47.39338,59464
444,frenchyjef,4,0.00673,28186,47.40011,59464
445,gigilove2001,4,0.00673,28190,47.40683,59464
446,gophersumit,4,0.00673,28194,47.41356,59464
447,guangdashao,4,0.00673,28198,47.42029,59464
448,haowaiwai,4,0.00673,28202,47.42701,59464
449,Hermsi1337,4,0.00673,28206,47.43374,59464
450,huiyangz,4,0.00673,28210,47.44047,59464
451,ibondy,4,0.00673,28214,47.44719,59464
452,jayendranarumugam,4,0.00673,28218,47.45392,59464
453,jdubois,4,0.00673,28222,47.46065,59464
454,jgardner04,4,0.00673,28226,47.46738,59464
455,jjchiw,4,0.00673,28230,47.47410,59464
456,johncming,4,0.00673,28234,47.48083,59464
457,jony4,4,0.00673,28238,47.48756,59464
458,Julian-Chu,4,0.00673,28242,47.49428,59464
459,kfrajtak,4,0.00673,28246,47.50101,59464
460,khalidabuhakmeh,4,0.00673,28250,47.50774,59464
461,LarsKemmann,4,0.00673,28254,47.51446,59464
462,lilongsswang,4,0.00673,28258,47.52119,59464
463,LiPL2017,4,0.00673,28262,47.52792,59464
464,longle255,4,0.00673,28266,47.53464,59464
465,lullen,4,0.00673,28270,47.54137,59464
466,madhavan-j,4,0.00673,28274,47.54810,59464
467,marc-mueller,4,0.00673,28278,47.55482,59464
468,mike-reynolds-savient,4,0.00673,28282,47.56155,59464
469,MistrBurns,4,0.00673,28286,47.56828,59464
470,mlatoszek,4,0.00673,28290,47.57500,59464
471,MoonShining,4,0.00673,28294,47.58173,59464
472,MotaOcimar,4,0.00673,28298,47.58846,59464
473,mslot,4,0.00673,28302,47.59518,59464
474,nero-philip-wang,4,0.00673,28306,47.60191,59464
475,omid-verneek,4,0.00673,28310,47.60864,59464
476,ottolote,4,0.00673,28314,47.61536,59464
477,Phiph,4,0.00673,28318,47.62209,59464
478,pohorely,4,0.00673,28322,47.62882,59464
479,ProfessorMc,4,0.00673,28326,47.63554,59464
480,rbroggi,4,0.00673,28330,47.64227,59464
481,Rinita-De,4,0.00673,28334,47.64900,59464
482,rolfik,4,0.00673,28338,47.65572,59464
483,rumblefrog,4,0.00673,28342,47.66245,59464
484,samnela,4,0.00673,28346,47.66918,59464
485,sdeoras,4,0.00673,28350,47.67590,59464
486,shanselman,4,0.00673,28354,47.68263,59464
487,sheng-jie,4,0.00673,28358,47.68936,59464
488,shiranr,4,0.00673,28362,47.69609,59464
489,skmaingi,4,0.00673,28366,47.70281,59464
490,smitcham,4,0.00673,28370,47.70954,59464
491,soiboxauxi,4,0.00673,28374,47.71627,59464
492,srntqn,4,0.00673,28378,47.72299,59464
493,stevenknox,4,0.00673,28382,47.72972,59464
494,Tallone,4,0.00673,28386,47.73645,59464
495,vermegi,4,0.00673,28390,47.74317,59464
496,victormarante,4,0.00673,28394,47.74990,59464
497,vjrantal,4,0.00673,28398,47.75663,59464
498,vnextcoder,4,0.00673,28402,47.76335,59464
499,voltcode,4,0.00673,28406,47.77008,59464
500,wise-Kaas,4,0.00673,28410,47.77681,59464
501,xiatiandegaga,4,0.00673,28414,47.78353,59464
502,yamajik,4,0.00673,28418,47.79026,59464
503,zarba7,4,0.00673,28422,47.79699,59464
504,zhangshuiyong,4,0.00673,28426,47.80371,59464
505,zhongfox,4,0.00673,28430,47.81044,59464
506,666DoxGangLucifer,3,0.00505,28433,47.81548,59464
507,a1tan,3,0.00505,28436,47.82053,59464
508,abertonica,3,0.00505,28439,47.82558,59464
509,Abhilash-Chandran,3,0.00505,28442,47.83062,59464
510,afsalcodehack,3,0.00505,28445,47.83567,59464
511,ahaWDY,3,0.00505,28448,47.84071,59464
512,akansh97531,3,0.00505,28451,47.84576,59464
513,alexdresko,3,0.00505,28454,47.85080,59464
514,AlseinX,3,0.00505,28457,47.85585,59464
515,andycwk,3,0.00505,28460,47.86089,59464
516,andypeng2015,3,0.00505,28463,47.86594,59464
517,ArieJones,3,0.00505,28466,47.87098,59464
518,asw101,3,0.00505,28469,47.87603,59464
519,awright18,3,0.00505,28472,47.88107,59464
520,barrricade,3,0.00505,28475,47.88612,59464
521,bmilleare,3,0.00505,28478,47.89116,59464
522,btull89,3,0.00505,28481,47.89621,59464
523,Campergue,3,0.00505,28484,47.90125,59464
524,CarloGarcia,3,0.00505,28487,47.90630,59464
525,CCGAC-Andreas-Riehl,3,0.00505,28490,47.91134,59464
526,ChenHaoHu,3,0.00505,28493,47.91639,59464
527,chess-equality,3,0.00505,28496,47.92143,59464
528,cjlpowers,3,0.00505,28499,47.92648,59464
529,clonedonaldmarshall,3,0.00505,28502,47.93152,59464
530,cysnet,3,0.00505,28505,47.93657,59464
531,dairlair,3,0.00505,28508,47.94161,59464
532,DanAbara,3,0.00505,28511,47.94666,59464
533,DarinShapiroMS,3,0.00505,28514,47.95170,59464
534,databasedav,3,0.00505,28517,47.95675,59464
535,DavidHoerster,3,0.00505,28520,47.96179,59464
536,dhowardimpinj,3,0.00505,28523,47.96684,59464
537,divyeshBhartiya,3,0.00505,28526,47.97188,59464
538,ecaisse,3,0.00505,28529,47.97693,59464
539,EmixamZ,3,0.00505,28532,47.98197,59464
540,eosgortor,3,0.00505,28535,47.98702,59464
541,franpog859,3,0.00505,28538,47.99206,59464
542,Fredborg,3,0.00505,28541,47.99711,59464
543,F-Sidney,3,0.00505,28544,48.00215,59464
544,Giovds,3,0.00505,28547,48.00720,59464
545,goodforever,3,0.00505,28550,48.01224,59464
546,grahamehorner,3,0.00505,28553,48.01729,59464
547,guihlk,3,0.00505,28556,48.02233,59464
548,hackmong,3,0.00505,28559,48.02738,59464
549,hanzvanaardt,3,0.00505,28562,48.03242,59464
550,hichamveo,3,0.00505,28565,48.03747,59464
551,hobpet,3,0.00505,28568,48.04251,59464
552,Hynn01,3,0.00505,28571,48.04756,59464
553,i542873057,3,0.00505,28574,48.05260,59464
554,IroNEDR,3,0.00505,28577,48.05765,59464
555,jacksierkstra,3,0.00505,28580,48.06269,59464
556,JadynWong,3,0.00505,28583,48.06774,59464
557,jerrylisl,3,0.00505,28586,48.07278,59464
558,JIOO-phoeNIX,3,0.00505,28589,48.07783,59464
559,jonathonfletcher,3,0.00505,28592,48.08287,59464
560,jp1482,3,0.00505,28595,48.08792,59464
561,KaiwenWang,3,0.00505,28598,48.09296,59464
562,kaluzaaa,3,0.00505,28601,48.09801,59464
563,kathu,3,0.00505,28604,48.10305,59464
564,KeKe-Li,3,0.00505,28607,48.10810,59464
565,keranbingaa,3,0.00505,28610,48.11314,59464
566,kinosang,3,0.00505,28613,48.11819,59464
567,kpantos,3,0.00505,28616,48.12323,59464
568,krautbax,3,0.00505,28619,48.12828,59464
569,krishnabhargav,3,0.00505,28622,48.13332,59464
570,larserikfinholt,3,0.00505,28625,48.13837,59464
571,lcartel-ms,3,0.00505,28628,48.14341,59464
572,LeartS,3,0.00505,28631,48.14846,59464
573,Lellansin,3,0.00505,28634,48.15350,59464
574,leonids2005,3,0.00505,28637,48.15855,59464
575,lgbin879,3,0.00505,28640,48.16359,59464
576,lianxue7851,3,0.00505,28643,48.16864,59464
577,linxuyalun,3,0.00505,28646,48.17368,59464
578,LKI,3,0.00505,28649,48.17873,59464
579,lloydfischer,3,0.00505,28652,48.18378,59464
580,logamanig,3,0.00505,28655,48.18882,59464
581,lomholdt,3,0.00505,28658,48.19387,59464
582,luiscantero,3,0.00505,28661,48.19891,59464
583,luk355,3,0.00505,28664,48.20396,59464
584,madhugilla,3,0.00505,28667,48.20900,59464
585,marcusturewicz,3,0.00505,28670,48.21405,59464
586,marcvaneijk,3,0.00505,28673,48.21909,59464
587,MarHolyR,3,0.00505,28676,48.22414,59464
588,mariemzyr,3,0.00505,28679,48.22918,59464
589,marounb98,3,0.00505,28682,48.23423,59464
590,millerdz,3,0.00505,28685,48.23927,59464
591,mkash32,3,0.00505,28688,48.24432,59464
592,moderakh,3,0.00505,28691,48.24936,59464
593,MoeweX,3,0.00505,28694,48.25441,59464
594,Monte-Christo,3,0.00505,28697,48.25945,59464
595,mychajlo,3,0.00505,28700,48.26450,59464
596,neildonkin,3,0.00505,28703,48.26954,59464
597,neumann1990,3,0.00505,28706,48.27459,59464
598,nielsbauman,3,0.00505,28709,48.27963,59464
599,Otto404,3,0.00505,28712,48.28468,59464
600,ovebastiansen,3,0.00505,28715,48.28972,59464
601,pinxiong,3,0.00505,28718,48.29477,59464
602,Pitlis,3,0.00505,28721,48.29981,59464
603,psibernetic,3,0.00505,28724,48.30486,59464
604,raghavender7,3,0.00505,28727,48.30990,59464
605,ravi-k4,3,0.00505,28730,48.31495,59464
606,RazorscreaM,3,0.00505,28733,48.31999,59464
607,rcollina,3,0.00505,28736,48.32504,59464
608,rizzi37,3,0.00505,28739,48.33008,59464
609,rohitshrivastava04,3,0.00505,28742,48.33513,59464
610,samueleresca,3,0.00505,28745,48.34017,59464
611,sawadary,3,0.00505,28748,48.34522,59464
612,sep2,3,0.00505,28751,48.35026,59464
613,sergey-komarov,3,0.00505,28754,48.35531,59464
614,ShaneCourtrille,3,0.00505,28757,48.36035,59464
615,ShawnMcGough,3,0.00505,28760,48.36540,59464
616,shubhammicrosoft1,3,0.00505,28763,48.37044,59464
617,sirius1024,3,0.00505,28766,48.37549,59464
618,sregdorr,3,0.00505,28769,48.38053,59464
619,ssimontis,3,0.00505,28772,48.38558,59464
620,sthussey,3,0.00505,28775,48.39062,59464
621,subash89,3,0.00505,28778,48.39567,59464
622,sureshmvp,3,0.00505,28781,48.40071,59464
623,surlydev,3,0.00505,28784,48.40576,59464
624,Syuparn,3,0.00505,28787,48.41080,59464
625,tangly1991,3,0.00505,28790,48.41585,59464
626,tareksharbak,3,0.00505,28793,48.42089,59464
627,tedvanderveen,3,0.00505,28796,48.42594,59464
628,thangchung,3,0.00505,28799,48.43098,59464
629,TheGrayFrost,3,0.00505,28802,48.43603,59464
630,the-virt,3,0.00505,28805,48.44107,59464
631,tjwp,3,0.00505,28808,48.44612,59464
632,vaclavpetr,3,0.00505,28811,48.45116,59464
633,VarunPeddina,3,0.00505,28814,48.45621,59464
634,vikborisov,3,0.00505,28817,48.46125,59464
635,vincentfree,3,0.00505,28820,48.46630,59464
636,wenqiglantz,3,0.00505,28823,48.47134,59464
637,wenwenchenbosch,3,0.00505,28826,48.47639,59464
638,wisecoders,3,0.00505,28829,48.48143,59464
639,Wood-Xia,3,0.00505,28832,48.48648,59464
640,wsams,3,0.00505,28835,48.49152,59464
641,wujunwei,3,0.00505,28838,48.49657,59464
642,xdmushui,3,0.00505,28841,48.50161,59464
643,yinxiaoling,3,0.00505,28844,48.50666,59464
644,yufan022,3,0.00505,28847,48.51170,59464
645,zach030,3,0.00505,28850,48.51675,59464
646,ZeyadYasser,3,0.00505,28853,48.52179,59464
647,zhangwanli666,3,0.00505,28856,48.52684,59464
648,ZhangX-Byte,3,0.00505,28859,48.53188,59464
649,AbbetWang,2,0.00336,28861,48.53525,59464
650,abossard,2,0.00336,28863,48.53861,59464
651,AHFoD,2,0.00336,28865,48.54197,59464
652,AhmedSayed77,2,0.00336,28867,48.54534,59464
653,AlexJuca,2,0.00336,28869,48.54870,59464
654,alexthissen,2,0.00336,28871,48.55207,59464
655,alswl,2,0.00336,28873,48.55543,59464
656,Alvazz,2,0.00336,28875,48.55879,59464
657,AmeBel,2,0.00336,28877,48.56216,59464
658,andrecarlucci,2,0.00336,28879,48.56552,59464
659,andrewda,2,0.00336,28881,48.56888,59464
660,andyczerwonka,2,0.00336,28883,48.57225,59464
661,anglogold,2,0.00336,28885,48.57561,59464
662,Antaris,2,0.00336,28887,48.57897,59464
663,antmdvs,2,0.00336,28889,48.58234,59464
664,anton-rlgx,2,0.00336,28891,48.58570,59464
665,Arashrohani,2,0.00336,28893,48.58906,59464
666,aTiKhan,2,0.00336,28895,48.59243,59464
667,awolf,2,0.00336,28897,48.59579,59464
668,baili-tang,2,0.00336,28899,48.59915,59464
669,Basyras,2,0.00336,28901,48.60252,59464
670,bencod,2,0.00336,28903,48.60588,59464
671,BhanuKorthiwada,2,0.00336,28905,48.60924,59464
672,billpoole-mi,2,0.00336,28907,48.61261,59464
673,bkort,2,0.00336,28909,48.61597,59464
674,callalilychen,2,0.00336,28911,48.61933,59464
675,candreso,2,0.00336,28913,48.62270,59464
676,Carmen675,2,0.00336,28915,48.62606,59464
677,ChrisHanna,2,0.00336,28917,48.62942,59464
678,christian-be,2,0.00336,28919,48.63279,59464
679,ChuchoCoder,2,0.00336,28921,48.63615,59464
680,codecorner-mpi,2,0.00336,28923,48.63951,59464
681,cvs79,2,0.00336,28925,48.64288,59464
682,cwiederspan,2,0.00336,28927,48.64624,59464
683,daN4cat,2,0.00336,28929,48.64960,59464
684,dbarkol,2,0.00336,28931,48.65297,59464
685,diezfx,2,0.00336,28933,48.65633,59464
686,DiyuanZhang,2,0.00336,28935,48.65969,59464
687,dpr-dev,2,0.00336,28937,48.66306,59464
688,drub0y,2,0.00336,28939,48.66642,59464
689,Dunning-Kruger,2,0.00336,28941,48.66978,59464
690,dylandee,2,0.00336,28943,48.67315,59464
691,ecafkoob,2,0.00336,28945,48.67651,59464
692,ecw1973,2,0.00336,28947,48.67987,59464
693,egmkang,2,0.00336,28949,48.68324,59464
694,espenairmine,2,0.00336,28951,48.68660,59464
695,exegete46,2,0.00336,28953,48.68996,59464
696,fanadol,2,0.00336,28955,48.69333,59464
697,fpaganetto,2,0.00336,28957,48.69669,59464
698,fraozy,2,0.00336,28959,48.70005,59464
699,fvillellr,2,0.00336,28961,48.70342,59464
700,gafeol,2,0.00336,28963,48.70678,59464
701,gboersma,2,0.00336,28965,48.71014,59464
702,geekgao,2,0.00336,28967,48.71351,59464
703,glennmusa,2,0.00336,28969,48.71687,59464
704,gontadu,2,0.00336,28971,48.72023,59464
705,handicraftsman,2,0.00336,28973,48.72360,59464
706,HectorMeneses333,2,0.00336,28975,48.72696,59464
707,hereisok,2,0.00336,28977,48.73032,59464
708,htalvitie,2,0.00336,28979,48.73369,59464
709,iayti,2,0.00336,28981,48.73705,59464
710,Igzi,2,0.00336,28983,48.74041,59464
711,iliasjennane,2,0.00336,28985,48.74378,59464
712,Ilozuluchris,2,0.00336,28987,48.74714,59464
713,influx6,2,0.00336,28989,48.75050,59464
714,ionut-balazs-lateral,2,0.00336,28991,48.75387,59464
715,ipince,2,0.00336,28993,48.75723,59464
716,itsoli91,2,0.00336,28995,48.76059,59464
717,jasoncarreira,2,0.00336,28997,48.76396,59464
718,JasonTheDeveloper,2,0.00336,28999,48.76732,59464
719,jasparmang,2,0.00336,29001,48.77068,59464
720,javierpr71,2,0.00336,29003,48.77405,59464
721,jboarman,2,0.00336,29005,48.77741,59464
722,jboner,2,0.00336,29007,48.78077,59464
723,JCFawkes,2,0.00336,29009,48.78414,59464
724,jdmchone,2,0.00336,29011,48.78750,59464
725,jellebens,2,0.00336,29013,48.79087,59464
726,JiangYanghai,2,0.00336,29015,48.79423,59464
727,JimPaine,2,0.00336,29017,48.79759,59464
728,johanan,2,0.00336,29019,48.80096,59464
729,JosephWoodward,2,0.00336,29021,48.80432,59464
730,kachawla,2,0.00336,29023,48.80768,59464
731,Keithalisk,2,0.00336,29025,48.81105,59464
732,klowdo,2,0.00336,29027,48.81441,59464
733,krg7880,2,0.00336,29029,48.81777,59464
734,lefig,2,0.00336,29031,48.82114,59464
735,lgramatikov,2,0.00336,29033,48.82450,59464
736,lihanping2016,2,0.00336,29035,48.82786,59464
737,lisy09,2,0.00336,29037,48.83123,59464
738,lizzzcai,2,0.00336,29039,48.83459,59464
739,lokijota,2,0.00336,29041,48.83795,59464
740,lokinfey,2,0.00336,29043,48.84132,59464
741,luhanCRM,2,0.00336,29045,48.84468,59464
742,LukeRH,2,0.00336,29047,48.84804,59464
743,lysilver,2,0.00336,29049,48.85141,59464
744,madstt,2,0.00336,29051,48.85477,59464
745,mandarenmanman,2,0.00336,29053,48.85813,59464
746,MarcBruins,2,0.00336,29055,48.86150,59464
747,marcus-sa,2,0.00336,29057,48.86486,59464
748,matt-lethargic,2,0.00336,29059,48.86822,59464
749,MBDev2k,2,0.00336,29061,48.87159,59464
750,mickdelaney,2,0.00336,29063,48.87495,59464
751,mikecasas,2,0.00336,29065,48.87831,59464
752,mike-geiger,2,0.00336,29067,48.88168,59464
753,mladedav,2,0.00336,29069,48.88504,59464
754,MoaidHathot,2,0.00336,29071,48.88840,59464
755,mroberts91,2,0.00336,29073,48.89177,59464
756,myFirstway,2,0.00336,29075,48.89513,59464
757,nachtmaar,2,0.00336,29077,48.89849,59464
758,naheedk-pwc,2,0.00336,29079,48.90186,59464
759,NarayanK13,2,0.00336,29081,48.90522,59464
760,n-ate,2,0.00336,29083,48.90858,59464
761,nathanawmk,2,0.00336,29085,48.91195,59464
762,nigimaster,2,0.00336,29087,48.91531,59464
763,notbasetwo,2,0.00336,29089,48.91867,59464
764,Oppen,2,0.00336,29091,48.92204,59464
765,pcracknell,2,0.00336,29093,48.92540,59464
766,peter-alegeus,2,0.00336,29095,48.92876,59464
767,pli2014,2,0.00336,29097,48.93213,59464
768,prabhakarreddy1234,2,0.00336,29099,48.93549,59464
769,prtk-fyndna,2,0.00336,29101,48.93885,59464
770,Qalifah,2,0.00336,29103,48.94222,59464
771,r1v3n,2,0.00336,29105,48.94558,59464
772,rajagopalanrg,2,0.00336,29107,48.94894,59464
773,Ravindra-a,2,0.00336,29109,48.95231,59464
774,raykpontimax,2,0.00336,29111,48.95567,59464
775,RayneHwang,2,0.00336,29113,48.95903,59464
776,RevathiNeminathan,2,0.00336,29115,48.96240,59464
777,rizamarhaban,2,0.00336,29117,48.96576,59464
778,ryan-stinson-elembio,2,0.00336,29119,48.96912,59464
779,ryou90,2,0.00336,29121,48.97249,59464
780,sahansera,2,0.00336,29123,48.97585,59464
781,sandeep-ma,2,0.00336,29125,48.97921,59464
782,sedat-eyuboglu,2,0.00336,29127,48.98258,59464
783,seize-the-dave,2,0.00336,29129,48.98594,59464
784,sequoiar,2,0.00336,29131,48.98930,59464
785,sgalcheung,2,0.00336,29133,48.99267,59464
786,sgc109,2,0.00336,29135,48.99603,59464
787,shakyShane,2,0.00336,29137,48.99939,59464
788,ShankargoudPatil,2,0.00336,29139,49.00276,59464
789,shankarmaha,2,0.00336,29141,49.00612,59464
790,shanzy20,2,0.00336,29143,49.00948,59464
791,sheldonhull,2,0.00336,29145,49.01285,59464
792,sidecus,2,0.00336,29147,49.01621,59464
793,silverjava,2,0.00336,29149,49.01957,59464
794,s-m-sufyian,2,0.00336,29151,49.02294,59464
795,spboyer,2,0.00336,29153,49.02630,59464
796,staneee,2,0.00336,29155,49.02967,59464
797,Stephanvs,2,0.00336,29157,49.03303,59464
798,StoneCypher,2,0.00336,29159,49.03639,59464
799,StormSpirit22,2,0.00336,29161,49.03976,59464
800,Sunny5151,2,0.00336,29163,49.04312,59464
801,supervacuum,2,0.00336,29165,49.04648,59464
802,surenderssm,2,0.00336,29167,49.04985,59464
803,swuecho,2,0.00336,29169,49.05321,59464
804,S-YOU,2,0.00336,29171,49.05657,59464
805,tejaswini11,2,0.00336,29173,49.05994,59464
806,thesobercoder,2,0.00336,29175,49.06330,59464
807,tholcman,2,0.00336,29177,49.06666,59464
808,tilm4nn,2,0.00336,29179,49.07003,59464
809,TimVen,2,0.00336,29181,49.07339,59464
810,tky753,2,0.00336,29183,49.07675,59464
811,TomHermolle,2,0.00336,29185,49.08012,59464
812,tonysurma,2,0.00336,29187,49.08348,59464
813,usdruscia,2,0.00336,29189,49.08684,59464
814,vCillusion,2,0.00336,29191,49.09021,59464
815,VenkateshSrinivasan,2,0.00336,29193,49.09357,59464
816,vslepakov,2,0.00336,29195,49.09693,59464
817,W7T2A,2,0.00336,29197,49.10030,59464
818,whwlsfb,2,0.00336,29199,49.10366,59464
819,wouterroos,2,0.00336,29201,49.10702,59464
820,wqliang,2,0.00336,29203,49.11039,59464
821,xunavy,2,0.00336,29205,49.11375,59464
822,Yggdrasill-7C9,2,0.00336,29207,49.11711,59464
823,yuchen-sun,2,0.00336,29209,49.12048,59464
824,zhuang1125,2,0.00336,29211,49.12384,59464
825,0to1,1,0.00168,29212,49.12552,59464
826,1029219814,1,0.00168,29213,49.12720,59464
827,3GDXC,1,0.00168,29214,49.12888,59464
828,89z,1,0.00168,29215,49.13057,59464
829,aarondglover,1,0.00168,29216,49.13225,59464
830,abbrescia,1,0.00168,29217,49.13393,59464
831,acartcat,1,0.00168,29218,49.13561,59464
832,aczarkowski,1,0.00168,29219,49.13729,59464
833,adawalli,1,0.00168,29220,49.13897,59464
834,adhurwit,1,0.00168,29221,49.14066,59464
835,Aditi33,1,0.00168,29222,49.14234,59464
836,aditirao7,1,0.00168,29223,49.14402,59464
837,afterwire,1,0.00168,29224,49.14570,59464
838,afwn90cj93201nixr2e1re,1,0.00168,29225,49.14738,59464
839,agdelarue,1,0.00168,29226,49.14906,59464
840,agriessbosch,1,0.00168,29227,49.15075,59464
841,AiDaShi,1,0.00168,29228,49.15243,59464
842,akashraj98,1,0.00168,29229,49.15411,59464
843,aL3891,1,0.00168,29230,49.15579,59464
844,AlbertAY,1,0.00168,29231,49.15747,59464
845,alexdegroot,1,0.00168,29232,49.15916,59464
846,alex-doerfler,1,0.00168,29233,49.16084,59464
847,alicejgibbons,1,0.00168,29234,49.16252,59464
848,amsoedal,1,0.00168,29235,49.16420,59464
849,AndreaPersico,1,0.00168,29236,49.16588,59464
850,andriesfc,1,0.00168,29237,49.16756,59464
851,anneum,1,0.00168,29238,49.16925,59464
852,AnThoi,1,0.00168,29239,49.17093,59464
853,AnyISalIn,1,0.00168,29240,49.17261,59464
854,ardalis,1,0.00168,29241,49.17429,59464
855,aredier,1,0.00168,29242,49.17597,59464
856,Ares3266,1,0.00168,29243,49.17765,59464
857,arkakk93,1,0.00168,29244,49.17934,59464
858,aromagnolirvlsolution,1,0.00168,29245,49.18102,59464
859,aszego,1,0.00168,29246,49.18270,59464
860,AtticusYang,1,0.00168,29247,49.18438,59464
861,ayax79,1,0.00168,29248,49.18606,59464
862,aytekinar,1,0.00168,29249,49.18774,59464
863,azureluo,1,0.00168,29250,49.18943,59464
864,barrypt,1,0.00168,29251,49.19111,59464
865,bartr,1,0.00168,29252,49.19279,59464
866,bartsimp,1,0.00168,29253,49.19447,59464
867,berkaysakarg,1,0.00168,29254,49.19615,59464
868,berndku,1,0.00168,29255,49.19783,59464
869,besteban1989,1,0.00168,29256,49.19952,59464
870,birapjr,1,0.00168,29257,49.20120,59464
871,bizcad,1,0.00168,29258,49.20288,59464
872,Bosegeek,1,0.00168,29259,49.20456,59464
873,bryht,1,0.00168,29260,49.20624,59464
874,C0ffeeCode,1,0.00168,29261,49.20792,59464
875,callebjo,1,0.00168,29262,49.20961,59464
876,cbellee,1,0.00168,29263,49.21129,59464
877,charleszhn,1,0.00168,29264,49.21297,59464
878,CharlieZ-Autodesk,1,0.00168,29265,49.21465,59464
879,charliezgc,1,0.00168,29266,49.21633,59464
880,Chay12368,1,0.00168,29267,49.21801,59464
881,chenglanguo,1,0.00168,29268,49.21970,59464
882,chenhongyi,1,0.00168,29269,49.22138,59464
883,chensheng0,1,0.00168,29270,49.22306,59464
884,chenzuo,1,0.00168,29271,49.22474,59464
885,chetan2309,1,0.00168,29272,49.22642,59464
886,chivandikwa,1,0.00168,29273,49.22810,59464
887,ChrisMcKee,1,0.00168,29274,49.22979,59464
888,chunliu,1,0.00168,29275,49.23147,59464
889,CJ99,1,0.00168,29276,49.23315,59464
890,CJHunter91,1,0.00168,29277,49.23483,59464
891,ClementeGao,1,0.00168,29278,49.23651,59464
892,coderharee,1,0.00168,29279,49.23819,59464
893,codjust,1,0.00168,29280,49.23988,59464
894,corinaivanov,1,0.00168,29281,49.24156,59464
895,costap,1,0.00168,29282,49.24324,59464
896,CSelvaraj2010,1,0.00168,29283,49.24492,59464
897,cuipengfei,1,0.00168,29284,49.24660,59464
898,CvekCoding,1,0.00168,29285,49.24828,59464
899,danbo,1,0.00168,29286,49.24997,59464
900,DanielWangZhanggui,1,0.00168,29287,49.25165,59464
901,dasamitk,1,0.00168,29288,49.25333,59464
902,dasaraiy,1,0.00168,29289,49.25501,59464
903,davlinski,1,0.00168,29290,49.25669,59464
904,dberecz,1,0.00168,29291,49.25837,59464
905,deaquino,1,0.00168,29292,49.26006,59464
906,deemkeen,1,0.00168,29293,49.26174,59464
907,deepziyu,1,0.00168,29294,49.26342,59464
908,deesejohn,1,0.00168,29295,49.26510,59464
909,DenisaJurca,1,0.00168,29296,49.26678,59464
910,dennishog,1,0.00168,29297,49.26846,59464
911,dereknex,1,0.00168,29298,49.27015,59464
912,devictorsilva,1,0.00168,29299,49.27183,59464
913,devlead,1,0.00168,29300,49.27351,59464
914,dev-nextprogress,1,0.00168,29301,49.27519,59464
915,dingsongjie,1,0.00168,29302,49.27687,59464
916,djojoz,1,0.00168,29303,49.27856,59464
917,doggy8088,1,0.00168,29304,49.28024,59464
918,DoisKoh,1,0.00168,29305,49.28192,59464
919,DoNnMyTh,1,0.00168,29306,49.28360,59464
920,dstoyanoff,1,0.00168,29307,49.28528,59464
921,dtPaTh,1,0.00168,29308,49.28696,59464
922,DuanShaolong,1,0.00168,29309,49.28865,59464
923,dystopiandev,1,0.00168,29310,49.29033,59464
924,eblanchette,1,0.00168,29311,49.29201,59464
925,EdMendezNC,1,0.00168,29312,49.29369,59464
926,edwin19861218,1,0.00168,29313,49.29537,59464
927,egorsmkv,1,0.00168,29314,49.29705,59464
928,eligrey,1,0.00168,29315,49.29874,59464
929,elvuel,1,0.00168,29316,49.30042,59464
930,enriko-riba,1,0.00168,29317,49.30210,59464
931,eolamisan,1,0.00168,29318,49.30378,59464
932,ericjee,1,0.00168,29319,49.30546,59464
933,eric-swann-q2,1,0.00168,29320,49.30714,59464
934,espray,1,0.00168,29321,49.30883,59464
935,esride-jts,1,0.00168,29322,49.31051,59464
936,FacioRatio,1,0.00168,29323,49.31219,59464
937,faysou,1,0.00168,29324,49.31387,59464
938,felixloeng,1,0.00168,29325,49.31555,59464
939,ffreitas0,1,0.00168,29326,49.31723,59464
940,fireshoot,1,0.00168,29327,49.31892,59464
941,FlatMapIO,1,0.00168,29328,49.32060,59464
942,Flmstr,1,0.00168,29329,49.32228,59464
943,foreverddong,1,0.00168,29330,49.32396,59464
944,Forrest-zhao,1,0.00168,29331,49.32564,59464
945,frozenskys,1,0.00168,29332,49.32732,59464
946,FunnyYish,1,0.00168,29333,49.32901,59464
947,furkansakar,1,0.00168,29334,49.33069,59464
948,GaiusRed,1,0.00168,29335,49.33237,59464
949,gary-desroches,1,0.00168,29336,49.33405,59464
950,gazzu,1,0.00168,29337,49.33573,59464
951,gbarceloPIB,1,0.00168,29338,49.33741,59464
952,gdlcf88,1,0.00168,29339,49.33910,59464
953,genbod,1,0.00168,29340,49.34078,59464
954,GeneralFox,1,0.00168,29341,49.34246,59464
955,GeorgeTsiokos,1,0.00168,29342,49.34414,59464
956,gidduk,1,0.00168,29343,49.34582,59464
957,gItSpLasHeR,1,0.00168,29344,49.34750,59464
958,git-torrent,1,0.00168,29345,49.34919,59464
959,GrailSeeker,1,0.00168,29346,49.35087,59464
960,GreenShadeZhang,1,0.00168,29347,49.35255,59464
961,gregfiske,1,0.00168,29348,49.35423,59464
962,greghoover,1,0.00168,29349,49.35591,59464
963,gunnarlr,1,0.00168,29350,49.35759,59464
964,guoqqqi,1,0.00168,29351,49.35928,59464
965,GuoYL123,1,0.00168,29352,49.36096,59464
966,haannnees,1,0.00168,29353,49.36264,59464
967,hafizkurniaaji,1,0.00168,29354,49.36432,59464
968,haibingzhao,1,0.00168,29355,49.36600,59464
969,hansker8,1,0.00168,29356,49.36768,59464
970,haohaifeng002,1,0.00168,29357,49.36937,59464
971,harryvu,1,0.00168,29358,49.37105,59464
972,HarshKhatore,1,0.00168,29359,49.37273,59464
973,hdget,1,0.00168,29360,49.37441,59464
974,Helenmichel,1,0.00168,29361,49.37609,59464
975,helgeblod,1,0.00168,29362,49.37777,59464
976,helmerm,1,0.00168,29363,49.37946,59464
977,heoelri,1,0.00168,29364,49.38114,59464
978,herowk,1,0.00168,29365,49.38282,59464
979,hieumoscow,1,0.00168,29366,49.38450,59464
980,hoffe86,1,0.00168,29367,49.38618,59464
981,HongjiangHuang,1,0.00168,29368,49.38786,59464
982,hongjic,1,0.00168,29369,49.38955,59464
983,horros,1,0.00168,29370,49.39123,59464
984,hotfirewire,1,0.00168,29371,49.39291,59464
985,howlowck,1,0.00168,29372,49.39459,59464
986,huangxunyi,1,0.00168,29373,49.39627,59464
987,huzhiguan,1,0.00168,29374,49.39796,59464
988,ibmendoza,1,0.00168,29375,49.39964,59464
989,Ibrahim-Islam,1,0.00168,29376,49.40132,59464
990,idrennanvmware,1,0.00168,29377,49.40300,59464
991,igsys,1,0.00168,29378,49.40468,59464
992,Immorality21,1,0.00168,29379,49.40636,59464
993,inuvano-labs,1,0.00168,29380,49.40805,59464
994,irhawks,1,0.00168,29381,49.40973,59464
995,israelevi-code,1,0.00168,29382,49.41141,59464
996,issingle,1,0.00168,29383,49.41309,59464
997,I-take-it-smart,1,0.00168,29384,49.41477,59464
998,iweixubin,1,0.00168,29385,49.41645,59464
999,jakkaj,1,0.00168,29386,49.41814,59464
1000,janmedrek,1,0.00168,29387,49.41982,59464
1001,jason-chong,1,0.00168,29388,49.42150,59464
1002,jasonrpeterson,1,0.00168,29389,49.42318,59464
1003,jasonsoft,1,0.00168,29390,49.42486,59464
1004,jaypaddy,1,0.00168,29391,49.42654,59464
1005,jdgomeza,1,0.00168,29392,49.42823,59464
1006,jeffdoolittle,1,0.00168,29393,49.42991,59464
1007,jekula,1,0.00168,29394,49.43159,59464
1008,JensKula,1,0.00168,29395,49.43327,59464
1009,joearias,1,0.00168,29396,49.43495,59464
1010,JohnH-Work,1,0.00168,29397,49.43663,59464
1011,johnjelinek,1,0.00168,29398,49.43832,59464
1012,jornhd,1,0.00168,29399,49.44000,59464
1013,joshbode,1,0.00168,29400,49.44168,59464
1014,Jossec101,1,0.00168,29401,49.44336,59464
1015,jplane,1,0.00168,29402,49.44504,59464
1016,jrjenks-davinci,1,0.00168,29403,49.44672,59464
1017,juaby,1,0.00168,29404,49.44841,59464
1018,juanluelguerre,1,0.00168,29405,49.45009,59464
1019,Juliandb1708,1,0.00168,29406,49.45177,59464
1020,kamasylvia,1,0.00168,29407,49.45345,59464
1021,kamlesh-nb,1,0.00168,29408,49.45513,59464
1022,karolzlot,1,0.00168,29409,49.45681,59464
1023,kencharos,1,0.00168,29410,49.45850,59464
1024,kevin100702,1,0.00168,29411,49.46018,59464
1025,kevingbb,1,0.00168,29412,49.46186,59464
1026,kinderyj,1,0.00168,29413,49.46354,59464
1027,kinglionsoft,1,0.00168,29414,49.46522,59464
1028,kiran290,1,0.00168,29415,49.46690,59464
1029,kishanTakeda,1,0.00168,29416,49.46859,59464
1030,KoditkarVedant,1,0.00168,29417,49.47027,59464
1031,kshyju,1,0.00168,29418,49.47195,59464
1032,kskem,1,0.00168,29419,49.47363,59464
1033,larsoleruben,1,0.00168,29420,49.47531,59464
1034,laxapanj,1,0.00168,29421,49.47699,59464
1035,LEBATRUNG,1,0.00168,29422,49.47868,59464
1036,leeprtc,1,0.00168,29423,49.48036,59464
1037,leskap1,1,0.00168,29424,49.48204,59464
1038,lichen782,1,0.00168,29425,49.48372,59464
1039,LongBeachHXC,1,0.00168,29426,49.48540,59464
1040,longday24,1,0.00168,29427,49.48708,59464
1041,Lonli-Lokli,1,0.00168,29428,49.48877,59464
1042,LoungeFlyZ,1,0.00168,29429,49.49045,59464
1043,maksimkim,1,0.00168,29430,49.49213,59464
1044,manishvicky,1,0.00168,29431,49.49381,59464
1045,ManuDinicola,1,0.00168,29432,49.49549,59464
1046,MarcinKruszynski,1,0.00168,29433,49.49717,59464
1047,marciomyst,1,0.00168,29434,49.49886,59464
1048,marcmaranon,1,0.00168,29435,49.50054,59464
1049,MarcStoecker,1,0.00168,29436,49.50222,59464
1050,marjorienorm,1,0.00168,29437,49.50390,59464
1051,markheath,1,0.00168,29438,49.50558,59464
1052,marlinla,1,0.00168,29439,49.50726,59464
1053,martinriedel,1,0.00168,29440,49.50895,59464
1054,masoud-shayan,1,0.00168,29441,49.51063,59464
1055,MatiKloster,1,0.00168,29442,49.51231,59464
1056,matthieuklotz,1,0.00168,29443,49.51399,59464
1057,mattscully,1,0.00168,29444,49.51567,59464
1058,maulik-modi,1,0.00168,29445,49.51736,59464
1059,Max-Eriksson,1,0.00168,29446,49.51904,59464
1060,mcrio,1,0.00168,29447,49.52072,59464
1061,mdmg92,1,0.00168,29448,49.52240,59464
1062,mehdijoafshani,1,0.00168,29449,49.52408,59464
1063,melodicdeath,1,0.00168,29450,49.52576,59464
1064,merken,1,0.00168,29451,49.52745,59464
1065,mexanichp,1,0.00168,29452,49.52913,59464
1066,mheisenberg,1,0.00168,29453,49.53081,59464
1067,mikanyg,1,0.00168,29454,49.53249,59464
1068,MIKEPArA,1,0.00168,29455,49.53417,59464
1069,milijan,1,0.00168,29456,49.53585,59464
1070,minascasiou,1,0.00168,29457,49.53754,59464
1071,mivano,1,0.00168,29458,49.53922,59464
1072,mmarquesbr,1,0.00168,29459,49.54090,59464
1073,mnsrulz,1,0.00168,29460,49.54258,59464
1074,mohsenmahdieh,1,0.00168,29461,49.54426,59464
1075,moulikcipherX,1,0.00168,29462,49.54594,59464
1076,mpaine-act,1,0.00168,29463,49.54763,59464
1077,mpalmer78,1,0.00168,29464,49.54931,59464
1078,mpldr,1,0.00168,29465,49.55099,59464
1079,msjiaxie,1,0.00168,29466,49.55267,59464
1080,ms-kashyap,1,0.00168,29467,49.55435,59464
1081,mswilson4040,1,0.00168,29468,49.55603,59464
1082,mukundans91,1,0.00168,29469,49.55772,59464
1083,mukundansundararajan,1,0.00168,29470,49.55940,59464
1084,napalm684,1,0.00168,29471,49.56108,59464
1085,NathanaelZuchuon,1,0.00168,29472,49.56276,59464
1086,navndn,1,0.00168,29473,49.56444,59464
1087,nesherhh,1,0.00168,29474,49.56612,59464
1088,NexZhu,1,0.00168,29475,49.56781,59464
1089,ngealy,1,0.00168,29476,49.56949,59464
1090,niclar,1,0.00168,29477,49.57117,59464
1091,NicoSchuett,1,0.00168,29478,49.57285,59464
1092,NitrofCG,1,0.00168,29479,49.57453,59464
1093,nitroin,1,0.00168,29480,49.57621,59464
1094,nk-thouc,1,0.00168,29481,49.57790,59464
1095,nnthuanegany,1,0.00168,29482,49.57958,59464
1096,nrjohnstone,1,0.00168,29483,49.58126,59464
1097,nskarakoc,1,0.00168,29484,49.58294,59464
1098,nstrause1,1,0.00168,29485,49.58462,59464
1099,nuvetek,1,0.00168,29486,49.58630,59464
1100,Oceanswave,1,0.00168,29487,49.58799,59464
1101,olegchorny,1,0.00168,29488,49.58967,59464
1102,ol-sudo,1,0.00168,29489,49.59135,59464
1103,onionhammer,1,0.00168,29490,49.59303,59464
1104,openwindow,1,0.00168,29491,49.59471,59464
1105,OpenWindow,1,0.00168,29492,49.59639,59464
1106,pankajarav,1,0.00168,29493,49.59808,59464
1107,pankajthakare-mb,1,0.00168,29494,49.59976,59464
1108,pathing,1,0.00168,29495,49.60144,59464
1109,patrickdemooij,1,0.00168,29496,49.60312,59464
1110,paulgyro,1,0.00168,29497,49.60480,59464
1111,PaulRiviera,1,0.00168,29498,49.60648,59464
1112,penghuima,1,0.00168,29499,49.60817,59464
1113,pisees,1,0.00168,29500,49.60985,59464
1114,pjanaya,1,0.00168,29501,49.61153,59464
1115,PlusMinus0,1,0.00168,29502,49.61321,59464
1116,pnocera,1,0.00168,29503,49.61489,59464
1117,polar3130,1,0.00168,29504,49.61657,59464
1118,pparth,1,0.00168,29505,49.61826,59464
1119,Proximus-Azure-Services,1,0.00168,29506,49.61994,59464
1120,prtk-g,1,0.00168,29507,49.62162,59464
1121,PubSubServices,1,0.00168,29508,49.62330,59464
1122,purefun,1,0.00168,29509,49.62498,59464
1123,qayshp,1,0.00168,29510,49.62666,59464
1124,quanquangduc,1,0.00168,29511,49.62835,59464
1125,rafamerlin,1,0.00168,29512,49.63003,59464
1126,rahuahua,1,0.00168,29513,49.63171,59464
1127,rahulpoddar-fyndna,1,0.00168,29514,49.63339,59464
1128,rainfd,1,0.00168,29515,49.63507,59464
1129,rdiaz82,1,0.00168,29516,49.63676,59464
1130,redaER7,1,0.00168,29517,49.63844,59464
1131,RehanSaeed,1,0.00168,29518,49.64012,59464
1132,rehbergtr,1,0.00168,29519,49.64180,59464
1133,ringods,1,0.00168,29520,49.64348,59464
1134,RJvH,1,0.00168,29521,49.64516,59464
1135,rkayman,1,0.00168,29522,49.64685,59464
1136,robberphex,1,0.00168,29523,49.64853,59464
1137,roberto-mardeni,1,0.00168,29524,49.65021,59464
1138,rschiefer,1,0.00168,29525,49.65189,59464
1139,rtmorgan,1,0.00168,29526,49.65357,59464
1140,rtrindvg,1,0.00168,29527,49.65525,59464
1141,runemy,1,0.00168,29528,49.65694,59464
1142,ruslanguk,1,0.00168,29529,49.65862,59464
1143,saendu,1,0.00168,29530,49.66030,59464
1144,SahajR,1,0.00168,29531,49.66198,59464
1145,sahan91,1,0.00168,29532,49.66366,59464
1146,sameer106,1,0.00168,29533,49.66534,59464
1147,samikshaJ,1,0.00168,29534,49.66703,59464
1148,samip5,1,0.00168,29535,49.66871,59464
1149,sandeep-eroad,1,0.00168,29536,49.67039,59464
1150,sandeshkg,1,0.00168,29537,49.67207,59464
1151,sandipsmahajan,1,0.00168,29538,49.67375,59464
1152,SaschaPWittwer,1,0.00168,29539,49.67543,59464
1153,ScofieldOY,1,0.00168,29540,49.67712,59464
1154,ScottArbeit,1,0.00168,29541,49.67880,59464
1155,searus,1,0.00168,29542,49.68048,59464
1156,SebastianSchildt,1,0.00168,29543,49.68216,59464
1157,seenu433,1,0.00168,29544,49.68384,59464
1158,seewindcn,1,0.00168,29545,49.68552,59464
1159,sentoz,1,0.00168,29546,49.68721,59464
1160,shawn-deng,1,0.00168,29547,49.68889,59464
1161,Sigi-os,1,0.00168,29548,49.69057,59464
1162,sigpop,1,0.00168,29549,49.69225,59464
1163,singhabhilash,1,0.00168,29550,49.69393,59464
1164,sing-ideas,1,0.00168,29551,49.69561,59464
1165,sjf10050,1,0.00168,29552,49.69730,59464
1166,skordesign,1,0.00168,29553,49.69898,59464
1167,slayer,1,0.00168,29554,49.70066,59464
1168,smereczynski,1,0.00168,29555,49.70234,59464
1169,smitterh,1,0.00168,29556,49.70402,59464
1170,sniper-xx,1,0.00168,29557,49.70570,59464
1171,sol-lee,1,0.00168,29558,49.70739,59464
1172,Spars3Matrix,1,0.00168,29559,49.70907,59464
1173,spasumalaithevan,1,0.00168,29560,49.71075,59464
1174,sravan-pallamreddy,1,0.00168,29561,49.71243,59464
1175,starzhou,1,0.00168,29562,49.71411,59464
1176,StefH,1,0.00168,29563,49.71579,59464
1177,stephenaggett,1,0.00168,29564,49.71748,59464
1178,stevef1uk,1,0.00168,29565,49.71916,59464
1179,stliu,1,0.00168,29566,49.72084,59464
1180,sullis,1,0.00168,29567,49.72252,59464
1181,swiftugandan,1,0.00168,29568,49.72420,59464
1182,tangxusc,1,0.00168,29569,49.72588,59464
1183,tehmoth,1,0.00168,29570,49.72757,59464
1184,TerraVenil,1,0.00168,29571,49.72925,59464
1185,theduke,1,0.00168,29572,49.73093,59464
1186,thinkbigdatanalytics,1,0.00168,29573,49.73261,59464
1187,thoemmi,1,0.00168,29574,49.73429,59464
1188,thombrn,1,0.00168,29575,49.73597,59464
1189,TilmannBach,1,0.00168,29576,49.73766,59464
1190,timeshift92,1,0.00168,29577,49.73934,59464
1191,tmatev,1,0.00168,29578,49.74102,59464
1192,Tojuro,1,0.00168,29579,49.74270,59464
1193,Tokumicn,1,0.00168,29580,49.74438,59464
1194,tomasherceg,1,0.00168,29581,49.74606,59464
1195,tomgron,1,0.00168,29582,49.74775,59464
1196,ToNewDay,1,0.00168,29583,49.74943,59464
1197,tonidy,1,0.00168,29584,49.75111,59464
1198,tonyqus,1,0.00168,29585,49.75279,59464
1199,tony-shi,1,0.00168,29586,49.75447,59464
1200,touchofevil2,1,0.00168,29587,49.75615,59464
1201,tryhardest,1,0.00168,29588,49.75784,59464
1202,tsubasaxZZZ,1,0.00168,29589,49.75952,59464
1203,tunoi,1,0.00168,29590,49.76120,59464
1204,tylertechgraves,1,0.00168,29591,49.76288,59464
1205,VermaNishant978,1,0.00168,29592,49.76456,59464
1206,vikingcodes,1,0.00168,29593,49.76625,59464
1207,vinayakkumargupta,1,0.00168,29594,49.76793,59464
1208,virginoid,1,0.00168,29595,49.76961,59464
1209,VishnuuVijayan,1,0.00168,29596,49.77129,59464
1210,waltermyersiii,1,0.00168,29597,49.77297,59464
1211,waqasraz,1,0.00168,29598,49.77465,59464
1212,WaterYue,1,0.00168,29599,49.77634,59464
1213,Weidaicheng,1,0.00168,29600,49.77802,59464
1214,whilelie,1,0.00168,29601,49.77970,59464
1215,Whivel,1,0.00168,29602,49.78138,59464
1216,wimvc1,1,0.00168,29603,49.78306,59464
1217,wimvdc,1,0.00168,29604,49.78474,59464
1218,Wriky,1,0.00168,29605,49.78643,59464
1219,xfiodembo,1,0.00168,29606,49.78811,59464
1220,xiaoweil,1,0.00168,29607,49.78979,59464
1221,xinyii,1,0.00168,29608,49.79147,59464
1222,yaobo-lab,1,0.00168,29609,49.79315,59464
1223,yavuztor,1,0.00168,29610,49.79483,59464
1224,yavuzturk96,1,0.00168,29611,49.79652,59464
1225,younss,1,0.00168,29612,49.79820,59464
1226,yrong,1,0.00168,29613,49.79988,59464
1227,YurasovDV,1,0.00168,29614,49.80156,59464
1228,yuridevx,1,0.00168,29615,49.80324,59464
1229,zfchai,1,0.00168,29616,49.80492,59464
1230,zhchlmm,1,0.00168,29617,49.80661,59464
1231,zhenjunMa,1,0.00168,29618,49.80829,59464
1232,zhonglang115,1,0.00168,29619,49.80997,59464
1233,Zigby,1,0.00168,29620,49.81165,59464
1234,ziuyung,1,0.00168,29621,49.81333,59464
1235,zsq1576154634,1,0.00168,29622,49.81501,59464
