rank_number,actor,contributions,percent,cumulative_sum,cumulative_percent,all_contributions
1,champtar,672,6.89584,672,6.89584,9745
2,msherif1234,281,2.88353,953,9.77937,9745
3,markdgray,269,2.76039,1222,12.53976,9745
4,oribon,140,1.43663,1362,13.97640,9745
5,sabinaaledort,104,1.06721,1466,15.04361,9745
6,liuyuan10,71,0.72858,1537,15.77219,9745
7,xnaveira,36,0.36942,1573,16.14161,9745
8,p-v-a,22,0.22576,1595,16.36737,9745
9,ykulazhenkov,19,0.19497,1614,16.56234,9745
10,bantocn,18,0.18471,1632,16.74705,9745
11,cmcarey,15,0.15393,1647,16.90097,9745
12,ElanHasson,15,0.15393,1662,17.05490,9745
13,rdxmb,15,0.15393,1677,17.20883,9745
14,chief93,14,0.14366,1691,17.35249,9745
15,icpenguins,14,0.14366,1705,17.49615,9745
16,mikemckiernan,14,0.14366,1719,17.63982,9745
17,remche,14,0.14366,1733,17.78348,9745
18,utkuozdemir,14,0.14366,1747,17.92714,9745
19,gayathri-baskaran,13,0.13340,1760,18.06054,9745
20,mleklund,13,0.13340,1773,18.19395,9745
21,mmack,13,0.13340,1786,18.32735,9745
22,rahul-kr4604,13,0.13340,1799,18.46075,9745
23,aditsachde,12,0.12314,1811,18.58389,9745
24,aleksey005,12,0.12314,1823,18.70703,9745
25,Elegant996,12,0.12314,1835,18.83017,9745
26,Matoch,12,0.12314,1847,18.95331,9745
27,pdf,12,0.12314,1859,19.07645,9745
28,TheKangaroo,12,0.12314,1871,19.19959,9745
29,aleks-mariusz,11,0.11288,1882,19.31247,9745
30,brettjenkins,11,0.11288,1893,19.42535,9745
31,chenpfeisoo,11,0.11288,1904,19.53822,9745
32,TheEnbyperor,11,0.11288,1915,19.65110,9745
33,Christoph-Raab,10,0.10262,1925,19.75372,9745
34,mxey,10,0.10262,1935,19.85634,9745
35,nalakawula,10,0.10262,1945,19.95895,9745
36,onmyflow,10,0.10262,1955,20.06157,9745
37,t0b3,10,0.10262,1965,20.16419,9745
38,13567436138,9,0.09236,1974,20.25654,9745
39,adamdunstan,9,0.09236,1983,20.34890,9745
40,DarkBlaez,9,0.09236,1992,20.44125,9745
41,olegmayko,9,0.09236,2001,20.53361,9745
42,qiyongxiao,9,0.09236,2010,20.62596,9745
43,davjr96,8,0.08209,2018,20.70806,9745
44,ghorofamike,8,0.08209,2026,20.79015,9745
45,jpm38,8,0.08209,2034,20.87224,9745
46,MinhDuc010194,8,0.08209,2042,20.95434,9745
47,rifaterdemsahin,8,0.08209,2050,21.03643,9745
48,ashak,7,0.07183,2057,21.10826,9745
49,asvillamar,7,0.07183,2064,21.18009,9745
50,davidq2q,7,0.07183,2071,21.25192,9745
51,driftavalli,7,0.07183,2078,21.32376,9745
52,dylex,7,0.07183,2085,21.39559,9745
53,halfa,7,0.07183,2092,21.46742,9745
54,honza801,7,0.07183,2099,21.53925,9745
55,hslabbert,7,0.07183,2106,21.61108,9745
56,jpiper,7,0.07183,2113,21.68291,9745
57,juliantaylor,7,0.07183,2120,21.75475,9745
58,maximih,7,0.07183,2127,21.82658,9745
59,RdL87,7,0.07183,2134,21.89841,9745
60,teralype,7,0.07183,2141,21.97024,9745
61,troppens,7,0.07183,2148,22.04207,9745
62,andrelop,6,0.06157,2154,22.10364,9745
63,donnib,6,0.06157,2160,22.16521,9745
64,harii9,6,0.06157,2166,22.22678,9745
65,jawabuu,6,0.06157,2172,22.28835,9745
66,jcrosel,6,0.06157,2178,22.34992,9745
67,jlclx,6,0.06157,2184,22.41149,9745
68,ryholt,6,0.06157,2190,22.47306,9745
69,WillieWookiee,6,0.06157,2196,22.53463,9745
70,chrono2002,5,0.05131,2201,22.58594,9745
71,ckoester2,5,0.05131,2206,22.63725,9745
72,dkulchinsky,5,0.05131,2211,22.68856,9745
73,gallart,5,0.05131,2216,22.73987,9745
74,ggmr2212,5,0.05131,2221,22.79117,9745
75,Henry-Kim-Youngwoo,5,0.05131,2226,22.84248,9745
76,howels,5,0.05131,2231,22.89379,9745
77,kiuka,5,0.05131,2236,22.94510,9745
78,ohauer,5,0.05131,2241,22.99641,9745
79,rbq,5,0.05131,2246,23.04772,9745
80,redmangospros,5,0.05131,2251,23.09903,9745
81,schaze,5,0.05131,2256,23.15033,9745
82,spuder,5,0.05131,2261,23.20164,9745
83,swoga,5,0.05131,2266,23.25295,9745
84,till,5,0.05131,2271,23.30426,9745
85,tommyknows,5,0.05131,2276,23.35557,9745
86,treydock,5,0.05131,2281,23.40688,9745
87,Zyt612,5,0.05131,2286,23.45818,9745
88,zzzuzik,5,0.05131,2291,23.50949,9745
89,albe2669,4,0.04105,2295,23.55054,9745
90,AlexisDucastel,4,0.04105,2299,23.59159,9745
91,ananbas,4,0.04105,2303,23.63263,9745
92,arnaudgelly,4,0.04105,2307,23.67368,9745
93,chrisplo,4,0.04105,2311,23.71473,9745
94,cjreyn,4,0.04105,2315,23.75577,9745
95,coolermister,4,0.04105,2319,23.79682,9745
96,dldd17,4,0.04105,2323,23.83787,9745
97,dschunack,4,0.04105,2327,23.87891,9745
98,elgamal2020,4,0.04105,2331,23.91996,9745
99,elliotmoso,4,0.04105,2335,23.96101,9745
100,eranyanay,4,0.04105,2339,24.00205,9745
101,frouzbeh,4,0.04105,2343,24.04310,9745
102,hatt,4,0.04105,2347,24.08415,9745
103,icefed,4,0.04105,2351,24.12519,9745
104,jenciso,4,0.04105,2355,24.16624,9745
105,jeroenjacobs1205,4,0.04105,2359,24.20729,9745
106,johnlane,4,0.04105,2363,24.24833,9745
107,jr0dd,4,0.04105,2367,24.28938,9745
108,Jumpy-Squirrel,4,0.04105,2371,24.33043,9745
109,liaolinrong,4,0.04105,2375,24.37147,9745
110,maxisam,4,0.04105,2379,24.41252,9745
111,mcarbonneaux,4,0.04105,2383,24.45357,9745
112,morgwai,4,0.04105,2387,24.49461,9745
113,orenzp,4,0.04105,2391,24.53566,9745
114,ralfonso,4,0.04105,2395,24.57671,9745
115,RostyslavFridman,4,0.04105,2399,24.61775,9745
116,shaggykp,4,0.04105,2403,24.65880,9745
117,skydoctor,4,0.04105,2407,24.69985,9745
118,stevenfollis,4,0.04105,2411,24.74089,9745
119,tedder,4,0.04105,2415,24.78194,9745
120,tiandong19860806,4,0.04105,2419,24.82299,9745
121,vgoldani,4,0.04105,2423,24.86403,9745
122,WeirdMachine,4,0.04105,2427,24.90508,9745
123,zerobane,4,0.04105,2431,24.94613,9745
124,ahdzesq,3,0.03079,2434,24.97691,9745
125,berlinsaint,3,0.03079,2437,25.00770,9745
126,bkupidura,3,0.03079,2440,25.03848,9745
127,calfox,3,0.03079,2443,25.06927,9745
128,Champ-Goblem,3,0.03079,2446,25.10005,9745
129,christarazi,3,0.03079,2449,25.13084,9745
130,danielkucera,3,0.03079,2452,25.16162,9745
131,dano0b,3,0.03079,2455,25.19241,9745
132,dirtbag,3,0.03079,2458,25.22319,9745
133,Diz100rM,3,0.03079,2461,25.25398,9745
134,doug62,3,0.03079,2464,25.28476,9745
135,falfaro,3,0.03079,2467,25.31555,9745
136,flaktack,3,0.03079,2470,25.34633,9745
137,flokli,3,0.03079,2473,25.37712,9745
138,gggitpl,3,0.03079,2476,25.40790,9745
139,HaveFun83,3,0.03079,2479,25.43869,9745
140,hibby50,3,0.03079,2482,25.46947,9745
141,holmesb,3,0.03079,2485,25.50026,9745
142,iceman91176,3,0.03079,2488,25.53104,9745
143,imranrazakhan,3,0.03079,2491,25.56183,9745
144,inevity,3,0.03079,2494,25.59261,9745
145,Inv0k-er,3,0.03079,2497,25.62340,9745
146,ivan046,3,0.03079,2500,25.65418,9745
147,jcatana,3,0.03079,2503,25.68497,9745
148,joestafford,3,0.03079,2506,25.71575,9745
149,johnlunney,3,0.03079,2509,25.74654,9745
150,ju4nmg,3,0.03079,2512,25.77732,9745
151,juanrgm,3,0.03079,2515,25.80811,9745
152,juliohm1978,3,0.03079,2518,25.83889,9745
153,kristoferobin,3,0.03079,2521,25.86968,9745
154,leroyshirto,3,0.03079,2524,25.90046,9745
155,lmishii,3,0.03079,2527,25.93125,9745
156,M0nsieurChat,3,0.03079,2530,25.96203,9745
157,michael-robbins,3,0.03079,2533,25.99282,9745
158,mikefaraponov,3,0.03079,2536,26.02360,9745
159,mimmus,3,0.03079,2539,26.05439,9745
160,MoJo2600,3,0.03079,2542,26.08517,9745
161,msoderberg,3,0.03079,2545,26.11596,9745
162,owbmoore,3,0.03079,2548,26.14674,9745
163,pecheneg12,3,0.03079,2551,26.17753,9745
164,protheusfr,3,0.03079,2554,26.20831,9745
165,rsanders,3,0.03079,2557,26.23910,9745
166,SergeyJyravlev,3,0.03079,2560,26.26988,9745
167,SergeyMuha,3,0.03079,2563,26.30067,9745
168,sha224,3,0.03079,2566,26.33145,9745
169,shanedizer,3,0.03079,2569,26.36224,9745
170,sksaranraj,3,0.03079,2572,26.39302,9745
171,steebchen,3,0.03079,2575,26.42381,9745
172,stokbaek,3,0.03079,2578,26.45459,9745
173,Tatsu-Kishi,3,0.03079,2581,26.48538,9745
174,tylfin,3,0.03079,2584,26.51616,9745
175,vaizki,3,0.03079,2587,26.54695,9745
176,vakarthik,3,0.03079,2590,26.57773,9745
177,vapon,3,0.03079,2593,26.60852,9745
178,vkorn,3,0.03079,2596,26.63930,9745
179,WKBae,3,0.03079,2599,26.67009,9745
180,ydotk,3,0.03079,2602,26.70087,9745
181,yenneferofvengerberg,3,0.03079,2605,26.73166,9745
182,ymettier,3,0.03079,2608,26.76244,9745
183,aaronspruit,2,0.02052,2610,26.78297,9745
184,albertkohl-monotek,2,0.02052,2612,26.80349,9745
185,anandsinghkunwar,2,0.02052,2614,26.82401,9745
186,AshleyDumaine,2,0.02052,2616,26.84454,9745
187,blmhemu,2,0.02052,2618,26.86506,9745
188,bstascavage,2,0.02052,2620,26.88558,9745
189,byronmccollum,2,0.02052,2622,26.90611,9745
190,chezbut,2,0.02052,2624,26.92663,9745
191,creativie,2,0.02052,2626,26.94715,9745
192,CSRedRat,2,0.02052,2628,26.96768,9745
193,dave-tock,2,0.02052,2630,26.98820,9745
194,dberadze,2,0.02052,2632,27.00872,9745
195,deadNightTiger,2,0.02052,2634,27.02925,9745
196,drz9,2,0.02052,2636,27.04977,9745
197,enkelprifti98,2,0.02052,2638,27.07029,9745
198,GanKanTechnology,2,0.02052,2640,27.09082,9745
199,ggilley,2,0.02052,2642,27.11134,9745
200,gprossliner,2,0.02052,2644,27.13186,9745
201,groundhog2k,2,0.02052,2646,27.15239,9745
202,HankTheCrank,2,0.02052,2648,27.17291,9745
203,heimdull,2,0.02052,2650,27.19343,9745
204,Hopobcn,2,0.02052,2652,27.21396,9745
205,Jc2k,2,0.02052,2654,27.23448,9745
206,k2mahajan,2,0.02052,2656,27.25500,9745
207,kthurs,2,0.02052,2658,27.27553,9745
208,lin199231,2,0.02052,2660,27.29605,9745
209,logan2211,2,0.02052,2662,27.31657,9745
210,luzhongming,2,0.02052,2664,27.33710,9745
211,MarcoR83,2,0.02052,2666,27.35762,9745
212,masa213f,2,0.02052,2668,27.37814,9745
213,maxirus,2,0.02052,2670,27.39867,9745
214,mdavidsen,2,0.02052,2672,27.41919,9745
215,mhristache,2,0.02052,2674,27.43971,9745
216,misterdorm,2,0.02052,2676,27.46024,9745
217,mkhpalm,2,0.02052,2678,27.48076,9745
218,muffin87,2,0.02052,2680,27.50128,9745
219,nbraud,2,0.02052,2682,27.52181,9745
220,neurostream,2,0.02052,2684,27.54233,9745
221,nkaplatt,2,0.02052,2686,27.56285,9745
222,NorthFuture,2,0.02052,2688,27.58338,9745
223,pandeybk,2,0.02052,2690,27.60390,9745
224,paulwalko,2,0.02052,2692,27.62442,9745
225,pawankkamboj,2,0.02052,2694,27.64495,9745
226,rbirkby,2,0.02052,2696,27.66547,9745
227,rchenzheng,2,0.02052,2698,27.68599,9745
228,rhysjtevans,2,0.02052,2700,27.70652,9745
229,riking,2,0.02052,2702,27.72704,9745
230,rodrigodc,2,0.02052,2704,27.74756,9745
231,rptl,2,0.02052,2706,27.76809,9745
232,runam0K,2,0.02052,2708,27.78861,9745
233,sajjadG,2,0.02052,2710,27.80913,9745
234,sammcgeown,2,0.02052,2712,27.82966,9745
235,sathieu,2,0.02052,2714,27.85018,9745
236,seroron,2,0.02052,2716,27.87070,9745
237,SpencerSharkey,2,0.02052,2718,27.89123,9745
238,StefanSa,2,0.02052,2720,27.91175,9745
239,sterlingdragon,2,0.02052,2722,27.93227,9745
240,stevbev,2,0.02052,2724,27.95280,9745
241,stevensingh,2,0.02052,2726,27.97332,9745
242,sunney2010,2,0.02052,2728,27.99384,9745
243,superherointj,2,0.02052,2730,28.01437,9745
244,Thoro,2,0.02052,2732,28.03489,9745
245,tirelibirefe,2,0.02052,2734,28.05541,9745
246,tivrobo,2,0.02052,2736,28.07594,9745
247,Trackhe,2,0.02052,2738,28.09646,9745
248,windowsrefund,2,0.02052,2740,28.11698,9745
249,wzrdtales,2,0.02052,2742,28.13751,9745
250,zwiy,2,0.02052,2744,28.15803,9745
251,205g0,1,0.01026,2745,28.16829,9745
252,5at,1,0.01026,2746,28.17855,9745
253,adamsteinbok,1,0.01026,2747,28.18881,9745
254,adriancuadrado,1,0.01026,2748,28.19908,9745
255,Aeris126,1,0.01026,2749,28.20934,9745
256,ahmet2mir,1,0.01026,2750,28.21960,9745
257,Akay7,1,0.01026,2751,28.22986,9745
258,alaslums,1,0.01026,2752,28.24012,9745
259,alchemistake,1,0.01026,2753,28.25038,9745
260,alexanderturner,1,0.01026,2754,28.26065,9745
261,alexbarcelo,1,0.01026,2755,28.27091,9745
262,algakzru,1,0.01026,2756,28.28117,9745
263,alibo,1,0.01026,2757,28.29143,9745
264,amobdlp,1,0.01026,2758,28.30169,9745
265,AMyltsev,1,0.01026,2759,28.31195,9745
266,anroots,1,0.01026,2760,28.32222,9745
267,anthonyclarka2,1,0.01026,2761,28.33248,9745
268,anthonyliriano,1,0.01026,2762,28.34274,9745
269,antonvdl,1,0.01026,2763,28.35300,9745
270,aphistic,1,0.01026,2764,28.36326,9745
271,aphsa,1,0.01026,2765,28.37352,9745
272,arsenhovhannisyan95,1,0.01026,2766,28.38379,9745
273,artazar,1,0.01026,2767,28.39405,9745
274,Atharex,1,0.01026,2768,28.40431,9745
275,barthoda,1,0.01026,2769,28.41457,9745
276,Be-El,1,0.01026,2770,28.42483,9745
277,bharder,1,0.01026,2771,28.43509,9745
278,bianchi2,1,0.01026,2772,28.44536,9745
279,bordenit,1,0.01026,2773,28.45562,9745
280,brunnerf,1,0.01026,2774,28.46588,9745
281,buggtb,1,0.01026,2775,28.47614,9745
282,BumwooPark,1,0.01026,2776,28.48640,9745
283,burnechr,1,0.01026,2777,28.49666,9745
284,callicles,1,0.01026,2778,28.50693,9745
285,cambrant,1,0.01026,2779,28.51719,9745
286,CaptainRedHat,1,0.01026,2780,28.52745,9745
287,carroarmato0,1,0.01026,2781,28.53771,9745
288,cbarratt,1,0.01026,2782,28.54797,9745
289,ccatlett2000,1,0.01026,2783,28.55823,9745
290,cgoncalves,1,0.01026,2784,28.56850,9745
291,chrisbulgaria,1,0.01026,2785,28.57876,9745
292,chris-mccoy,1,0.01026,2786,28.58902,9745
293,ChristofferNicklassonLenswayGroup,1,0.01026,2787,28.59928,9745
294,CJP10,1,0.01026,2788,28.60954,9745
295,ClaudiuLSH,1,0.01026,2789,28.61981,9745
296,ClientIco,1,0.01026,2790,28.63007,9745
297,cobravsninja,1,0.01026,2791,28.64033,9745
298,ColdFreak,1,0.01026,2792,28.65059,9745
299,colinwilson,1,0.01026,2793,28.66085,9745
300,conexia-it,1,0.01026,2794,28.67111,9745
301,CorfitzMe,1,0.01026,2795,28.68138,9745
302,Cspellz,1,0.01026,2796,28.69164,9745
303,cspiess24,1,0.01026,2797,28.70190,9745
304,curantes,1,0.01026,2798,28.71216,9745
305,cylewitruk,1,0.01026,2799,28.72242,9745
306,Cytrian,1,0.01026,2800,28.73268,9745
307,damonjbeasley,1,0.01026,2801,28.74295,9745
308,danielhoherd,1,0.01026,2802,28.75321,9745
309,danieljkemp,1,0.01026,2803,28.76347,9745
310,darkhonor,1,0.01026,2804,28.77373,9745
311,davemuench,1,0.01026,2805,28.78399,9745
312,davidandreoletti,1,0.01026,2806,28.79425,9745
313,deep7710,1,0.01026,2807,28.80452,9745
314,DeviantEng,1,0.01026,2808,28.81478,9745
315,diddi-,1,0.01026,2809,28.82504,9745
316,dimatha,1,0.01026,2810,28.83530,9745
317,Dimiftb,1,0.01026,2811,28.84556,9745
318,dlxneamtu,1,0.01026,2812,28.85582,9745
319,dolvany,1,0.01026,2813,28.86609,9745
320,DonAndrey,1,0.01026,2814,28.87635,9745
321,donkeysharp,1,0.01026,2815,28.88661,9745
322,Dragonn,1,0.01026,2816,28.89687,9745
323,drazisil,1,0.01026,2817,28.90713,9745
324,dredwilliams,1,0.01026,2818,28.91739,9745
325,dsandersAzure,1,0.01026,2819,28.92766,9745
326,dtalbott,1,0.01026,2820,28.93792,9745
327,duylong,1,0.01026,2821,28.94818,9745
328,ebauman,1,0.01026,2822,28.95844,9745
329,ehlo550,1,0.01026,2823,28.96870,9745
330,embix,1,0.01026,2824,28.97896,9745
331,eponerine,1,0.01026,2825,28.98923,9745
332,eqrx,1,0.01026,2826,28.99949,9745
333,ericxtang,1,0.01026,2827,29.00975,9745
334,erikturk,1,0.01026,2828,29.02001,9745
335,ErmakovDmitriy,1,0.01026,2829,29.03027,9745
336,ErwanMAS,1,0.01026,2830,29.04053,9745
337,ethanbergstrom,1,0.01026,2831,29.05080,9745
338,exmatrikulator,1,0.01026,2832,29.06106,9745
339,eyablokov,1,0.01026,2833,29.07132,9745
340,fabioyy,1,0.01026,2834,29.08158,9745
341,fcrespofastly,1,0.01026,2835,29.09184,9745
342,FerronN,1,0.01026,2836,29.10210,9745
343,FF7C7,1,0.01026,2837,29.11237,9745
344,fkrauthan,1,0.01026,2838,29.12263,9745
345,fleckenstein-ma,1,0.01026,2839,29.13289,9745
346,fmmatthewzeemann,1,0.01026,2840,29.14315,9745
347,FNSdev,1,0.01026,2841,29.15341,9745
348,Foltik,1,0.01026,2842,29.16367,9745
349,foosinn,1,0.01026,2843,29.17394,9745
350,fpiesche,1,0.01026,2844,29.18420,9745
351,franklymrshankley,1,0.01026,2845,29.19446,9745
352,franrebo84,1,0.01026,2846,29.20472,9745
353,FROGGS,1,0.01026,2847,29.21498,9745
354,fsdaniel,1,0.01026,2848,29.22524,9745
355,Fufuhu,1,0.01026,2849,29.23551,9745
356,fungnaz,1,0.01026,2850,29.24577,9745
357,gautvenk,1,0.01026,2851,29.25603,9745
358,grssam,1,0.01026,2852,29.26629,9745
359,GuillaumeOuint,1,0.01026,2853,29.27655,9745
360,guoh1988,1,0.01026,2854,29.28681,9745
361,guxuezheng,1,0.01026,2855,29.29708,9745
362,hameno,1,0.01026,2856,29.30734,9745
363,HassanHashemi,1,0.01026,2857,29.31760,9745
364,hei-pa,1,0.01026,2858,29.32786,9745
365,hetii,1,0.01026,2859,29.33812,9745
366,hijak,1,0.01026,2860,29.34838,9745
367,hulucc,1,0.01026,2861,29.35865,9745
368,huydinhtiki,1,0.01026,2862,29.36891,9745
369,ianhlavats,1,0.01026,2863,29.37917,9745
370,igalse,1,0.01026,2864,29.38943,9745
371,igostv,1,0.01026,2865,29.39969,9745
372,ilhaan,1,0.01026,2866,29.40995,9745
373,Incubator4th,1,0.01026,2867,29.42022,9745
374,Intellium,1,0.01026,2868,29.43048,9745
375,isaron,1,0.01026,2869,29.44074,9745
376,Isaroth,1,0.01026,2870,29.45100,9745
377,ittrainingdotpro,1,0.01026,2871,29.46126,9745
378,jamesdube,1,0.01026,2872,29.47152,9745
379,jamestutton,1,0.01026,2873,29.48179,9745
380,jansmets,1,0.01026,2874,29.49205,9745
381,jbrisko,1,0.01026,2875,29.50231,9745
382,jeff-hillman,1,0.01026,2876,29.51257,9745
383,jeschero,1,0.01026,2877,29.52283,9745
384,jijiechen,1,0.01026,2878,29.53309,9745
385,jlcox1970,1,0.01026,2879,29.54336,9745
386,jmlogan,1,0.01026,2880,29.55362,9745
387,jmozd,1,0.01026,2881,29.56388,9745
388,jochenseeber,1,0.01026,2882,29.57414,9745
389,johnarok,1,0.01026,2883,29.58440,9745
390,jonas-werner,1,0.01026,2884,29.59466,9745
391,jphuc96,1,0.01026,2885,29.60493,9745
392,juhoson1129,1,0.01026,2886,29.61519,9745
393,kalak451,1,0.01026,2887,29.62545,9745
394,kelvinatstreetline,1,0.01026,2888,29.63571,9745
395,kmkramer,1,0.01026,2889,29.64597,9745
396,kmorning,1,0.01026,2890,29.65623,9745
397,knandras,1,0.01026,2891,29.66650,9745
398,KoJJang,1,0.01026,2892,29.67676,9745
399,konvergence,1,0.01026,2893,29.68702,9745
400,koojw99,1,0.01026,2894,29.69728,9745
401,kprasad99,1,0.01026,2895,29.70754,9745
402,krichter722,1,0.01026,2896,29.71780,9745
403,kz12123,1,0.01026,2897,29.72807,9745
404,laisbsc,1,0.01026,2898,29.73833,9745
405,Laith-Alobaidy,1,0.01026,2899,29.74859,9745
406,laoshancun,1,0.01026,2900,29.75885,9745
407,larntz,1,0.01026,2901,29.76911,9745
408,LeducH,1,0.01026,2902,29.77937,9745
409,lgorence,1,0.01026,2903,29.78964,9745
410,lirlia,1,0.01026,2904,29.79990,9745
411,Lord-Y,1,0.01026,2905,29.81016,9745
412,lorenzomorandini,1,0.01026,2906,29.82042,9745
413,mabusaa,1,0.01026,2907,29.83068,9745
414,MaheshTR033,1,0.01026,2908,29.84094,9745
415,makeacode,1,0.01026,2909,29.85121,9745
416,MalKeshar,1,0.01026,2910,29.86147,9745
417,mandydydy,1,0.01026,2911,29.87173,9745
418,marceliwac,1,0.01026,2912,29.88199,9745
419,marcelogimenes,1,0.01026,2913,29.89225,9745
420,marcingorzynski77,1,0.01026,2914,29.90251,9745
421,marcochs,1,0.01026,2915,29.91278,9745
422,markus-seidl,1,0.01026,2916,29.92304,9745
423,marwooj,1,0.01026,2917,29.93330,9745
424,mazay,1,0.01026,2918,29.94356,9745
425,mdasraf,1,0.01026,2919,29.95382,9745
426,MehrCurry,1,0.01026,2920,29.96408,9745
427,mersl,1,0.01026,2921,29.97435,9745
428,mflopez79,1,0.01026,2922,29.98461,9745
429,mikioh,1,0.01026,2923,29.99487,9745
430,mingfang,1,0.01026,2924,30.00513,9745
431,mnorrsken,1,0.01026,2925,30.01539,9745
432,mofm,1,0.01026,2926,30.02565,9745
433,mpackard,1,0.01026,2927,30.03592,9745
434,mrin,1,0.01026,2928,30.04618,9745
435,mristok,1,0.01026,2929,30.05644,9745
436,MrStonedOne,1,0.01026,2930,30.06670,9745
437,mscbpi,1,0.01026,2931,30.07696,9745
438,mslee89,1,0.01026,2932,30.08722,9745
439,Mumrau,1,0.01026,2933,30.09749,9745
440,muralirm,1,0.01026,2934,30.10775,9745
441,n8behavior,1,0.01026,2935,30.11801,9745
442,nathandorsey,1,0.01026,2936,30.12827,9745
443,nealf,1,0.01026,2937,30.13853,9745
444,nemodev,1,0.01026,2938,30.14879,9745
445,neowisard,1,0.01026,2939,30.15906,9745
446,nick-oconnor,1,0.01026,2940,30.16932,9745
447,nickperry,1,0.01026,2941,30.17958,9745
448,Nickymaco,1,0.01026,2942,30.18984,9745
449,njuptlzf,1,0.01026,2943,30.20010,9745
450,NM4,1,0.01026,2944,30.21036,9745
451,nnz1024,1,0.01026,2945,30.22063,9745
452,nrbrt,1,0.01026,2946,30.23089,9745
453,omyno,1,0.01026,2947,30.24115,9745
454,orenye,1,0.01026,2948,30.25141,9745
455,passcod,1,0.01026,2949,30.26167,9745
456,paulmorabito,1,0.01026,2950,30.27193,9745
457,penghon,1,0.01026,2951,30.28220,9745
458,pengliaoye,1,0.01026,2952,30.29246,9745
459,peterski007,1,0.01026,2953,30.30272,9745
460,pgagnon,1,0.01026,2954,30.31298,9745
461,PhilsLab,1,0.01026,2955,30.32324,9745
462,piyushns,1,0.01026,2956,30.33350,9745
463,plnordquist,1,0.01026,2957,30.34377,9745
464,plockc,1,0.01026,2958,30.35403,9745
465,pranay142,1,0.01026,2959,30.36429,9745
466,pulpo,1,0.01026,2960,30.37455,9745
467,qhxnj,1,0.01026,2961,30.38481,9745
468,qodfathr,1,0.01026,2962,30.39507,9745
469,rainbowjose,1,0.01026,2963,30.40534,9745
470,raonadeem,1,0.01026,2964,30.41560,9745
471,rayyen,1,0.01026,2965,30.42586,9745
472,remkolems,1,0.01026,2966,30.43612,9745
473,rgl,1,0.01026,2967,30.44638,9745
474,rhydian76,1,0.01026,2968,30.45664,9745
475,RiaanLab,1,0.01026,2969,30.46691,9745
476,richardmosquera,1,0.01026,2970,30.47717,9745
477,rnwolfe,1,0.01026,2971,30.48743,9745
478,ruanshudong,1,0.01026,2972,30.49769,9745
479,rur0,1,0.01026,2973,30.50795,9745
480,Russell-IO,1,0.01026,2974,30.51821,9745
481,rvarner,1,0.01026,2975,30.52848,9745
482,ryancurrah,1,0.01026,2976,30.53874,9745
483,scepeda78,1,0.01026,2977,30.54900,9745
484,schemen,1,0.01026,2978,30.55926,9745
485,scoonie7,1,0.01026,2979,30.56952,9745
486,sdinten,1,0.01026,2980,30.57978,9745
487,SeanChristopherConway,1,0.01026,2981,30.59005,9745
488,shahbhavik01,1,0.01026,2982,30.60031,9745
489,shailendra-singh93,1,0.01026,2983,30.61057,9745
490,shenshouer,1,0.01026,2984,30.62083,9745
491,shenyuanyu,1,0.01026,2985,30.63109,9745
492,Shuliyey,1,0.01026,2986,30.64135,9745
493,Slyke,1,0.01026,2987,30.65162,9745
494,smackmybitsup,1,0.01026,2988,30.66188,9745
495,smbm,1,0.01026,2989,30.67214,9745
496,smoretto,1,0.01026,2990,30.68240,9745
497,sonaikar,1,0.01026,2991,30.69266,9745
498,soudaburger,1,0.01026,2992,30.70292,9745
499,splashx,1,0.01026,2993,30.71319,9745
500,SriRamanujam,1,0.01026,2994,30.72345,9745
501,stefanbethke,1,0.01026,2995,30.73371,9745
502,strus38,1,0.01026,2996,30.74397,9745
503,sumitb,1,0.01026,2997,30.75423,9745
504,SunChero,1,0.01026,2998,30.76449,9745
505,sushicodeur,1,0.01026,2999,30.77476,9745
506,syska,1,0.01026,3000,30.78502,9745
507,sysnet4admin,1,0.01026,3001,30.79528,9745
508,taitd,1,0.01026,3002,30.80554,9745
509,TalissonBento,1,0.01026,3003,30.81580,9745
510,tangjoe,1,0.01026,3004,30.82606,9745
511,teeram,1,0.01026,3005,30.83633,9745
512,therealbubbasour,1,0.01026,3006,30.84659,9745
513,thielemans,1,0.01026,3007,30.85685,9745
514,thies226j,1,0.01026,3008,30.86711,9745
515,tmadrms,1,0.01026,3009,30.87737,9745
516,tomasz-kuzemko,1,0.01026,3010,30.88763,9745
517,tomhur,1,0.01026,3011,30.89790,9745
518,tonytjo,1,0.01026,3012,30.90816,9745
519,tranlyvu,1,0.01026,3013,30.91842,9745
520,trezm,1,0.01026,3014,30.92868,9745
521,ttyS0,1,0.01026,3015,30.93894,9745
522,tvendelin,1,0.01026,3016,30.94920,9745
523,Ufaowl,1,0.01026,3017,30.95947,9745
524,Ultrafenrir,1,0.01026,3018,30.96973,9745
525,uri-tech,1,0.01026,3019,30.97999,9745
526,VanagaS,1,0.01026,3020,30.99025,9745
527,vanyasvl,1,0.01026,3021,31.00051,9745
528,vidbaz,1,0.01026,3022,31.01077,9745
529,VileBrigandier,1,0.01026,3023,31.02104,9745
530,vishvish,1,0.01026,3024,31.03130,9745
531,vskovzgird,1,0.01026,3025,31.04156,9745
532,walker622,1,0.01026,3026,31.05182,9745
533,Walternrg4u,1,0.01026,3027,31.06208,9745
534,wernerb,1,0.01026,3028,31.07234,9745
535,wjwinner,1,0.01026,3029,31.08261,9745
536,xanderificnl,1,0.01026,3030,31.09287,9745
537,xclud,1,0.01026,3031,31.10313,9745
538,Xsenonn,1,0.01026,3032,31.11339,9745
539,yee379,1,0.01026,3033,31.12365,9745
540,z3net,1,0.01026,3034,31.13391,9745
541,zakharovvi,1,0.01026,3035,31.14418,9745
542,zamiramos,1,0.01026,3036,31.15444,9745
543,zanona,1,0.01026,3037,31.16470,9745
544,zhangq123456,1,0.01026,3038,31.17496,9745
545,zsek,1,0.01026,3039,31.18522,9745
